month,year,lineName,station,feePassenger,freePassenegr,totalPassenger
201803,2018,7호선,상동,413307,50935,464242
201803,2018,7호선,상봉(시외버스터미널),487494,75024,562518
201803,2018,7호선,신대방삼거리,432607,97259,529866
201803,2018,7호선,신중동,404047,51985,456032
201803,2018,7호선,신풍,301976,72961,374937
201803,2018,7호선,어린이대공원(세종대),510956,46712,557668
201803,2018,7호선,온수(성공회대입구),318550,37111,355661
201803,2018,7호선,용마산,168620,37019,205639
201803,2018,7호선,이수,451741,83925,535666
201803,2018,7호선,장승배기,272098,82476,354574
201803,2018,7호선,장암,68201,7891,76092
201803,2018,7호선,중계,404220,98610,502830
201803,2018,7호선,중곡,267650,64753,332403
201803,2018,7호선,중화,303689,64362,368051
201803,2018,7호선,천왕,230740,49187,279927
201803,2018,7호선,철산,667196,102495,769691
201803,2018,7호선,청담,550349,78590,628939
201803,2018,7호선,춘의,248880,30184,279064
201803,2018,7호선,태릉입구,263859,41881,305740
201803,2018,7호선,하계,539478,115660,655138
201803,2018,7호선,강남구청,414704,50724,465428
201803,2018,8호선,가락시장,174293,56587,230880
201803,2018,8호선,천호(풍납토성),505185,99944,605129
201803,2018,8호선,남한산성입구(성남법원.검찰청),401540,79778,481318
201803,2018,8호선,단대오거리,305447,69748,375195
201803,2018,8호선,석촌,219853,64459,284312
201803,2018,8호선,송파,141639,38398,180037
201803,2018,8호선,수진,128482,48347,176829
201803,2018,8호선,모란,100538,59455,159993
201803,2018,8호선,몽촌토성(평화의문),171672,45504,217176
201803,2018,8호선,문정,450062,51030,501092
201803,2018,8호선,복정,335028,51186,386214
201803,2018,8호선,산성,151160,35125,186285
201803,2018,8호선,신흥,108001,44826,152827
201803,2018,8호선,암사,488324,98313,586637
201803,2018,8호선,잠실(송파구청),380855,68195,449050
201803,2018,8호선,장지,509265,74321,583586
201803,2018,8호선,강동구청,280238,68384,348622
201803,2018,9호선,가양,529079,128842,657921
201803,2018,9호선,개화,177139,36592,213731
201803,2018,9호선,고속터미널,359801,51992,411793
201803,2018,9호선,동작(현충원),44375,13019,57394
201803,2018,9호선,등촌,249927,83518,333445
201803,2018,9호선,마곡나루,211720,15281,227001
201803,2018,9호선,공항시장,68018,22284,90302
201803,2018,9호선,구반포,73813,24535,98348
201803,2018,9호선,국회의사당,430863,54209,485072
201803,2018,9호선,김포공항,274727,20924,295651
201803,2018,9호선,노들,114596,31911,146507
201803,2018,9호선,노량진,791232,89874,881106
201803,2018,9호선,당산,504894,66516,571410
201803,2018,9호선,선유도,185289,26687,211976
201803,2018,9호선,사평,68362,14655,83017
201803,2018,9호선,샛강,130592,27578,158170
201803,2018,9호선,신논현,872366,54607,926973
201803,2018,9호선,신목동,107186,19278,126464
201803,2018,9호선,신반포,86271,25281,111552
201803,2018,9호선,신방화,212105,46461,258566
201803,2018,9호선,양천향교,220371,40585,260956
201803,2018,9호선,여의도,544743,43541,588284
201803,2018,9호선,염창,448785,65018,513803
201803,2018,9호선,증미,176163,43179,219342
201803,2018,9호선,흑석(중앙대입구),298888,53627,352515
201803,2018,9호선2단계,선정릉,192409,21126,213535
201803,2018,9호선2단계,봉은사,388544,39646,428190
201803,2018,9호선2단계,종합운동장,181898,16847,198745
201803,2018,9호선2단계,언주,224822,25138,249960
201803,2018,9호선2단계,삼성중앙,134013,22732,156745
201803,2018,경강선,이매,41555,9194,50749
201803,2018,경강선,곤지암,55971,11628,67599
201803,2018,경강선,경기광주,171492,24887,196379
201803,2018,경강선,여주,61475,15143,76618
201803,2018,경강선,신둔도예촌,35263,5936,41199
201803,2018,경강선,삼동,50810,8712,59522
201803,2018,경강선,부발,49456,6597,56053
201803,2018,경강선,세종대왕릉,5591,2984,8575
201803,2018,경강선,판교,91058,10707,101765
201803,2018,경강선,초월,63647,10825,74472
201803,2018,경강선,이천,66917,12519,79436
201803,2018,경부선,서정리,161396,26856,188252
201803,2018,경부선,의왕,249492,43493,292985
201803,2018,경부선,성균관대,493321,58068,551389
201803,2018,경부선,성환,164940,22458,187398
201803,2018,경부선,세류,110190,19859,130049
201803,2018,경부선,세마,75323,14472,89795
201803,2018,경부선,군포,198061,36282,234343
201803,2018,경부선,송탄,144680,26450,171130
201803,2018,경부선,수원,1399240,159209,1558449
201803,2018,경부선,신길,273717,49743,323460
201803,2018,경부선,명학,293239,46180,339419
201803,2018,경부선,병점,493641,62974,556615
201803,2018,경부선,금정,768722,114814,883536
201803,2018,경부선,금천구청,294167,81057,375224
201803,2018,경부선,서동탄,41925,9574,51499
201803,2018,경부선,신도림,96296,24248,120544
201803,2018,경부선,남영,324027,42002,366029
201803,2018,경부선,안양,831316,123121,954437
201803,2018,경부선,노량진,404646,52914,457560
201803,2018,경부선,영등포,1253847,300116,1553963
201803,2018,경부선,오산,304432,45308,349740
201803,2018,경부선,오산대,103994,14096,118090
201803,2018,경부선,용산,1131697,138352,1270049
201803,2018,경부선,가산디지털단지,447780,32262,480042
201803,2018,경부선,당정,215138,31058,246196
201803,2018,경부선,대방,402900,77114,480014
201803,2018,경부선,독산,448870,70025,518895
201803,2018,경부선,두정,207514,24358,231872
201803,2018,경부선,화서,227043,45458,272501
201803,2018,경부선,평택,419031,72945,491976
201803,2018,경부선,구로,564779,102500,667279
201803,2018,경부선,광명,60609,5168,65777
201803,2018,경부선,천안,225518,62067,287585
201803,2018,경부선,관악,221011,57932,278943
201803,2018,경부선,지제,64287,7392,71679
201803,2018,경부선,직산,24141,6344,30485
201803,2018,경부선,진위,47500,8378,55878
201803,2018,분당선,죽전,452586,85527,538113
201803,2018,분당선,청명,119852,18884,138736
201803,2018,분당선,태평,369194,96261,465455
201803,2018,분당선,강남구청,231758,41668,273426
201803,2018,수인선,남동인더스파크,59483,5412,64895
201803,2018,수인선,달월,2037,1262,3299
201803,2018,수인선,소래포구,109018,45885,154903
201803,2018,수인선,송도,70549,22312,92861
201803,2018,수인선,숭의,80157,27879,108036
201803,2018,수인선,신포,48627,12857,61484
201803,2018,수인선,호구포,96292,17613,113905
201803,2018,수인선,원인재,122249,28833,151082
201803,2018,수인선,월곶,75151,14428,89579
201803,2018,수인선,인천,22974,10003,32977
201803,2018,수인선,인천논현,163300,33833,197133
201803,2018,수인선,인하대,187567,24162,211729
201803,2018,수인선,연수,138374,29318,167692
201803,2018,안산선,고잔,257756,37765,295521
201803,2018,안산선,대야미,112596,25887,138483
201803,2018,안산선,수리산,109575,32963,142538
201803,2018,안산선,신길온천,47129,9420,56549
201803,2018,안산선,반월,122764,29577,152341
201803,2018,안산선,산본,466663,105986,572649
201803,2018,안산선,한대앞,270777,41723,312500
201803,2018,안산선,안산,481876,44613,526489
201803,2018,안산선,오이도,275334,37318,312652
201803,2018,안산선,정왕,289379,24177,313556
201803,2018,안산선,중앙,510538,60834,571372
201803,2018,안산선,초지,145798,16175,161973
201803,2018,안산선,상록수,600785,88754,689539
201803,2018,우이신설선,4.19민주묘지,79007,27337,106344
201803,2018,우이신설선,가오리,77144,42784,119928
201803,2018,우이신설선,성신여대입구(돈암),96091,31932,128023
201803,2018,우이신설선,솔밭공원,46336,24623,70959
201803,2018,우이신설선,솔샘,129232,32935,162167
201803,2018,우이신설선,보문,32036,14959,46995
201803,2018,우이신설선,화계,57156,36225,93381
201803,2018,우이신설선,북한산우이,58493,31283,89776
201803,2018,우이신설선,삼양,37607,25513,63120
201803,2018,우이신설선,삼양사거리,38238,31947,70185
201803,2018,우이신설선,신설동,34133,16418,50551
201803,2018,우이신설선,정릉,88041,41614,129655
201803,2018,우이신설선,북한산보국문,144451,39793,184244
201803,2018,일산선,마두,187242,81171,268413
201803,2018,일산선,화정,489304,137398,626702
201803,2018,일산선,대화,392149,98105,490254
201803,2018,일산선,대곡,41135,11198,52333
201803,2018,일산선,주엽,209435,100260,309695
201803,2018,일산선,정발산,216210,59985,276195
201803,2018,일산선,원흥,216442,45243,261685
201803,2018,일산선,원당,299489,91124,390613
201803,2018,일산선,삼송,421770,89857,511627
201803,2018,일산선,백석,291277,82918,374195
201803,2018,장항선,쌍용(나사렛대),77055,17009,94064
201803,2018,장항선,신창(순천향대),82734,8401,91135
201803,2018,장항선,온양온천,98339,67706,166045
201803,2018,장항선,봉명,30679,14511,45190
201803,2018,장항선,아산,100505,10855,111360
201803,2018,장항선,배방,26415,8070,34485
201803,2018,중앙선,덕소,152670,52622,205292
201803,2018,중앙선,회기,861683,135885,997568
201803,2018,중앙선,도심,64538,21136,85674
201803,2018,중앙선,망우,190694,72413,263107
201803,2018,중앙선,구리,347445,87692,435137
201803,2018,중앙선,국수,19133,9387,28520
201803,2018,중앙선,상봉(시외버스터미널),151731,40146,191877
201803,2018,중앙선,신원,4373,3210,7583
201803,2018,중앙선,아신,17851,5963,23814
201803,2018,중앙선,양수,43465,19266,62731
201803,2018,중앙선,양원,39544,17179,56723
201803,2018,중앙선,양정,18489,8651,27140
201803,2018,중앙선,양평,79500,36170,115670
201803,2018,중앙선,오빈,6517,4180,10697
201803,2018,중앙선,용문,43218,40303,83521
201803,2018,중앙선,운길산,19637,7984,27621
201803,2018,1호선,동대문,344838,144807,489645
201803,2018,1호선,동묘앞,186399,161159,347558
201803,2018,1호선,시청,661782,111157,772939
201803,2018,1호선,서울역,1455338,228041,1683379
201803,2018,1호선,청량리(서울시립대입구),523932,332933,856865
201803,2018,1호선,제기동,303632,349589,653221
201803,2018,1호선,종각,1236445,170206,1406651
201803,2018,1호선,종로3가,698691,401375,1100066
201803,2018,1호선,종로5가,557447,302624,860071
201803,2018,1호선,신설동,389298,132858,522156
201803,2018,2호선,강남,3034426,183497,3217923
201803,2018,2호선,홍대입구,2470011,122278,2592289
201803,2018,2호선,건대입구,1394861,102806,1497667
201803,2018,2호선,도림천,31239,6580,37819
201803,2018,2호선,동대문역사문화공원,540948,64548,605496
201803,2018,2호선,뚝섬,476502,68513,545015
201803,2018,2호선,교대(법원.검찰청),986389,179200,1165589
201803,2018,2호선,구로디지털단지,1803465,178348,1981813
201803,2018,2호선,구의(광진구청),649073,112520,761593
201803,2018,2호선,낙성대,864570,117594,982164
201803,2018,2호선,당산,603961,72675,676636
201803,2018,2호선,대림(구로구청),825496,123373,948869
201803,2018,2호선,서초,637541,94228,731769
201803,2018,2호선,선릉,1492095,224007,1716102
201803,2018,2호선,성수,741914,108149,850063
201803,2018,2호선,시청,704871,67465,772336
201803,2018,2호선,문래,526025,90157,616182
201803,2018,2호선,방배,609333,87264,696597
201803,2018,2호선,봉천,597792,158677,756469
201803,2018,2호선,사당,1128276,223582,1351858
201803,2018,2호선,삼성(무역센터),1684625,131921,1816546
201803,2018,2호선,상왕십리,375885,71020,446905
201803,2018,2호선,서울대입구(관악구청),1525004,220064,1745068
201803,2018,2호선,신답,34476,10985,45461
201803,2018,2호선,신당,378721,111562,490283
201803,2018,2호선,신대방,773266,139879,913145
201803,2018,2호선,신도림,1709060,221529,1930589
201803,2018,2호선,신림,1985706,256962,2242668
201803,2018,2호선,신설동,106589,42787,149376
201803,2018,2호선,신정네거리,241772,68017,309789
201803,2018,2호선,신촌,1493965,149123,1643088
201803,2018,2호선,아현,275754,67642,343396
201803,2018,2호선,양천구청,175775,47497,223272
201803,2018,2호선,역삼,1287032,158222,1445254
201803,2018,2호선,영등포구청,583438,110842,694280
201803,2018,2호선,왕십리(성동구청),591685,62080,653765
201803,2018,2호선,용답,72242,18121,90363
201803,2018,2호선,용두(동대문구청),51145,24778,75923
201803,2018,2호선,을지로3가,576045,94921,670966
201803,2018,2호선,을지로4가,299877,97514,397391
201803,2018,2호선,을지로입구,1462219,123805,1586024
201803,2018,2호선,이대,642722,71935,714657
201803,2018,2호선,잠실(송파구청),2514484,236514,2750998
201803,2018,2호선,잠실나루,447474,95463,542937
201803,2018,2호선,잠실새내,721478,126809,848287
201803,2018,2호선,종합운동장,379251,56021,435272
201803,2018,2호선,충정로(경기대입구),306366,57243,363609
201803,2018,2호선,한양대,404545,16731,421276
201803,2018,2호선,합정,982177,78093,1060270
201803,2018,2호선,강변(동서울터미널),1327074,150927,1478001
201803,2018,경인선,간석,165568,46855,212423
201803,2018,경인선,개봉,603572,166097,769669
201803,2018,경인선,도원,100984,36655,137639
201803,2018,경인선,도화,92523,39021,131544
201803,2018,3호선,가락시장,249031,77865,326896
201803,2018,3호선,홍제,487041,157276,644317
201803,2018,3호선,경찰병원,199998,42238,242236
201803,2018,3호선,고속터미널,1703305,196614,1899919
201803,2018,3호선,도곡,177537,31425,208962
201803,2018,3호선,독립문,194730,79936,274666
201803,2018,3호선,동대입구,344881,37954,382835
201803,2018,3호선,매봉,290012,59455,349467
201803,2018,3호선,교대(법원.검찰청),394456,77533,471989
201803,2018,3호선,구파발,545590,105917,651507
201803,2018,3호선,금호,220206,59474,279680
201803,2018,3호선,남부터미널(예술의전당),965670,138505,1104175
201803,2018,3호선,녹번,354314,69070,423384
201803,2018,3호선,대청,265962,56064,322026
201803,2018,3호선,대치,339484,66391,405875
201803,2018,3호선,수서,460389,106019,566408
201803,2018,3호선,무악재,95400,32802,128202
201803,2018,3호선,불광,459825,158221,618046
201803,2018,3호선,신사,944793,78515,1023308
201803,2018,3호선,안국,683879,135744,819623
201803,2018,3호선,압구정,915346,159549,1074895
201803,2018,3호선,약수,362343,89886,452229
201803,2018,3호선,양재(서초구청),1130906,181146,1312052
201803,2018,3호선,연신내,1081275,283023,1364298
201803,2018,3호선,오금,193791,30687,224478
201803,2018,3호선,옥수,255442,64497,319939
201803,2018,3호선,을지로3가,255957,63001,318958
201803,2018,3호선,일원,233068,62482,295550
201803,2018,3호선,잠원,159803,38271,198074
201803,2018,3호선,종로3가,233338,61980,295318
201803,2018,3호선,지축,27568,10673,38241
201803,2018,3호선,충무로,55,1,56
201803,2018,3호선,학여울,82050,19106,101156
201803,2018,3호선,경복궁(정부서울청사),724881,100641,825522
201803,2018,4호선,동대문,651580,172198,823778
201803,2018,4호선,회현(남대문시장),761089,234770,995859
201803,2018,4호선,동작(현충원),53586,20687,74273
201803,2018,4호선,길음,661630,133361,794991
201803,2018,4호선,남태령,103562,10685,114247
201803,2018,4호선,노원,622226,98608,720834
201803,2018,4호선,당고개,317671,97226,414897
201803,2018,4호선,서울역,375430,43424,418854
201803,2018,4호선,성신여대입구(돈암),735813,99091,834904
201803,2018,4호선,수유(강북구청),1042293,226426,1268719
201803,2018,4호선,숙대입구(갈월),514574,61586,576160
201803,2018,4호선,명동,1237402,77669,1315071
201803,2018,4호선,미아(서울사이버대학),451387,128159,579546
201803,2018,4호선,미아사거리,776870,191130,968000
201803,2018,4호선,사당,839854,100016,939870
201803,2018,4호선,삼각지,127172,30359,157531
201803,2018,4호선,상계,560976,125028,686004
201803,2018,4호선,신용산,422153,52607,474760
201803,2018,4호선,쌍문,892536,177238,1069774
201803,2018,4호선,이촌(국립중앙박물관),242359,50645,293004
201803,2018,4호선,창동,730930,202527,933457
201803,2018,4호선,총신대입구(이수),535025,156102,691127
201803,2018,4호선,충무로,941994,136726,1078720
201803,2018,4호선,한성대입구(삼선교),479321,83153,562474
201803,2018,4호선,혜화,1195672,140467,1336139
201803,2018,4호선,동대문역사문화공원,677292,69214,746506
201803,2018,5호선,강동,539299,105691,644990
201803,2018,5호선,화곡,802451,150103,952554
201803,2018,5호선,개화산,149143,37313,186456
201803,2018,5호선,거여,167272,54304,221576
201803,2018,5호선,고덕,246658,66519,313177
201803,2018,5호선,공덕,379325,49539,428864
201803,2018,5호선,동대문역사문화공원,77450,9310,86760
201803,2018,5호선,둔촌동,248670,70205,318875
201803,2018,5호선,마곡,215416,28465,243881
201803,2018,5호선,마장,155931,45520,201451
201803,2018,5호선,마천,116581,50346,166927
201803,2018,5호선,마포,372052,69629,441681
201803,2018,5호선,광나루(장신대),404152,73222,477374
201803,2018,5호선,광화문(세종문화회관),1034708,98743,1133451
201803,2018,5호선,군자(능동),315668,42236,357904
201803,2018,5호선,굽은다리(강동구민회관앞),248382,68541,316923
201803,2018,5호선,길동,179752,64176,243928
201803,2018,5호선,김포공항,217179,31082,248261
201803,2018,5호선,까치산,806137,162371,968508
201803,2018,5호선,답십리,437831,89626,527457
201803,2018,5호선,송정,235837,63754,299591
201803,2018,5호선,신금호,161791,38914,200705
201803,2018,5호선,신길,91449,13265,104714
201803,2018,5호선,명일,204196,66190,270386
201803,2018,5호선,목동,499680,90247,589927
201803,2018,5호선,발산,470989,73560,544549
201803,2018,5호선,방이,189663,46862,236525
201803,2018,5호선,방화,186467,50364,236831
201803,2018,5호선,상일동,323664,69282,392946
201803,2018,5호선,서대문,481766,73199,554965
201803,2018,5호선,신정(은행정),398543,63891,462434
201803,2018,5호선,아차산(어린이대공원후문),393844,101187,495031
201803,2018,5호선,애오개,192133,41165,233298
201803,2018,5호선,양평,172581,30270,202851
201803,2018,5호선,여의나루,325339,28867,354206
201803,2018,5호선,여의도,650390,55005,705395
201803,2018,5호선,영등포구청,90672,20811,111483
201803,2018,5호선,영등포시장,220415,83277,303692
201803,2018,5호선,오금,98235,18957,117192
201803,2018,5호선,오목교(목동운동장앞),703583,89975,793558
201803,2018,5호선,올림픽공원(한국체대),164294,36851,201145
201803,2018,5호선,왕십리(성동구청),133911,27459,161370
201803,2018,5호선,우장산,420558,86709,507267
201803,2018,5호선,을지로4가,111817,44463,156280
201803,2018,5호선,장한평,491299,101918,593217
201803,2018,5호선,종로3가,364615,129133,493748
201803,2018,5호선,천호(풍납토성),508795,155025,663820
201803,2018,5호선,청구,105342,28873,134215
201803,2018,5호선,충정로(경기대입구),131080,17362,148442
201803,2018,5호선,행당,222066,51565,273631
201803,2018,5호선,개롱,169932,47625,217557
201803,2018,6호선,고려대(종암),284567,37985,322552
201803,2018,6호선,효창공원앞,198205,44786,242991
201803,2018,6호선,독바위,70806,21960,92766
201803,2018,6호선,돌곶이,229121,63730,292851
201803,2018,6호선,동묘앞,231663,73541,305204
201803,2018,6호선,디지털미디어시티,372568,58670,431238
201803,2018,6호선,마포구청,361655,85347,447002
201803,2018,6호선,망원,360194,88841,449035
201803,2018,6호선,광흥창(서강),239621,62898,302519
201803,2018,6호선,구산,202457,58617,261074
201803,2018,6호선,녹사평(용산구청),209740,21868,231608
201803,2018,6호선,대흥(서강대앞),240802,50290,291092
201803,2018,6호선,석계,351403,79262,430665
201803,2018,6호선,버티고개,65139,15950,81089
201803,2018,6호선,보문,214604,36111,250715
201803,2018,6호선,봉화산(서울의료원),251478,55350,306828
201803,2018,6호선,불광,132660,43501,176161
201803,2018,6호선,삼각지,212006,19686,231692
201803,2018,6호선,상수,333131,24124,357255
201803,2018,6호선,상월곡(한국과학기술연구원),164965,43114,208079
201803,2018,6호선,새절(신사),359969,91040,451009
201803,2018,6호선,신당,246230,42533,288763
201803,2018,중앙선,원덕,7152,5817,12969
201803,2018,6호선,안암(고대병원앞),471463,35686,507149
201803,2018,6호선,약수,93348,25138,118486
201803,2018,6호선,역촌,87235,37160,124395
201803,2018,6호선,연신내,18,0,18
201803,2018,6호선,월곡(동덕여대),359142,79353,438495
201803,2018,6호선,월드컵경기장(성산),125900,52225,178125
201803,2018,6호선,응암,459952,120128,580080
201803,2018,6호선,이태원,541037,37998,579035
201803,2018,6호선,증산(명지대앞),266483,74157,340640
201803,2018,6호선,창신,102433,18097,120530
201803,2018,6호선,청구,100273,20265,120538
201803,2018,6호선,태릉입구,149524,29447,178971
201803,2018,6호선,한강진,224242,16009,240251
201803,2018,6호선,합정,464383,43602,507985
201803,2018,6호선,화랑대(서울여대입구),384325,49198,433523
201803,2018,6호선,공덕,498985,77449,576434
201803,2018,7호선,가산디지털단지,1145064,83776,1228840
201803,2018,7호선,학동,598909,64047,662956
201803,2018,7호선,건대입구,482349,57958,540307
201803,2018,7호선,고속터미널,575043,83873,658916
201803,2018,7호선,도봉산,260421,41586,302007
201803,2018,7호선,뚝섬유원지,243058,41315,284373
201803,2018,7호선,마들,305706,81493,387199
201803,2018,7호선,먹골,278988,64392,343380
201803,2018,7호선,면목,450082,89750,539832
201803,2018,7호선,공릉(서울과학기술대),366189,71319,437508
201803,2018,7호선,광명사거리,702912,155055,857967
201803,2018,7호선,군자(능동),382542,81631,464173
201803,2018,7호선,굴포천,258206,36689,294895
201803,2018,7호선,까치울,203949,25764,229713
201803,2018,7호선,남구로,447516,62252,509768
201803,2018,7호선,남성,301422,74564,375986
201803,2018,7호선,내방,387379,68949,456328
201803,2018,7호선,노원,546034,122872,668906
201803,2018,7호선,논현,547397,55583,602980
201803,2018,7호선,대림(구로구청),295491,37243,332734
201803,2018,7호선,수락산,354457,95694,450151
201803,2018,7호선,숭실대입구(살피재),486954,63904,550858
201803,2018,7호선,반포,173393,35314,208707
201803,2018,7호선,보라매,249014,44959,293973
201803,2018,7호선,부천시청,348816,50297,399113
201803,2018,7호선,부천종합운동장,146037,18858,164895
201803,2018,7호선,부평구청,343397,32212,375609
201803,2018,7호선,사가정,415672,98349,514021
201803,2018,7호선,삼산체육관,140496,25209,165705
201803,2018,7호선,상도,322301,63135,385436
201803,2018,7호선,상동,413307,50935,464242
201803,2018,7호선,상봉(시외버스터미널),487494,75024,562518
201803,2018,7호선,신대방삼거리,432607,97259,529866
201803,2018,7호선,신중동,404047,51985,456032
201803,2018,7호선,신풍,301976,72961,374937
201803,2018,7호선,어린이대공원(세종대),510956,46712,557668
201803,2018,7호선,온수(성공회대입구),318550,37111,355661
201803,2018,7호선,용마산,168620,37019,205639
201803,2018,7호선,이수,451741,83925,535666
201803,2018,7호선,장승배기,272098,82476,354574
201803,2018,7호선,장암,68201,7891,76092
201803,2018,7호선,중계,404220,98610,502830
201803,2018,7호선,중곡,267650,64753,332403
201803,2018,7호선,중화,303689,64362,368051
201803,2018,7호선,천왕,230740,49187,279927
201803,2018,7호선,철산,667196,102495,769691
201803,2018,7호선,청담,550349,78590,628939
201803,2018,7호선,춘의,248880,30184,279064
201803,2018,7호선,태릉입구,263859,41881,305740
201803,2018,7호선,하계,539478,115660,655138
201803,2018,7호선,강남구청,414704,50724,465428
201803,2018,8호선,가락시장,174293,56587,230880
201803,2018,8호선,천호(풍납토성),505185,99944,605129
201803,2018,8호선,남한산성입구(성남법원.검찰청),401540,79778,481318
201803,2018,8호선,단대오거리,305447,69748,375195
201803,2018,8호선,석촌,219853,64459,284312
201803,2018,8호선,송파,141639,38398,180037
201803,2018,8호선,수진,128482,48347,176829
201803,2018,8호선,모란,100538,59455,159993
201803,2018,8호선,몽촌토성(평화의문),171672,45504,217176
201803,2018,8호선,문정,450062,51030,501092
201803,2018,8호선,복정,335028,51186,386214
201803,2018,8호선,산성,151160,35125,186285
201803,2018,8호선,신흥,108001,44826,152827
201803,2018,8호선,암사,488324,98313,586637
201803,2018,8호선,잠실(송파구청),380855,68195,449050
201803,2018,8호선,장지,509265,74321,583586
201803,2018,8호선,강동구청,280238,68384,348622
201803,2018,9호선,가양,529079,128842,657921
201803,2018,9호선,개화,177139,36592,213731
201803,2018,9호선,고속터미널,359801,51992,411793
201803,2018,9호선,동작(현충원),44375,13019,57394
201803,2018,9호선,등촌,249927,83518,333445
201803,2018,9호선,마곡나루,211720,15281,227001
201803,2018,9호선,공항시장,68018,22284,90302
201803,2018,9호선,구반포,73813,24535,98348
201803,2018,9호선,국회의사당,430863,54209,485072
201803,2018,9호선,김포공항,274727,20924,295651
201803,2018,9호선,노들,114596,31911,146507
201803,2018,9호선,노량진,791232,89874,881106
201803,2018,9호선,당산,504894,66516,571410
201803,2018,9호선,선유도,185289,26687,211976
201803,2018,9호선,사평,68362,14655,83017
201803,2018,9호선,샛강,130592,27578,158170
201803,2018,9호선,신논현,872366,54607,926973
201803,2018,9호선,신목동,107186,19278,126464
201803,2018,9호선,신반포,86271,25281,111552
201803,2018,9호선,신방화,212105,46461,258566
201803,2018,9호선,양천향교,220371,40585,260956
201803,2018,9호선,여의도,544743,43541,588284
201803,2018,9호선,염창,448785,65018,513803
201803,2018,9호선,증미,176163,43179,219342
201803,2018,9호선,흑석(중앙대입구),298888,53627,352515
201803,2018,9호선2단계,선정릉,192409,21126,213535
201803,2018,9호선2단계,봉은사,388544,39646,428190
201803,2018,9호선2단계,종합운동장,181898,16847,198745
201803,2018,9호선2단계,언주,224822,25138,249960
201803,2018,9호선2단계,삼성중앙,134013,22732,156745
201803,2018,경강선,이매,41555,9194,50749
201803,2018,경강선,곤지암,55971,11628,67599
201803,2018,경강선,경기광주,171492,24887,196379
201803,2018,경강선,여주,61475,15143,76618
201803,2018,경강선,신둔도예촌,35263,5936,41199
201803,2018,경강선,삼동,50810,8712,59522
201803,2018,경강선,부발,49456,6597,56053
201803,2018,경강선,세종대왕릉,5591,2984,8575
201803,2018,경강선,판교,91058,10707,101765
201803,2018,경강선,초월,63647,10825,74472
201803,2018,경강선,이천,66917,12519,79436
201803,2018,경부선,서정리,161396,26856,188252
201803,2018,경부선,의왕,249492,43493,292985
201803,2018,경부선,성균관대,493321,58068,551389
201803,2018,경부선,성환,164940,22458,187398
201803,2018,경부선,세류,110190,19859,130049
201803,2018,경부선,세마,75323,14472,89795
201803,2018,경부선,군포,198061,36282,234343
201803,2018,경부선,송탄,144680,26450,171130
201803,2018,경부선,수원,1399240,159209,1558449
201803,2018,경부선,신길,273717,49743,323460
201803,2018,경부선,명학,293239,46180,339419
201803,2018,경부선,병점,493641,62974,556615
201803,2018,경부선,금정,768722,114814,883536
201803,2018,경부선,금천구청,294167,81057,375224
201803,2018,경부선,서동탄,41925,9574,51499
201803,2018,경부선,신도림,96296,24248,120544
201803,2018,경부선,남영,324027,42002,366029
201803,2018,경부선,안양,831316,123121,954437
201803,2018,경부선,노량진,404646,52914,457560
201803,2018,경부선,영등포,1253847,300116,1553963
201803,2018,경부선,오산,304432,45308,349740
201803,2018,경부선,오산대,103994,14096,118090
201803,2018,경부선,용산,1131697,138352,1270049
201803,2018,경부선,가산디지털단지,447780,32262,480042
201803,2018,경부선,당정,215138,31058,246196
201803,2018,경부선,대방,402900,77114,480014
201803,2018,경부선,독산,448870,70025,518895
201803,2018,경부선,두정,207514,24358,231872
201803,2018,경부선,화서,227043,45458,272501
201803,2018,경부선,평택,419031,72945,491976
201803,2018,경부선,구로,564779,102500,667279
201803,2018,경부선,광명,60609,5168,65777
201803,2018,경부선,천안,225518,62067,287585
201803,2018,경부선,진위,47500,8378,55878
201803,2018,경부선,직산,24141,6344,30485
201803,2018,일산선,화정,489304,137398,626702
201803,2018,일산선,대화,392149,98105,490254
201803,2018,일산선,대곡,41135,11198,52333
201803,2018,일산선,주엽,209435,100260,309695
201803,2018,일산선,정발산,216210,59985,276195
201803,2018,일산선,원흥,216442,45243,261685
201803,2018,일산선,원당,299489,91124,390613
201803,2018,일산선,삼송,421770,89857,511627
201803,2018,일산선,백석,291277,82918,374195
201803,2018,장항선,쌍용(나사렛대),77055,17009,94064
201803,2018,장항선,신창(순천향대),82734,8401,91135
201803,2018,장항선,온양온천,98339,67706,166045
201803,2018,장항선,봉명,30679,14511,45190
201803,2018,장항선,아산,100505,10855,111360
201803,2018,장항선,배방,26415,8070,34485
201803,2018,중앙선,덕소,152670,52622,205292
201803,2018,중앙선,회기,861683,135885,997568
201803,2018,중앙선,도심,64538,21136,85674
201803,2018,중앙선,망우,190694,72413,263107
201803,2018,중앙선,구리,347445,87692,435137
201803,2018,중앙선,국수,19133,9387,28520
201803,2018,중앙선,상봉(시외버스터미널),151731,40146,191877
201803,2018,중앙선,신원,4373,3210,7583
201803,2018,중앙선,아신,17851,5963,23814
201803,2018,중앙선,양수,43465,19266,62731
201803,2018,중앙선,양원,39544,17179,56723
201803,2018,중앙선,양정,18489,8651,27140
201803,2018,중앙선,양평,79500,36170,115670
201803,2018,중앙선,오빈,6517,4180,10697
201803,2018,중앙선,용문,43218,40303,83521
201803,2018,중앙선,운길산,19637,7984,27621
201803,2018,중앙선,원덕,7152,5817,12969
201803,2018,중앙선,중랑,126303,53912,180215
201803,2018,중앙선,지평,1137,663,1800
201803,2018,중앙선,팔당,22951,7465,30416
201803,2018,중앙선,도농,229960,60523,290483
201803,2018,중앙선,중랑,126303,53912,180215
201803,2018,중앙선,지평,1137,663,1800
201803,2018,중앙선,팔당,22951,7465,30416
201803,2018,중앙선,도농,229960,60523,290483
201803,2018,경부선,지제,64287,7392,71679
201803,2018,경부선,관악,221011,57932,278943
201803,2018,경부선,서울역,185103,12951,198054
201803,2018,경부선,석수,328224,51261,379485
201803,2018,경원선,의정부,570488,126511,696999
201803,2018,경원선,이촌(국립중앙박물관),111704,31984,143688
201803,2018,경원선,지행,195581,47022,242603
201803,2018,경원선,창동,1,0,1
201803,2018,경원선,청량리(서울시립대입구),356857,147608,504465
201803,2018,경원선,한남,101039,35522,136561
201803,2018,경원선,회룡,260911,147235,408146
201803,2018,경원선,석계,266007,69031,335038
201803,2018,경원선,소요산,53737,72688,126425
201803,2018,경원선,방학,214423,112083,326506
201803,2018,경원선,보산,43898,15406,59304
201803,2018,경원선,서빙고,49379,17137,66516
201803,2018,경원선,신이문,239912,69246,309158
201803,2018,경원선,양주,240249,57762,298011
201803,2018,경원선,옥수,1482,114,1596
201803,2018,경원선,왕십리(성동구청),489659,64376,554035
201803,2018,경원선,외대앞,359045,60336,419381
201803,2018,경원선,월계,159976,59970,219946
201803,2018,경원선,응봉,43419,19481,62900
201803,2018,경원선,가능,174875,62690,237565
201803,2018,경원선,덕계,55108,17624,72732
201803,2018,경원선,덕정,204637,39604,244241
201803,2018,경원선,도봉,134007,74567,208574
201803,2018,경원선,도봉산,176670,101624,278294
201803,2018,경원선,동두천,58063,21420,79483
201803,2018,경원선,동두천중앙,82229,43568,125797
201803,2018,경원선,망월사,241450,74124,315574
201803,2018,경원선,광운대,282295,60071,342366
201803,2018,경원선,녹양,124088,37143,161231
201803,2018,경원선,녹천,123449,41932,165381
201803,2018,경의선,김포공항,11,1,12
201803,2018,경의선,금촌,187870,47133,235003
201803,2018,경의선,일산,247974,61899,309873
201803,2018,경의선,탄현,202550,38258,240808
201803,2018,경의선,파주,58840,8361,67201
201803,2018,경의선,풍산,124556,30652,155208
201803,2018,경의선,행신,213026,36249,249275
201803,2018,경의선,홍대입구,52807,5774,58581
201803,2018,경의선,화전,91886,9087,100973
201803,2018,경의선,효창공원앞,69176,13133,82309
201803,2018,경의선,서울역,77853,10565,88418
201803,2018,경의선,서울역,12,2,14
201803,2018,경의선,수색,57043,17769,74812
201803,2018,경의선,문산,151065,44533,195598
201803,2018,경의선,백마,185649,33048,218697
201803,2018,경의선,서강대,61553,10058,71611
201803,2018,경의선,신촌,22311,3510,25821
201803,2018,경의선,야당,113889,26208,140097
201803,2018,경의선,운정,142415,33374,175789
201803,2018,경의선,월롱,84364,8745,93109
201803,2018,경의선,가좌,116200,47901,164101
201803,2018,경의선,강매,69514,16705,86219
201803,2018,경의선,검암,4,0,4
201803,2018,경의선,계양,20,0,20
201803,2018,경의선,곡산,12630,4987,17617
201803,2018,경의선,공덕,80875,11918,92793
201803,2018,경의선,디지털미디어시티,59783,9225,69008
201803,2018,경의선,디지털미디어시티,2,0,2
201803,2018,경의선,금릉,129266,25206,154472
201803,2018,경의선,능곡,88946,31707,120653
201803,2018,경인선,인천,98364,38629,136993
201803,2018,경인선,제물포,324652,61721,386373
201803,2018,경인선,주안,706689,105669,812358
201803,2018,경인선,중동,249706,69293,318999
201803,2018,경인선,소사,359630,92837,452467
201803,2018,경인선,송내,922153,124292,1046445
201803,2018,경인선,백운,221975,68981,290956
201803,2018,경인선,부개,247136,68161,315297
201803,2018,경인선,부천,1110190,224541,1334731
201803,2018,경인선,부평,1069404,153991,1223395
201803,2018,경인선,역곡,889523,157506,1047029
201803,2018,경인선,오류동,283768,94749,378517
201803,2018,경인선,온수(성공회대입구),190890,48379,239269
201803,2018,경인선,간석,165568,46855,212423
201803,2018,경인선,개봉,603572,166097,769669
201803,2018,경인선,도원,100984,36655,137639
201803,2018,경인선,도화,92523,39021,131544
201803,2018,경인선,동암,497363,110705,608068
201803,2018,경인선,동인천,434224,131295,565519
201803,2018,경인선,구일,206791,38765,245556
201803,2018,경춘선,김유정,9960,3401,13361
201803,2018,경춘선,금곡,33142,16135,49277
201803,2018,경춘선,대성리,43095,5636,48731
201803,2018,경춘선,천마산,32398,16615,49013
201803,2018,경춘선,청평,49854,15956,65810
201803,2018,경춘선,춘천,51358,17859,69217
201803,2018,경춘선,퇴계원,87156,26075,113231
201803,2018,경춘선,평내호평,145714,42853,188567
201803,2018,경춘선,신내,16715,6997,23712
201803,2018,경춘선,백양리,3409,906,4315
201803,2018,경춘선,별내,58663,18159,76822
201803,2018,경춘선,사릉,96441,19628,116069
201803,2018,경춘선,상천,7197,4815,12012
201803,2018,경춘선,가평,46314,13009,59323
201803,2018,경춘선,갈매,53324,15395,68719
201803,2018,경춘선,강촌,17528,4043,21571
201803,2018,경춘선,마석,89135,33777,122912
201803,2018,경춘선,굴봉산,2881,2072,4953
201803,2018,경춘선,남춘천,78756,24822,103578
201803,2018,공항철도 1호선,인천공항1터미널,457424,38214,495638
201803,2018,공항철도 1호선,인천공항2터미널,158115,19435,177550
201803,2018,공항철도 1호선,청라국제도시,165634,9705,175339
201803,2018,공항철도 1호선,홍대입구,288728,17386,306114
201803,2018,공항철도 1호선,서울역,336636,34178,370814
201803,2018,공항철도 1호선,영종,50622,13435,64057
201803,2018,공항철도 1호선,김포공항,296579,19393,315972
201803,2018,공항철도 1호선,검암,249316,24440,273756
201803,2018,공항철도 1호선,계양,312768,31889,344657
201803,2018,공항철도 1호선,공덕,51272,6718,57990
201803,2018,공항철도 1호선,디지털미디어시티,354364,23817,378181
201803,2018,공항철도 1호선,공항화물청사,68715,7859,76574
201803,2018,공항철도 1호선,운서,165679,23505,189184
201803,2018,과천선,인덕원,729131,108632,837763
201803,2018,과천선,정부과천청사,326609,67163,393772
201803,2018,과천선,평촌,468687,68222,536909
201803,2018,과천선,대공원,83555,39714,123269
201803,2018,과천선,범계,843692,114734,958426
201803,2018,과천선,경마공원,154074,64630,218704
201803,2018,과천선,과천,116702,33321,150023
201803,2018,과천선,선바위,257640,34651,292291
201803,2018,분당선,가천대,330379,26521,356900
201803,2018,분당선,한티,384376,71421,455797
201803,2018,분당선,개포동,79506,21681,101187
201803,2018,분당선,도곡,177475,44645,222120
201803,2018,분당선,망포,398179,35067,433246
201803,2018,분당선,매교,72796,18702,91498
201803,2018,분당선,매탄권선,133352,16755,150107
201803,2018,분당선,구룡,54082,20333,74415
201803,2018,분당선,구성,121605,42070,163675
201803,2018,분당선,기흥,253593,37313,290906
201803,2018,분당선,대모산입구,69786,29650,99436
201803,2018,분당선,서현,753868,140213,894081
201803,2018,분당선,선릉,224229,28900,253129
201803,2018,분당선,선정릉,202078,38400,240478
201803,2018,분당선,수내,360942,88061,449003
201803,2018,분당선,수서,382242,67211,449453
201803,2018,분당선,수원,285696,30379,316075
201803,2018,분당선,수원시청,335305,38592,373897
201803,2018,분당선,신갈,115485,33440,148925
201803,2018,분당선,모란,588585,182176,770761
201803,2018,분당선,미금,501605,132451,634056
201803,2018,분당선,보정,65027,26788,91815
201803,2018,분당선,상갈,139584,33303,172887
201803,2018,분당선,서울숲,217681,23295,240976
201803,2018,분당선,압구정로데오,454811,42516,497327
201803,2018,분당선,야탑,750428,175937,926365
201803,2018,분당선,영통,286029,31835,317864
201803,2018,분당선,오리,363135,97504,460639
201803,2018,분당선,이매,153027,41558,194585
201803,2018,분당선,정자,463488,87635,551123
201803,2018,분당선,죽전,452586,85527,538113
201803,2018,분당선,청명,119852,18884,138736
201803,2018,분당선,태평,369194,96261,465455
201803,2018,분당선,강남구청,231758,41668,273426
201803,2018,수인선,남동인더스파크,59483,5412,64895
201803,2018,수인선,달월,2037,1262,3299
201803,2018,수인선,소래포구,109018,45885,154903
201803,2018,수인선,송도,70549,22312,92861
201803,2018,수인선,숭의,80157,27879,108036
201803,2018,수인선,신포,48627,12857,61484
201803,2018,수인선,호구포,96292,17613,113905
201803,2018,수인선,원인재,122249,28833,151082
201803,2018,수인선,월곶,75151,14428,89579
201803,2018,수인선,인천,22974,10003,32977
201803,2018,수인선,인천논현,163300,33833,197133
201803,2018,수인선,인하대,187567,24162,211729
201803,2018,수인선,연수,138374,29318,167692
201803,2018,안산선,고잔,257756,37765,295521
201803,2018,안산선,대야미,112596,25887,138483
201803,2018,안산선,수리산,109575,32963,142538
201803,2018,안산선,신길온천,47129,9420,56549
201803,2018,안산선,반월,122764,29577,152341
201803,2018,안산선,산본,466663,105986,572649
201803,2018,안산선,한대앞,270777,41723,312500
201803,2018,안산선,안산,481876,44613,526489
201803,2018,안산선,오이도,275334,37318,312652
201803,2018,경인선,동암,497363,110705,608068
201803,2018,경인선,동인천,434224,131295,565519
201803,2018,경인선,구일,206791,38765,245556
201803,2018,경춘선,김유정,9960,3401,13361
201803,2018,경춘선,금곡,33142,16135,49277
201803,2018,경춘선,대성리,43095,5636,48731
201803,2018,경춘선,천마산,32398,16615,49013
201803,2018,경춘선,청평,49854,15956,65810
201803,2018,경춘선,춘천,51358,17859,69217
201803,2018,경춘선,퇴계원,87156,26075,113231
201803,2018,경춘선,평내호평,145714,42853,188567
201803,2018,경춘선,신내,16715,6997,23712
201803,2018,경춘선,백양리,3409,906,4315
201803,2018,경춘선,별내,58663,18159,76822
201803,2018,경춘선,사릉,96441,19628,116069
201803,2018,경춘선,상천,7197,4815,12012
201803,2018,경춘선,가평,46314,13009,59323
201803,2018,경춘선,갈매,53324,15395,68719
201803,2018,경춘선,강촌,17528,4043,21571
201803,2018,경춘선,마석,89135,33777,122912
201803,2018,경춘선,굴봉산,2881,2072,4953
201803,2018,경춘선,남춘천,78756,24822,103578
201803,2018,공항철도 1호선,인천공항1터미널,457424,38214,495638
201803,2018,공항철도 1호선,인천공항2터미널,158115,19435,177550
201803,2018,공항철도 1호선,청라국제도시,165634,9705,175339
201803,2018,공항철도 1호선,홍대입구,288728,17386,306114
201803,2018,공항철도 1호선,서울역,336636,34178,370814
201803,2018,공항철도 1호선,영종,50622,13435,64057
201803,2018,공항철도 1호선,김포공항,296579,19393,315972
201803,2018,공항철도 1호선,검암,249316,24440,273756
201803,2018,공항철도 1호선,계양,312768,31889,344657
201803,2018,공항철도 1호선,공덕,51272,6718,57990
201803,2018,공항철도 1호선,디지털미디어시티,354364,23817,378181
201803,2018,공항철도 1호선,공항화물청사,68715,7859,76574
201803,2018,공항철도 1호선,운서,165679,23505,189184
201803,2018,과천선,인덕원,729131,108632,837763
201803,2018,과천선,정부과천청사,326609,67163,393772
201803,2018,과천선,평촌,468687,68222,536909
201803,2018,과천선,대공원,83555,39714,123269
201803,2018,과천선,범계,843692,114734,958426
201803,2018,과천선,경마공원,154074,64630,218704
201803,2018,과천선,과천,116702,33321,150023
201803,2018,과천선,선바위,257640,34651,292291
201803,2018,분당선,가천대,330379,26521,356900
201803,2018,분당선,한티,384376,71421,455797
201803,2018,분당선,개포동,79506,21681,101187
201803,2018,분당선,도곡,177475,44645,222120
201803,2018,분당선,망포,398179,35067,433246
201803,2018,분당선,매교,72796,18702,91498
201803,2018,분당선,매탄권선,133352,16755,150107
201803,2018,분당선,구룡,54082,20333,74415
201803,2018,분당선,구성,121605,42070,163675
201803,2018,분당선,기흥,253593,37313,290906
201803,2018,분당선,대모산입구,69786,29650,99436
201803,2018,분당선,서현,753868,140213,894081
201803,2018,분당선,선릉,224229,28900,253129
201803,2018,분당선,선정릉,202078,38400,240478
201803,2018,분당선,수내,360942,88061,449003
201803,2018,분당선,수서,382242,67211,449453
201803,2018,분당선,수원,285696,30379,316075
201803,2018,분당선,수원시청,335305,38592,373897
201803,2018,분당선,신갈,115485,33440,148925
201803,2018,분당선,모란,588585,182176,770761
201803,2018,분당선,미금,501605,132451,634056
201803,2018,분당선,보정,65027,26788,91815
201803,2018,분당선,상갈,139584,33303,172887
201803,2018,분당선,서울숲,217681,23295,240976
201803,2018,분당선,압구정로데오,454811,42516,497327
201803,2018,분당선,야탑,750428,175937,926365
201803,2018,분당선,영통,286029,31835,317864
201803,2018,분당선,오리,363135,97504,460639
201803,2018,분당선,이매,153027,41558,194585
201803,2018,분당선,정자,463488,87635,551123
201803,2018,경인선,오류동,283768,94749,378517
201803,2018,경인선,역곡,889523,157506,1047029
201803,2018,경인선,부평,1069404,153991,1223395
201803,2018,경인선,부천,1110190,224541,1334731
201803,2018,경인선,부개,247136,68161,315297
201803,2018,경인선,백운,221975,68981,290956
201803,2018,경인선,송내,922153,124292,1046445
201803,2018,경인선,소사,359630,92837,452467
201803,2018,경인선,중동,249706,69293,318999
201803,2018,경인선,주안,706689,105669,812358
201803,2018,경인선,제물포,324652,61721,386373
201803,2018,경인선,인천,98364,38629,136993
201803,2018,경의선,능곡,88946,31707,120653
201803,2018,경의선,금릉,129266,25206,154472
201803,2018,경의선,디지털미디어시티,2,0,2
201803,2018,경의선,디지털미디어시티,59783,9225,69008
201803,2018,경의선,공덕,80875,11918,92793
201803,2018,경의선,곡산,12630,4987,17617
201803,2018,경의선,계양,20,0,20
201803,2018,경의선,검암,4,0,4
201803,2018,경의선,강매,69514,16705,86219
201803,2018,경의선,가좌,116200,47901,164101
201803,2018,경의선,월롱,84364,8745,93109
201803,2018,경의선,운정,142415,33374,175789
201803,2018,경의선,야당,113889,26208,140097
201803,2018,경의선,신촌,22311,3510,25821
201803,2018,경의선,서강대,61553,10058,71611
201803,2018,경의선,백마,185649,33048,218697
201803,2018,경의선,문산,151065,44533,195598
201803,2018,경의선,수색,57043,17769,74812
201803,2018,경의선,서울역,12,2,14
201803,2018,경의선,서울역,77853,10565,88418
201803,2018,경의선,효창공원앞,69176,13133,82309
201803,2018,경의선,화전,91886,9087,100973
201803,2018,경의선,홍대입구,52807,5774,58581
201803,2018,경의선,행신,213026,36249,249275
201803,2018,경의선,풍산,124556,30652,155208
201803,2018,경의선,파주,58840,8361,67201
201803,2018,경인선,온수(성공회대입구),190890,48379,239269
201803,2018,경의선,탄현,202550,38258,240808
201803,2018,경의선,일산,247974,61899,309873
201803,2018,경의선,금촌,187870,47133,235003
201803,2018,경의선,김포공항,11,1,12
201803,2018,경원선,녹천,123449,41932,165381
201803,2018,경원선,녹양,124088,37143,161231
201803,2018,경원선,광운대,282295,60071,342366
201803,2018,경원선,망월사,241450,74124,315574
201803,2018,경원선,동두천중앙,82229,43568,125797
201803,2018,경원선,동두천,58063,21420,79483
201803,2018,경원선,도봉산,176670,101624,278294
201803,2018,경원선,도봉,134007,74567,208574
201803,2018,경원선,덕정,204637,39604,244241
201803,2018,경원선,덕계,55108,17624,72732
201803,2018,경원선,가능,174875,62690,237565
201803,2018,경원선,응봉,43419,19481,62900
201803,2018,경원선,월계,159976,59970,219946
201803,2018,경원선,외대앞,359045,60336,419381
201803,2018,경원선,왕십리(성동구청),489659,64376,554035
201803,2018,경원선,옥수,1482,114,1596
201803,2018,경원선,양주,240249,57762,298011
201803,2018,경원선,신이문,239912,69246,309158
201803,2018,경원선,서빙고,49379,17137,66516
201803,2018,경원선,보산,43898,15406,59304
201803,2018,경원선,방학,214423,112083,326506
201803,2018,경원선,소요산,53737,72688,126425
201803,2018,경원선,석계,266007,69031,335038
201803,2018,경원선,회룡,260911,147235,408146
201803,2018,경원선,한남,101039,35522,136561
201803,2018,경원선,청량리(서울시립대입구),356857,147608,504465
201803,2018,경원선,창동,1,0,1
201803,2018,경원선,지행,195581,47022,242603
201803,2018,경원선,이촌(국립중앙박물관),111704,31984,143688
201803,2018,경원선,의정부,570488,126511,696999
201803,2018,경부선,석수,328224,51261,379485
201803,2018,경부선,서울역,185103,12951,198054
201803,2018,안산선,정왕,289379,24177,313556
201803,2018,안산선,중앙,510538,60834,571372
201803,2018,안산선,초지,145798,16175,161973
201803,2018,안산선,상록수,600785,88754,689539
201803,2018,우이신설선,4.19민주묘지,79007,27337,106344
201803,2018,우이신설선,가오리,77144,42784,119928
201803,2018,우이신설선,성신여대입구(돈암),96091,31932,128023
201803,2018,우이신설선,솔밭공원,46336,24623,70959
201803,2018,우이신설선,솔샘,129232,32935,162167
201803,2018,우이신설선,보문,32036,14959,46995
201803,2018,우이신설선,화계,57156,36225,93381
201803,2018,우이신설선,북한산우이,58493,31283,89776
201803,2018,우이신설선,삼양,37607,25513,63120
201803,2018,우이신설선,삼양사거리,38238,31947,70185
201803,2018,우이신설선,신설동,34133,16418,50551
201803,2018,1호선,동대문,344838,144807,489645
201803,2018,1호선,동묘앞,186399,161159,347558
201803,2018,1호선,시청,661782,111157,772939
201803,2018,1호선,서울역,1455338,228041,1683379
201803,2018,1호선,청량리(서울시립대입구),523932,332933,856865
201803,2018,1호선,제기동,303632,349589,653221
201803,2018,1호선,종각,1236445,170206,1406651
201803,2018,1호선,종로3가,698691,401375,1100066
201803,2018,1호선,종로5가,557447,302624,860071
201803,2018,1호선,신설동,389298,132858,522156
201803,2018,2호선,강남,3034426,183497,3217923
201803,2018,2호선,홍대입구,2470011,122278,2592289
201803,2018,2호선,건대입구,1394861,102806,1497667
201803,2018,2호선,도림천,31239,6580,37819
201803,2018,2호선,동대문역사문화공원,540948,64548,605496
201803,2018,2호선,뚝섬,476502,68513,545015
201803,2018,2호선,교대(법원.검찰청),986389,179200,1165589
201803,2018,2호선,구로디지털단지,1803465,178348,1981813
201803,2018,2호선,구의(광진구청),649073,112520,761593
201803,2018,2호선,낙성대,864570,117594,982164
201803,2018,2호선,당산,603961,72675,676636
201803,2018,2호선,대림(구로구청),825496,123373,948869
201803,2018,2호선,서초,637541,94228,731769
201803,2018,2호선,선릉,1492095,224007,1716102
201803,2018,2호선,성수,741914,108149,850063
201803,2018,2호선,시청,704871,67465,772336
201803,2018,2호선,문래,526025,90157,616182
201803,2018,2호선,방배,609333,87264,696597
201803,2018,2호선,봉천,597792,158677,756469
201803,2018,2호선,사당,1128276,223582,1351858
201803,2018,2호선,삼성(무역센터),1684625,131921,1816546
201803,2018,2호선,상왕십리,375885,71020,446905
201803,2018,2호선,서울대입구(관악구청),1525004,220064,1745068
201803,2018,2호선,신답,34476,10985,45461
201803,2018,2호선,신당,378721,111562,490283
201803,2018,2호선,신대방,773266,139879,913145
201803,2018,2호선,신도림,1709060,221529,1930589
201803,2018,2호선,신림,1985706,256962,2242668
201803,2018,2호선,신설동,106589,42787,149376
201803,2018,2호선,신정네거리,241772,68017,309789
201803,2018,2호선,신촌,1493965,149123,1643088
201803,2018,2호선,아현,275754,67642,343396
201803,2018,2호선,양천구청,175775,47497,223272
201803,2018,2호선,역삼,1287032,158222,1445254
201803,2018,2호선,영등포구청,583438,110842,694280
201803,2018,2호선,왕십리(성동구청),591685,62080,653765
201803,2018,2호선,용답,72242,18121,90363
201803,2018,2호선,용두(동대문구청),51145,24778,75923
201803,2018,2호선,을지로3가,576045,94921,670966
201803,2018,2호선,을지로4가,299877,97514,397391
201803,2018,2호선,을지로입구,1462219,123805,1586024
201803,2018,2호선,이대,642722,71935,714657
201803,2018,2호선,잠실(송파구청),2514484,236514,2750998
201803,2018,2호선,잠실나루,447474,95463,542937
201803,2018,2호선,잠실새내,721478,126809,848287
201803,2018,2호선,종합운동장,379251,56021,435272
201803,2018,2호선,충정로(경기대입구),306366,57243,363609
201803,2018,2호선,한양대,404545,16731,421276
201803,2018,2호선,합정,982177,78093,1060270
201803,2018,2호선,강변(동서울터미널),1327074,150927,1478001
201803,2018,3호선,가락시장,249031,77865,326896
201803,2018,3호선,홍제,487041,157276,644317
201803,2018,3호선,경찰병원,199998,42238,242236
201803,2018,3호선,고속터미널,1703305,196614,1899919
201803,2018,3호선,도곡,177537,31425,208962
201803,2018,3호선,독립문,194730,79936,274666
201803,2018,3호선,동대입구,344881,37954,382835
201803,2018,3호선,매봉,290012,59455,349467
201803,2018,3호선,교대(법원.검찰청),394456,77533,471989
201803,2018,3호선,구파발,545590,105917,651507
201803,2018,3호선,금호,220206,59474,279680
201803,2018,3호선,남부터미널(예술의전당),965670,138505,1104175
201803,2018,3호선,녹번,354314,69070,423384
201803,2018,3호선,대청,265962,56064,322026
201803,2018,3호선,대치,339484,66391,405875
201803,2018,3호선,수서,460389,106019,566408
201803,2018,3호선,무악재,95400,32802,128202
201803,2018,3호선,불광,459825,158221,618046
201803,2018,3호선,신사,944793,78515,1023308
201803,2018,3호선,안국,683879,135744,819623
201803,2018,3호선,압구정,915346,159549,1074895
201803,2018,3호선,약수,362343,89886,452229
201803,2018,3호선,양재(서초구청),1130906,181146,1312052
201803,2018,3호선,연신내,1081275,283023,1364298
201803,2018,3호선,오금,193791,30687,224478
201803,2018,3호선,옥수,255442,64497,319939
201803,2018,3호선,을지로3가,255957,63001,318958
201803,2018,3호선,일원,233068,62482,295550
201803,2018,3호선,잠원,159803,38271,198074
201803,2018,3호선,종로3가,233338,61980,295318
201803,2018,3호선,지축,27568,10673,38241
201803,2018,3호선,충무로,55,1,56
201803,2018,3호선,학여울,82050,19106,101156
201803,2018,우이신설선,정릉,88041,41614,129655
201803,2018,우이신설선,북한산보국문,144451,39793,184244
201803,2018,3호선,경복궁(정부서울청사),724881,100641,825522
201803,2018,4호선,동대문,651580,172198,823778
201803,2018,4호선,회현(남대문시장),761089,234770,995859
201803,2018,4호선,동작(현충원),53586,20687,74273
201803,2018,4호선,길음,661630,133361,794991
201803,2018,4호선,남태령,103562,10685,114247
201803,2018,4호선,노원,622226,98608,720834
201803,2018,4호선,당고개,317671,97226,414897
201803,2018,4호선,서울역,375430,43424,418854
201803,2018,4호선,성신여대입구(돈암),735813,99091,834904
201803,2018,4호선,수유(강북구청),1042293,226426,1268719
201803,2018,4호선,숙대입구(갈월),514574,61586,576160
201803,2018,4호선,명동,1237402,77669,1315071
201803,2018,4호선,미아(서울사이버대학),451387,128159,579546
201803,2018,4호선,미아사거리,776870,191130,968000
201803,2018,4호선,사당,839854,100016,939870
201803,2018,4호선,삼각지,127172,30359,157531
201803,2018,4호선,상계,560976,125028,686004
201803,2018,4호선,신용산,422153,52607,474760
201803,2018,4호선,쌍문,892536,177238,1069774
201803,2018,4호선,이촌(국립중앙박물관),242359,50645,293004
201803,2018,4호선,창동,730930,202527,933457
201803,2018,4호선,총신대입구(이수),535025,156102,691127
201803,2018,4호선,충무로,941994,136726,1078720
201803,2018,4호선,한성대입구(삼선교),479321,83153,562474
201803,2018,4호선,혜화,1195672,140467,1336139
201803,2018,4호선,동대문역사문화공원,677292,69214,746506
201803,2018,5호선,강동,539299,105691,644990
201803,2018,5호선,화곡,802451,150103,952554
201803,2018,5호선,개화산,149143,37313,186456
201803,2018,5호선,거여,167272,54304,221576
201803,2018,5호선,고덕,246658,66519,313177
201803,2018,일산선,마두,187242,81171,268413
201803,2018,5호선,공덕,379325,49539,428864
201803,2018,5호선,동대문역사문화공원,77450,9310,86760
201803,2018,5호선,둔촌동,248670,70205,318875
201803,2018,5호선,마곡,215416,28465,243881
201803,2018,5호선,마장,155931,45520,201451
201803,2018,5호선,마천,116581,50346,166927
201803,2018,5호선,마포,372052,69629,441681
201803,2018,5호선,광나루(장신대),404152,73222,477374
201803,2018,5호선,광화문(세종문화회관),1034708,98743,1133451
201803,2018,5호선,군자(능동),315668,42236,357904
201803,2018,5호선,굽은다리(강동구민회관앞),248382,68541,316923
201803,2018,5호선,길동,179752,64176,243928
201803,2018,5호선,김포공항,217179,31082,248261
201803,2018,5호선,까치산,806137,162371,968508
201803,2018,5호선,답십리,437831,89626,527457
201803,2018,5호선,송정,235837,63754,299591
201803,2018,5호선,신금호,161791,38914,200705
201803,2018,5호선,신길,91449,13265,104714
201803,2018,5호선,명일,204196,66190,270386
201803,2018,5호선,목동,499680,90247,589927
201803,2018,5호선,발산,470989,73560,544549
201803,2018,5호선,방이,189663,46862,236525
201803,2018,5호선,방화,186467,50364,236831
201803,2018,5호선,상일동,323664,69282,392946
201803,2018,5호선,서대문,481766,73199,554965
201803,2018,5호선,신정(은행정),398543,63891,462434
201803,2018,5호선,아차산(어린이대공원후문),393844,101187,495031
201803,2018,5호선,애오개,192133,41165,233298
201803,2018,5호선,양평,172581,30270,202851
201803,2018,5호선,여의나루,325339,28867,354206
201803,2018,5호선,여의도,650390,55005,705395
201803,2018,5호선,영등포구청,90672,20811,111483
201803,2018,5호선,영등포시장,220415,83277,303692
201803,2018,5호선,오금,98235,18957,117192
201803,2018,5호선,오목교(목동운동장앞),703583,89975,793558
201803,2018,5호선,올림픽공원(한국체대),164294,36851,201145
201803,2018,5호선,왕십리(성동구청),133911,27459,161370
201803,2018,5호선,우장산,420558,86709,507267
201803,2018,5호선,을지로4가,111817,44463,156280
201803,2018,5호선,장한평,491299,101918,593217
201803,2018,5호선,종로3가,364615,129133,493748
201803,2018,5호선,천호(풍납토성),508795,155025,663820
201803,2018,5호선,청구,105342,28873,134215
201803,2018,5호선,충정로(경기대입구),131080,17362,148442
201803,2018,5호선,행당,222066,51565,273631
201803,2018,5호선,개롱,169932,47625,217557
201803,2018,6호선,고려대(종암),284567,37985,322552
201803,2018,6호선,효창공원앞,198205,44786,242991
201803,2018,6호선,독바위,70806,21960,92766
201803,2018,6호선,돌곶이,229121,63730,292851
201803,2018,6호선,동묘앞,231663,73541,305204
201803,2018,6호선,디지털미디어시티,372568,58670,431238
201803,2018,6호선,마포구청,361655,85347,447002
201803,2018,6호선,망원,360194,88841,449035
201803,2018,6호선,광흥창(서강),239621,62898,302519
201803,2018,6호선,구산,202457,58617,261074
201803,2018,6호선,녹사평(용산구청),209740,21868,231608
201803,2018,6호선,대흥(서강대앞),240802,50290,291092
201803,2018,6호선,석계,351403,79262,430665
201803,2018,6호선,버티고개,65139,15950,81089
201803,2018,6호선,보문,214604,36111,250715
201803,2018,6호선,봉화산(서울의료원),251478,55350,306828
201803,2018,6호선,불광,132660,43501,176161
201803,2018,6호선,삼각지,212006,19686,231692
201803,2018,6호선,상수,333131,24124,357255
201803,2018,6호선,상월곡(한국과학기술연구원),164965,43114,208079
201803,2018,6호선,새절(신사),359969,91040,451009
201803,2018,6호선,신당,246230,42533,288763
201803,2018,6호선,안암(고대병원앞),471463,35686,507149
201803,2018,6호선,약수,93348,25138,118486
201803,2018,6호선,역촌,87235,37160,124395
201803,2018,6호선,연신내,18,0,18
201803,2018,6호선,월곡(동덕여대),359142,79353,438495
201803,2018,6호선,월드컵경기장(성산),125900,52225,178125
201803,2018,6호선,응암,459952,120128,580080
201803,2018,6호선,이태원,541037,37998,579035
201803,2018,6호선,증산(명지대앞),266483,74157,340640
201803,2018,6호선,창신,102433,18097,120530
201803,2018,6호선,청구,100273,20265,120538
201803,2018,6호선,태릉입구,149524,29447,178971
201803,2018,6호선,한강진,224242,16009,240251
201803,2018,6호선,합정,464383,43602,507985
201803,2018,6호선,화랑대(서울여대입구),384325,49198,433523
201803,2018,6호선,공덕,498985,77449,576434
201803,2018,7호선,가산디지털단지,1145064,83776,1228840
201803,2018,7호선,학동,598909,64047,662956
201803,2018,7호선,건대입구,482349,57958,540307
201803,2018,7호선,고속터미널,575043,83873,658916
201803,2018,7호선,도봉산,260421,41586,302007
201803,2018,7호선,뚝섬유원지,243058,41315,284373
201803,2018,7호선,마들,305706,81493,387199
201803,2018,7호선,먹골,278988,64392,343380
201803,2018,7호선,면목,450082,89750,539832
201803,2018,7호선,공릉(서울과학기술대),366189,71319,437508
201803,2018,7호선,광명사거리,702912,155055,857967
201803,2018,7호선,군자(능동),382542,81631,464173
201803,2018,7호선,굴포천,258206,36689,294895
201803,2018,7호선,까치울,203949,25764,229713
201803,2018,7호선,남구로,447516,62252,509768
201803,2018,7호선,남성,301422,74564,375986
201803,2018,7호선,내방,387379,68949,456328
201803,2018,7호선,노원,546034,122872,668906
201803,2018,7호선,논현,547397,55583,602980
201803,2018,7호선,대림(구로구청),295491,37243,332734
201803,2018,7호선,수락산,354457,95694,450151
201803,2018,7호선,숭실대입구(살피재),486954,63904,550858
201803,2018,7호선,반포,173393,35314,208707
201803,2018,7호선,보라매,249014,44959,293973
201803,2018,7호선,부천시청,348816,50297,399113
201803,2018,7호선,부천종합운동장,146037,18858,164895
201803,2018,7호선,부평구청,343397,32212,375609
201803,2018,7호선,사가정,415672,98349,514021
201803,2018,7호선,삼산체육관,140496,25209,165705
201803,2018,7호선,상도,322301,63135,385436
201802,2018,과천선,대공원,63175,25011,88186
201802,2018,3호선,잠원,126547,30101,156648
201802,2018,경강선,이천,58500,9793,68293
201802,2018,경강선,이매,32150,6910,39060
201802,2018,경의선,파주,27338,6125,33463
201802,2018,중앙선,국수,13397,6891,20288
201802,2018,중앙선,팔당,17261,4784,22045
201802,2018,중앙선,지평,570,467,1037
201802,2018,중앙선,중랑,106051,42713,148764
201802,2018,중앙선,원덕,5800,5055,10855
201802,2018,중앙선,운길산,13535,4728,18263
201802,2018,중앙선,용문,38340,27726,66066
201802,2018,중앙선,오빈,5203,3022,8225
201802,2018,중앙선,양평,67679,26808,94487
201802,2018,중앙선,양정,14721,5673,20394
201802,2018,중앙선,양원,25712,13066,38778
201802,2018,중앙선,양수,33887,13208,47095
201802,2018,중앙선,아신,11617,4537,16154
201802,2018,중앙선,신원,3119,2067,5186
201802,2018,중앙선,상봉(시외버스터미널),151094,33833,184927
201802,2018,중앙선,망우,155770,56356,212126
201802,2018,중앙선,도심,50004,16240,66244
201802,2018,중앙선,도농,178149,46648,224797
201802,2018,중앙선,덕소,121668,40700,162368
201802,2018,중앙선,회기,601009,107071,708080
201802,2018,중앙선,구리,283859,68150,352009
201802,2018,장항선,배방,20606,6180,26786
201802,2018,장항선,아산,65856,7946,73802
201802,2018,장항선,봉명,23105,11395,34500
201802,2018,장항선,온양온천,82815,56698,139513
201802,2018,장항선,신창(순천향대),28349,6126,34475
201802,2018,장항선,쌍용(나사렛대),43578,11856,55434
201802,2018,일산선,백석,246913,65235,312148
201802,2018,일산선,삼송,350150,72142,422292
201802,2018,일산선,원당,239866,69425,309291
201802,2018,일산선,원흥,164200,34126,198326
201802,2018,일산선,정발산,189905,45213,235118
201802,2018,일산선,주엽,171435,77783,249218
201802,2018,일산선,대화,305703,75467,381170
201802,2018,일산선,마두,154386,62572,216958
201802,2018,일산선,화정,403735,107446,511181
201802,2018,일산선,대곡,31289,8466,39755
201802,2018,우이신설선,삼양사거리,32327,25619,57946
201802,2018,우이신설선,정릉,69243,32799,102042
201802,2018,우이신설선,신설동,26977,12158,39135
201802,2018,우이신설선,솔샘,106579,26135,132714
201802,2018,우이신설선,솔밭공원,38535,19694,58229
201802,2018,우이신설선,성신여대입구(돈암),74370,25854,100224
201802,2018,우이신설선,화계,47280,28994,76274
201802,2018,우이신설선,삼양,31721,20547,52268
201802,2018,우이신설선,북한산우이,38282,25167,63449
201802,2018,우이신설선,북한산보국문,108693,31402,140095
201802,2018,우이신설선,보문,25433,12202,37635
201802,2018,우이신설선,가오리,64557,33343,97900
201802,2018,우이신설선,4.19민주묘지,40913,21229,62142
201802,2018,안산선,신길온천,37452,6763,44215
201802,2018,안산선,초지,85044,12384,97428
201802,2018,안산선,중앙,406527,46404,452931
201802,2018,안산선,정왕,194518,18411,212929
201802,2018,안산선,오이도,207894,25647,233541
201802,2018,안산선,안산,420002,35126,455128
201802,2018,안산선,한대앞,191081,32306,223387
201802,2018,안산선,수리산,87379,26520,113899
201802,2018,안산선,상록수,455991,69359,525350
201802,2018,안산선,산본,387529,83069,470598
201802,2018,안산선,반월,99977,23004,122981
201802,2018,안산선,대야미,88537,18904,107441
201802,2018,안산선,고잔,202891,28670,231561
201802,2018,수인선,연수,107505,22196,129701
201802,2018,수인선,인하대,110010,17675,127685
201802,2018,수인선,인천논현,131100,26414,157514
201802,2018,수인선,인천,18282,7799,26081
201802,2018,수인선,월곶,55811,9984,65795
201802,2018,수인선,원인재,97224,22582,119806
201802,2018,수인선,호구포,78680,14273,92953
201802,2018,수인선,신포,34134,9611,43745
201802,2018,수인선,숭의,64293,20550,84843
201802,2018,수인선,송도,56407,16769,73176
201802,2018,수인선,소래포구,83298,27634,110932
201802,2018,수인선,달월,1785,1069,2854
201802,2018,수인선,남동인더스파크,47524,4457,51981
201802,2018,분당선,강남구청,190512,32698,223210
201802,2018,분당선,태평,308983,77986,386969
201802,2018,분당선,청명,95450,14527,109977
201802,2018,분당선,죽전,331952,66053,398005
201802,2018,분당선,정자,391830,68145,459975
201802,2018,분당선,이매,119044,32850,151894
201802,2018,분당선,오리,304325,77751,382076
201802,2018,분당선,영통,212760,24796,237556
201802,2018,분당선,야탑,628741,136161,764902
201802,2018,분당선,압구정로데오,371938,33419,405357
201802,2018,분당선,신갈,96659,26363,123022
201802,2018,분당선,수원시청,275272,29552,304824
201802,2018,분당선,수원,230683,23167,253850
201802,2018,분당선,수서,326529,53701,380230
201802,2018,분당선,수내,311304,68248,379552
201802,2018,분당선,선정릉,166556,31177,197733
201802,2018,분당선,선릉,186068,22967,209035
201802,2018,분당선,서현,660789,110178,770967
201802,2018,분당선,서울숲,172794,18288,191082
201802,2018,분당선,상갈,114109,26296,140405
201802,2018,분당선,복정,2,0,2
201802,2018,분당선,보정,50143,20492,70635
201802,2018,분당선,미금,423192,103500,526692
201802,2018,분당선,모란,477306,135116,612422
201802,2018,분당선,매탄권선,102733,12974,115707
201802,2018,분당선,매교,52074,15048,67122
201802,2018,분당선,망포,320940,26742,347682
201802,2018,분당선,도곡,141107,34708,175815
201802,2018,분당선,대모산입구,55461,24349,79810
201802,2018,분당선,기흥,181680,29257,210937
201802,2018,분당선,구성,97391,32014,129405
201802,2018,분당선,구룡,35019,15671,50690
201802,2018,분당선,개포동,63113,16558,79671
201802,2018,분당선,한티,333012,57845,390857
201802,2018,분당선,가천대,150798,21969,172767
201802,2018,과천선,과천,92146,26397,118543
201802,2018,과천선,범계,690899,89417,780316
201802,2018,과천선,선바위,198422,25172,223594
201802,2018,과천선,인덕원,574263,85068,659331
201802,2018,과천선,정부과천청사,272565,53948,326513
201802,2018,과천선,평촌,382910,54034,436944
201802,2018,과천선,경마공원,105381,44325,149706
201802,2018,공항철도 1호선,서울역,305438,27133,332571
201802,2018,공항철도 1호선,영종,42886,10006,52892
201802,2018,공항철도 1호선,인천공항1터미널,409256,28005,437261
201802,2018,공항철도 1호선,운서,152707,18844,171551
201802,2018,공항철도 1호선,인천공항2터미널,159206,18162,177368
201802,2018,공항철도 1호선,청라국제도시,138491,7550,146041
201802,2018,공항철도 1호선,홍대입구,232596,13900,246496
201802,2018,공항철도 1호선,검암,216365,19359,235724
201802,2018,공항철도 1호선,계양,255596,24858,280454
201802,2018,공항철도 1호선,공덕,45000,5565,50565
201802,2018,공항철도 1호선,공항화물청사,58586,6423,65009
201802,2018,공항철도 1호선,김포공항,271121,15369,286490
201802,2018,공항철도 1호선,디지털미디어시티,293831,18787,312618
201802,2018,경춘선,대성리,13571,3777,17348
201802,2018,경춘선,신내,11193,5252,16445
201802,2018,경춘선,별내,44904,13531,58435
201802,2018,경춘선,천마산,24173,12636,36809
201802,2018,경춘선,강촌,10590,2783,13373
201802,2018,경춘선,갈매,41338,11641,52979
201802,2018,경춘선,가평,43481,9504,52985
201802,2018,경춘선,상천,4967,3810,8777
201802,2018,경춘선,사릉,70336,14810,85146
201802,2018,경춘선,춘천,33943,12175,46118
201802,2018,경춘선,백양리,10047,655,10702
201802,2018,경춘선,굴봉산,3658,1240,4898
201802,2018,경춘선,금곡,25111,11885,36996
201802,2018,경춘선,김유정,8333,2671,11004
201802,2018,경춘선,퇴계원,66677,19315,85992
201802,2018,경춘선,남춘천,55449,18512,73961
201802,2018,경춘선,마석,64810,24699,89509
201802,2018,경춘선,청평,43620,11737,55357
201802,2018,경춘선,평내호평,113252,33342,146594
201802,2018,경인선,온수(성공회대입구),137139,37589,174728
201802,2018,경인선,오류동,223744,72955,296699
201802,2018,경인선,역곡,665386,125201,790587
201802,2018,경인선,송내,722219,96592,818811
201802,2018,경인선,소사,274208,72634,346842
201802,2018,경인선,부평,929551,122882,1052433
201802,2018,경인선,부천,908071,180177,1088248
201802,2018,경인선,부개,198658,54027,252685
201802,2018,경인선,백운,174795,54685,229480
201802,2018,경인선,동인천,351970,101380,453350
201802,2018,경인선,동암,408707,88049,496756
201802,2018,경인선,도화,70187,29892,100079
201802,2018,경인선,도원,58868,28366,87234
201802,2018,경인선,구일,135378,29863,165241
201802,2018,경인선,개봉,489290,131391,620681
201802,2018,경인선,간석,133460,36256,169716
201802,2018,경인선,중동,203129,54799,257928
201802,2018,경인선,주안,541215,85508,626723
201802,2018,경인선,제물포,218015,47497,265512
201802,2018,경인선,인천,80321,25468,105789
201802,2018,경의선,월롱,55634,6448,62082
201802,2018,경의선,신촌,15217,2637,17854
201802,2018,경의선,수색,46187,15584,61771
201802,2018,경의선,서울역,13,0,13
201802,2018,경의선,서울역,62567,7538,70105
201802,2018,경의선,서강대,44750,7631,52381
201802,2018,경의선,백마,145051,25608,170659
201802,2018,경의선,문산,128298,33627,161925
201802,2018,경의선,디지털미디어시티,45792,7213,53005
201802,2018,경의선,능곡,71642,24151,95793
201802,2018,경의선,김포공항,10,0,10
201802,2018,경의선,금촌,152737,37067,189804
201802,2018,경의선,금릉,103313,19980,123293
201802,2018,경의선,공덕,1,0,1
201802,2018,경의선,공덕,66333,9423,75756
201802,2018,경의선,곡산,9649,3657,13306
201802,2018,경의선,계양,5,0,5
201802,2018,경의선,검암,2,0,2
201802,2018,경의선,강매,54081,12697,66778
201802,2018,경의선,가좌,89000,37649,126649
201802,2018,경의선,효창공원앞,49584,10296,59880
201802,2018,경의선,화전,32403,6732,39135
201802,2018,경의선,홍대입구,2,0,2
201802,2018,경의선,홍대입구,41814,4464,46278
201802,2018,경의선,행신,171889,28524,200413
201802,2018,경의선,풍산,99405,23346,122751
201802,2018,경의선,탄현,161582,29225,190807
201802,2018,경의선,일산,191191,46974,238165
201802,2018,경의선,야당,90304,19896,110200
201802,2018,경의선,운정,112458,25480,137938
201802,2018,경원선,회룡,211658,113042,324700
201802,2018,경원선,한남,84445,28220,112665
201802,2018,경원선,청량리(서울시립대입구),325782,122017,447799
201802,2018,경원선,창동,3,0,3
201802,2018,경원선,지행,149128,36500,185628
201802,2018,경원선,이촌(국립중앙박물관),89542,24908,114450
201802,2018,경원선,의정부,480670,99034,579704
201802,2018,경원선,응봉,32306,14682,46988
201802,2018,경원선,월계,85907,47114,133021
201802,2018,경원선,외대앞,234393,48723,283116
201802,2018,경원선,왕십리(성동구청),376895,52362,429257
201802,2018,경원선,옥수,1224,89,1313
201802,2018,경원선,양주,189276,44001,233277
201802,2018,경원선,신이문,195351,56375,251726
201802,2018,경원선,소요산,50328,46303,96631
201802,2018,경원선,석계,206754,54765,261519
201802,2018,경원선,서빙고,38008,13391,51399
201802,2018,경원선,보산,36295,11822,48117
201802,2018,경원선,방학,172935,89371,262306
201802,2018,경원선,망월사,144155,59188,203343
201802,2018,경원선,동두천중앙,67041,33769,100810
201802,2018,경원선,동두천,39760,15568,55328
201802,2018,경원선,도봉산,139703,71926,211629
201802,2018,경원선,도봉,109198,58680,167878
201802,2018,경원선,덕정,136792,28564,165356
201802,2018,경원선,덕계,40721,13388,54109
201802,2018,경원선,녹천,97894,33410,131304
201802,2018,경원선,녹양,98202,28222,126424
201802,2018,경원선,광운대,184591,48165,232756
201802,2018,경원선,가능,138328,49685,188013
201802,2018,경부선,성환,80511,17012,97523
201802,2018,경부선,가산디지털단지,369124,24564,393688
201802,2018,경부선,관악,169145,45291,214436
201802,2018,경부선,광명,51823,3747,55570
201802,2018,경부선,구로,463723,81366,545089
201802,2018,경부선,군포,163071,28260,191331
201802,2018,경부선,금정,624162,89770,713932
201802,2018,경부선,금천구청,234921,62703,297624
201802,2018,경부선,남영,231319,33122,264441
201802,2018,경부선,노량진,330248,45175,375423
201802,2018,경부선,당정,153819,23888,177707
201802,2018,경부선,대방,325183,62089,387272
201802,2018,경부선,평택,311768,56050,367818
201802,2018,경부선,천안,140667,48098,188765
201802,2018,경부선,진위,36265,6228,42493
201802,2018,경부선,직산,20041,4453,24494
201802,2018,경부선,지제,49516,5146,54662
201802,2018,경부선,의왕,195144,34458,229602
201802,2018,경부선,용산,1063756,111344,1175100
201802,2018,경부선,오산대,59072,10215,69287
201802,2018,경부선,오산,242645,35303,277948
201802,2018,경부선,영등포,1103311,237797,1341108
201802,2018,경부선,안양,568294,96350,664644
201802,2018,경부선,신도림,75935,16935,92870
201802,2018,경부선,신길,219924,39487,259411
201802,2018,경부선,수원,1086374,121857,1208231
201802,2018,경부선,송탄,113854,20499,134353
201802,2018,경부선,세마,59675,11240,70915
201802,2018,경부선,세류,89430,15341,104771
201802,2018,경부선,화서,174408,34933,209341
201802,2018,경부선,성균관대,351359,46250,397609
201802,2018,경부선,석수,249661,39891,289552
201802,2018,경부선,서정리,104535,20032,124567
201802,2018,경부선,서울역,169658,9873,179531
201802,2018,경부선,서동탄,33581,7403,40984
201802,2018,경부선,병점,335776,48874,384650
201802,2018,경부선,명학,209432,36541,245973
201802,2018,경부선,두정,122930,19009,141939
201802,2018,경부선,독산,370311,57609,427920
201802,2018,경강선,여주,41596,10652,52248
201802,2018,경강선,신둔도예촌,22740,4367,27107
201802,2018,경강선,세종대왕릉,5258,2156,7414
201802,2018,경강선,삼동,40626,6506,47132
201802,2018,경강선,경기광주,137796,18836,156632
201802,2018,경강선,곤지암,43981,8602,52583
201802,2018,경강선,초월,50878,8109,58987
201802,2018,경강선,판교,77694,8355,86049
201802,2018,경강선,부발,39754,4837,44591
201802,2018,9호선2단계,봉은사,322663,32172,354835
201802,2018,9호선2단계,선정릉,156522,17223,173745
201802,2018,9호선2단계,삼성중앙,113326,18317,131643
201802,2018,9호선2단계,종합운동장,151719,13567,165286
201802,2018,9호선2단계,언주,196521,20203,216724
201802,2018,9호선,신방화,170510,37155,207665
201802,2018,9호선,신반포,67757,19626,87383
201802,2018,9호선,신목동,87241,15256,102497
201802,2018,9호선,신논현,748925,44356,793281
201802,2018,9호선,선유도,152125,21730,173855
201802,2018,9호선,샛강,112330,22037,134367
201802,2018,9호선,사평,56344,11330,67674
201802,2018,9호선,양천향교,174072,32547,206619
201802,2018,9호선,여의도,461237,35319,496556
201802,2018,9호선,염창,370224,51428,421652
201802,2018,9호선,증미,150670,35094,185764
201802,2018,9호선,개화,143276,27763,171039
201802,2018,9호선,마곡나루,172287,11814,184101
201802,2018,9호선,등촌,210515,66953,277468
201802,2018,9호선,동작(현충원),37064,10509,47573
201802,2018,9호선,당산,415123,52721,467844
201802,2018,9호선,노량진,662377,74552,736929
201802,2018,9호선,노들,95989,25555,121544
201802,2018,9호선,김포공항,248556,16826,265382
201802,2018,9호선,국회의사당,369773,43554,413327
201802,2018,9호선,구반포,60113,19812,79925
201802,2018,9호선,공항시장,57975,17926,75901
201802,2018,9호선,고속터미널,306729,40480,347209
201802,2018,9호선,흑석(중앙대입구),182586,42637,225223
201802,2018,9호선,가양,438751,104864,543615
201802,2018,8호선,강동구청,229583,53977,283560
201802,2018,8호선,장지,421522,58731,480253
201802,2018,8호선,잠실(송파구청),343588,55067,398655
201802,2018,8호선,암사,403624,79067,482691
201802,2018,8호선,신흥,92146,37038,129184
201802,2018,8호선,수진,108786,40014,148800
201802,2018,8호선,송파,107702,30244,137946
201802,2018,8호선,석촌,185446,51558,237004
201802,2018,8호선,산성,116299,27913,144212
201802,2018,8호선,복정,244599,38997,283596
201802,2018,8호선,문정,364915,39620,404535
201802,2018,8호선,몽촌토성(평화의문),140921,35322,176243
201802,2018,8호선,모란,80888,44313,125201
201802,2018,8호선,단대오거리,232127,56195,288322
201802,2018,8호선,남한산성입구(성남법원.검찰청),293333,62865,356198
201802,2018,8호선,천호(풍납토성),421808,78982,500790
201802,2018,8호선,가락시장,146379,48994,195373
201802,2018,7호선,강남구청,342226,39776,382002
201802,2018,7호선,하계,432648,90884,523532
201802,2018,7호선,태릉입구,186884,33080,219964
201802,2018,7호선,춘의,207804,23927,231731
201802,2018,7호선,청담,449910,64021,513931
201802,2018,7호선,철산,553649,82291,635940
201802,2018,7호선,천왕,188204,39977,228181
201802,2018,7호선,중화,246187,50934,297121
201802,2018,7호선,중곡,217053,52550,269603
201802,2018,7호선,중계,322263,77891,400154
201802,2018,7호선,장암,52569,5401,57970
201802,2018,7호선,장승배기,226571,65948,292519
201802,2018,7호선,이수,378702,65927,444629
201802,2018,7호선,용마산,137191,29951,167142
201802,2018,7호선,온수(성공회대입구),233489,29215,262704
201802,2018,7호선,어린이대공원(세종대),303348,34929,338277
201802,2018,7호선,신풍,247689,58522,306211
201802,2018,7호선,신중동,334692,40825,375517
201802,2018,7호선,신대방삼거리,356249,78458,434707
201802,2018,7호선,숭실대입구(살피재),293959,50342,344301
201802,2018,7호선,수락산,289652,72333,361985
201802,2018,7호선,상봉(시외버스터미널),407688,61224,468912
201802,2018,7호선,상동,343488,39072,382560
201802,2018,7호선,상도,229214,49856,279070
201802,2018,7호선,삼산체육관,116200,18416,134616
201802,2018,7호선,사가정,343235,78127,421362
201802,2018,7호선,부평구청,280325,25730,306055
201802,2018,7호선,부천종합운동장,118686,14163,132849
201802,2018,7호선,부천시청,294817,39521,334338
201802,2018,7호선,보라매,196665,35712,232377
201802,2018,7호선,반포,139179,28158,167337
201802,2018,7호선,면목,333178,72788,405966
201802,2018,7호선,먹골,233112,51187,284299
201802,2018,7호선,마들,250608,64792,315400
201802,2018,7호선,뚝섬유원지,162586,31453,194039
201802,2018,7호선,도봉산,197793,30610,228403
201802,2018,7호선,대림(구로구청),259489,30745,290234
201802,2018,7호선,논현,455145,43853,498998
201802,2018,7호선,노원,471043,98464,569507
201802,2018,7호선,내방,315988,54343,370331
201802,2018,7호선,남성,243956,58928,302884
201802,2018,7호선,남구로,381295,50174,431469
201802,2018,7호선,까치울,158448,18538,176986
201802,2018,7호선,굴포천,216826,29731,246557
201802,2018,7호선,군자(능동),317983,63651,381634
201802,2018,7호선,광명사거리,587343,127053,714396
201802,2018,7호선,공릉(서울과학기술대),268291,57828,326119
201802,2018,7호선,고속터미널,538211,67679,605890
201802,2018,7호선,건대입구,376284,47378,423662
201802,2018,7호선,학동,497114,50588,547702
201802,2018,7호선,가산디지털단지,994515,65349,1059864
201802,2018,6호선,공덕,406535,61928,468463
201802,2018,6호선,화랑대(서울여대입구),279827,39582,319409
201802,2018,6호선,합정,381732,33953,415685
201802,2018,6호선,한강진,185622,12505,198127
201802,2018,6호선,태릉입구,113500,23760,137260
201802,2018,6호선,청구,80541,16109,96650
201802,2018,6호선,창신,76729,15074,91803
201802,2018,6호선,증산(명지대앞),217125,59554,276679
201802,2018,6호선,이태원,451496,29487,480983
201802,2018,6호선,응암,375883,94215,470098
201802,2018,6호선,월드컵경기장(성산),102060,38697,140757
201802,2018,6호선,월곡(동덕여대),252814,64233,317047
201802,2018,6호선,연신내,15,0,15
201802,2018,6호선,역촌,73559,29071,102630
201802,2018,6호선,약수,75456,20481,95937
201802,2018,6호선,안암(고대병원앞),283436,28886,312322
201802,2018,6호선,신당,187752,33885,221637
201802,2018,6호선,석계,274639,62607,337246
201802,2018,6호선,새절(신사),270621,72191,342812
201802,2018,6호선,상월곡(한국과학기술연구원),125550,34074,159624
201802,2018,6호선,상수,266993,19379,286372
201802,2018,6호선,삼각지,171040,15041,186081
201802,2018,6호선,불광,115199,35589,150788
201802,2018,6호선,봉화산(서울의료원),205227,44591,249818
201802,2018,6호선,보문,169118,28728,197846
201802,2018,6호선,버티고개,50960,12597,63557
201802,2018,6호선,망원,295641,71793,367434
201802,2018,6호선,마포구청,292658,68001,360659
201802,2018,6호선,디지털미디어시티,306583,46631,353214
201802,2018,6호선,동묘앞,184647,56163,240810
201802,2018,6호선,돌곶이,181094,52370,233464
201802,2018,6호선,독바위,59209,17235,76444
201802,2018,6호선,대흥(서강대앞),170466,38738,209204
201802,2018,6호선,녹사평(용산구청),162217,16878,179095
201802,2018,6호선,구산,163859,46419,210278
201802,2018,6호선,광흥창(서강),194589,50212,244801
201802,2018,6호선,효창공원앞,149762,34680,184442
201802,2018,6호선,고려대(종암),197639,29289,226928
201802,2018,5호선,개롱,134498,36872,171370
201802,2018,5호선,행당,180636,40924,221560
201802,2018,5호선,충정로(경기대입구),100636,13787,114423
201802,2018,5호선,청구,84725,22780,107505
201802,2018,5호선,천호(풍납토성),431120,123076,554196
201802,2018,5호선,종로3가,311197,105342,416539
201802,2018,5호선,장한평,404570,79244,483814
201802,2018,5호선,을지로4가,91788,35148,126936
201802,2018,5호선,우장산,332266,70013,402279
201802,2018,5호선,왕십리(성동구청),112143,21425,133568
201802,2018,5호선,올림픽공원(한국체대),111913,27259,139172
201802,2018,5호선,오목교(목동운동장앞),584517,71145,655662
201802,2018,5호선,오금,74732,14896,89628
201802,2018,5호선,영등포시장,178806,66798,245604
201802,2018,5호선,영등포구청,74920,17107,92027
201802,2018,5호선,여의도,551084,44195,595279
201802,2018,5호선,여의나루,166888,21578,188466
201802,2018,5호선,양평,143416,24058,167474
201802,2018,5호선,애오개,155234,33575,188809
201802,2018,5호선,아차산(어린이대공원후문),306459,78068,384527
201802,2018,5호선,신정(은행정),326021,51293,377314
201802,2018,5호선,신길,72985,10356,83341
201802,2018,5호선,신금호,124939,30575,155514
201802,2018,5호선,송정,192476,50070,242546
201802,2018,5호선,서대문,374282,59151,433433
201802,2018,5호선,상일동,256445,52138,308583
201802,2018,5호선,방화,154139,40383,194522
201802,2018,5호선,방이,153786,36881,190667
201802,2018,5호선,발산,368559,56970,425529
201802,2018,5호선,목동,405430,70432,475862
201802,2018,5호선,명일,164331,50506,214837
201802,2018,5호선,마포,310856,55023,365879
201802,2018,5호선,마천,91578,39975,131553
201802,2018,5호선,마장,124443,39615,164058
201802,2018,5호선,마곡,178220,21934,200154
201802,2018,5호선,둔촌동,199909,55126,255035
201802,2018,5호선,동대문역사문화공원,66487,8335,74822
201802,2018,5호선,답십리,358533,71040,429573
201802,2018,5호선,까치산,669588,129916,799504
201802,2018,5호선,김포공항,199369,24925,224294
201802,2018,5호선,길동,150510,51577,202087
201802,2018,5호선,굽은다리(강동구민회관앞),204098,54165,258263
201802,2018,5호선,군자(능동),253766,33146,286912
201802,2018,5호선,광화문(세종문화회관),876172,70326,946498
201802,2018,5호선,광나루(장신대),310714,55600,366314
201802,2018,5호선,공덕,306853,38930,345783
201802,2018,5호선,고덕,193467,52603,246070
201802,2018,5호선,거여,132150,43649,175799
201802,2018,5호선,개화산,125912,29965,155877
201802,2018,5호선,화곡,664693,120370,785063
201802,2018,5호선,강동,433948,84499,518447
201802,2018,4호선,남태령,65918,8034,73952
201802,2018,4호선,혜화,961314,113166,1074480
201802,2018,4호선,한성대입구(삼선교),332726,66436,399162
201802,2018,4호선,충무로,681932,109190,791122
201802,2018,4호선,총신대입구(이수),438735,123166,561901
201802,2018,4호선,창동,596714,164844,761558
201802,2018,4호선,이촌(국립중앙박물관),208931,38570,247501
201802,2018,4호선,쌍문,738064,141108,879172
201802,2018,4호선,신용산,366102,41800,407902
201802,2018,4호선,숙대입구(갈월),347842,49407,397249
201802,2018,4호선,수유(강북구청),847582,182162,1029744
201802,2018,4호선,성신여대입구(돈암),547231,79234,626465
201802,2018,4호선,서울역,305119,34910,340029
201802,2018,4호선,상계,455273,99798,555071
201802,2018,4호선,삼각지,105871,24316,130187
201802,2018,4호선,사당,677820,76772,754592
201802,2018,4호선,미아사거리,652475,152127,804602
201802,2018,4호선,미아(서울사이버대학),353424,101085,454509
201802,2018,4호선,명동,940752,61078,1001830
201802,2018,4호선,동작(현충원),39794,15578,55372
201802,2018,4호선,동대문역사문화공원,538926,53824,592750
201802,2018,4호선,동대문,509381,119209,628590
201802,2018,4호선,당고개,261666,76754,338420
201802,2018,4호선,노원,528905,78861,607766
201802,2018,4호선,회현(남대문시장),603487,158179,761666
201802,2018,4호선,길음,484236,106276,590512
201802,2018,3호선,경복궁(정부서울청사),535841,73253,609094
201802,2018,3호선,학여울,48208,13326,61534
201802,2018,3호선,충무로,55,0,55
201802,2018,3호선,지축,23127,8208,31335
201802,2018,3호선,종로3가,200644,49915,250559
201802,2018,3호선,일원,186688,49895,236583
201802,2018,3호선,을지로3가,210725,50452,261177
201802,2018,3호선,옥수,208365,49523,257888
201802,2018,3호선,오금,155075,24153,179228
201802,2018,3호선,연신내,893545,227465,1121010
201802,2018,3호선,양재(서초구청),902958,138044,1041002
201802,2018,3호선,약수,294743,71912,366655
201802,2018,3호선,압구정,771049,121474,892523
201802,2018,3호선,안국,534608,104825,639433
201802,2018,3호선,신사,797066,62648,859714
201802,2018,3호선,수서,388757,83902,472659
201802,2018,3호선,불광,373430,127147,500577
201802,2018,3호선,무악재,80278,26704,106982
201802,2018,3호선,매봉,239945,46871,286816
201802,2018,3호선,동대입구,227130,30451,257581
201802,2018,3호선,독립문,145805,60337,206142
201802,2018,3호선,도곡,140457,24684,165141
201802,2018,3호선,대치,280446,53470,333916
201802,2018,3호선,대청,210150,43623,253773
201802,2018,3호선,녹번,283747,56195,339942
201802,2018,3호선,남부터미널(예술의전당),854555,108887,963442
201802,2018,3호선,금호,181737,47838,229575
201802,2018,3호선,구파발,447135,84275,531410
201802,2018,3호선,교대(법원.검찰청),305555,58852,364407
201802,2018,3호선,고속터미널,1555785,157298,1713083
201802,2018,3호선,경찰병원,167679,34241,201920
201802,2018,3호선,홍제,377882,125367,503249
201802,2018,3호선,가락시장,206845,65189,272034
201802,2018,2호선,강변(동서울터미널),1175085,118906,1293991
201802,2018,2호선,합정,821207,61556,882763
201802,2018,2호선,한양대,189131,13196,202327
201802,2018,2호선,충정로(경기대입구),250751,46156,296907
201802,2018,2호선,종합운동장,267625,40801,308426
201802,2018,2호선,잠실새내,595576,100976,696552
201802,2018,2호선,잠실나루,363839,75545,439384
201802,2018,2호선,잠실(송파구청),2261682,186583,2448265
201802,2018,2호선,이대,424312,56378,480690
201802,2018,2호선,을지로입구,1220745,96689,1317434
201802,2018,2호선,을지로4가,245223,79871,325094
201802,2018,2호선,을지로3가,470727,74886,545613
201802,2018,2호선,용두(동대문구청),42232,21157,63389
201802,2018,2호선,용답,53386,14269,67655
201802,2018,2호선,왕십리(성동구청),449142,49767,498909
201802,2018,2호선,영등포구청,482921,89191,572112
201802,2018,2호선,역삼,1118540,125834,1244374
201802,2018,2호선,양천구청,141933,37030,178963
201802,2018,2호선,아현,208066,54272,262338
201802,2018,2호선,신촌,1177767,119576,1297343
201802,2018,2호선,신정네거리,199611,54568,254179
201802,2018,2호선,신설동,85076,31604,116680
201802,2018,2호선,신림,1658552,202640,1861192
201802,2018,2호선,신도림,1412274,173515,1585789
201802,2018,2호선,신대방,641905,108300,750205
201802,2018,2호선,신당,306059,89205,395264
201802,2018,2호선,신답,26986,8479,35465
201802,2018,2호선,시청,598072,50040,648112
201802,2018,2호선,성수,611166,86703,697869
201802,2018,2호선,선릉,1251732,178804,1430536
201802,2018,2호선,서초,513657,71913,585570
201802,2018,2호선,서울대입구(관악구청),1207319,174817,1382136
201802,2018,2호선,상왕십리,301051,57317,358368
201802,2018,2호선,삼성(무역센터),1419674,105024,1524698
201802,2018,2호선,사당,911693,166846,1078539
201802,2018,2호선,봉천,491272,124655,615927
201802,2018,2호선,방배,421527,68484,490011
201802,2018,2호선,문래,437363,71349,508712
201802,2018,2호선,뚝섬,380362,52809,433171
201802,2018,2호선,동대문역사문화공원,402033,48788,450821
201802,2018,2호선,도림천,23928,5345,29273
201802,2018,2호선,대림(구로구청),679760,97131,776891
201802,2018,2호선,당산,473293,54748,528041
201802,2018,2호선,낙성대,692108,94027,786135
201802,2018,2호선,구의(광진구청),536916,90386,627302
201802,2018,2호선,구로디지털단지,1527081,143773,1670854
201802,2018,2호선,교대(법원.검찰청),793757,139505,933262
201802,2018,2호선,건대입구,1106952,81767,1188719
201802,2018,2호선,홍대입구,2131171,97627,2228798
201802,2018,2호선,강남,2699269,147405,2846674
201802,2018,1호선,신설동,306176,102707,408883
201802,2018,1호선,종로5가,461690,223197,684887
201802,2018,1호선,종로3가,585497,311066,896563
201802,2018,1호선,종각,1068640,134067,1202707
201802,2018,1호선,제기동,250605,305913,556518
201802,2018,1호선,청량리(서울시립대입구),432438,291673,724111
201802,2018,1호선,시청,553832,81569,635401
201802,2018,1호선,서울역,1308968,179261,1488229
201802,2018,1호선,동묘앞,155268,120318,275586
201802,2018,1호선,동대문,289894,110530,400424
201801,2018,우이신설선,북한산우이,42003,25743,67746
201801,2018,우이신설선,북한산보국문,121088,33753,154841
201801,2018,우이신설선,보문,28559,12882,41441
201801,2018,우이신설선,가오리,70649,35420,106069
201801,2018,우이신설선,4.19민주묘지,44162,22451,66613
201801,2018,안산선,신길온천,43075,7453,50528
201801,2018,안산선,초지,94197,14332,108529
201801,2018,안산선,중앙,447284,51535,498819
201801,2018,안산선,정왕,216362,22270,238632
201801,2018,안산선,오이도,228054,28894,256948
201801,2018,안산선,안산,458381,40250,498631
201801,2018,안산선,한대앞,218542,35438,253980
201801,2018,안산선,수리산,100853,29404,130257
201801,2018,안산선,상록수,510961,76911,587872
201801,2018,안산선,산본,442169,93729,535898
201801,2018,안산선,반월,111924,25820,137744
201801,2018,안산선,대야미,97320,20501,117821
201801,2018,안산선,고잔,231440,32263,263703
201801,2018,수인선,연수,124182,25287,149469
201801,2018,수인선,인하대,128473,20036,148509
201801,2018,수인선,인천논현,150195,29577,179772
201801,2018,수인선,인천,19545,9061,28606
201801,2018,수인선,월곶,62667,11107,73774
201801,2018,수인선,원인재,110979,24777,135756
201801,2018,수인선,호구포,91544,15808,107352
201801,2018,수인선,신포,39413,10910,50323
201801,2018,수인선,숭의,74822,22509,97331
201801,2018,수인선,송도,64686,18755,83441
201801,2018,수인선,소래포구,92606,31764,124370
201801,2018,수인선,달월,2099,1307,3406
201801,2018,수인선,남동인더스파크,57420,5302,62722
201801,2018,분당선,강남구청,224094,37514,261608
201801,2018,분당선,태평,351007,86366,437373
201801,2018,분당선,청명,107167,15905,123072
201801,2018,분당선,죽전,374130,72735,446865
201801,2018,분당선,정자,456092,75920,532012
201801,2018,분당선,이매,134729,34504,169233
201801,2018,분당선,오리,350101,83969,434070
201801,2018,분당선,영통,241733,27528,269261
201801,2018,분당선,야탑,715449,150625,866074
201801,2018,분당선,압구정로데오,415028,37524,452552
201801,2018,분당선,신갈,111709,29458,141167
201801,2018,분당선,수원시청,312448,32934,345382
201801,2018,분당선,수원,249177,25530,274707
201801,2018,분당선,수서,365216,58554,423770
201801,2018,분당선,수내,362288,76667,438955
201801,2018,분당선,선정릉,197849,34394,232243
201801,2018,분당선,선릉,229983,26842,256825
201801,2018,분당선,서현,740521,124744,865265
201801,2018,분당선,서울숲,191697,20892,212589
201801,2018,분당선,상갈,127778,28870,156648
201801,2018,분당선,보정,56553,22843,79396
201801,2018,분당선,미금,482790,116060,598850
201801,2018,분당선,모란,535074,145462,680536
201801,2018,분당선,매탄권선,115692,13954,129646
201801,2018,분당선,매교,60414,17128,77542
201801,2018,분당선,망포,365013,30007,395020
201801,2018,분당선,도곡,164334,38056,202390
201801,2018,분당선,대모산입구,64452,28086,92538
201801,2018,분당선,기흥,197775,31107,228882
201801,2018,분당선,구성,110471,35294,145765
201801,2018,분당선,구룡,37676,18056,55732
201801,2018,분당선,개포동,72242,19261,91503
201801,2018,분당선,한티,386518,65693,452211
201801,2018,분당선,가천대,183983,25240,209223
201801,2018,과천선,범계,785871,99400,885271
201801,2018,과천선,과천,104856,29965,134821
201801,2018,과천선,경마공원,136337,51933,188270
201801,2018,과천선,선바위,229785,27881,257666
201801,2018,과천선,대공원,59628,25087,84715
201801,2018,과천선,평촌,449991,60437,510428
201801,2018,과천선,정부과천청사,316773,59845,376618
201801,2018,과천선,인덕원,671105,96447,767552
201801,2018,공항철도 1호선,운서,170131,21071,191202
201801,2018,공항철도 1호선,김포공항,295019,17175,312194
201801,2018,공항철도 1호선,공항화물청사,68308,7491,75799
201801,2018,공항철도 1호선,공덕,50593,6119,56712
201801,2018,공항철도 1호선,계양,291291,27455,318746
201801,2018,공항철도 1호선,검암,244684,21234,265918
201801,2018,공항철도 1호선,디지털미디어시티,348697,21040,369737
201801,2018,공항철도 1호선,영종,47042,10675,57717
201801,2018,공항철도 1호선,서울역,313150,30136,343286
201801,2018,공항철도 1호선,홍대입구,253076,15941,269017
201801,2018,공항철도 1호선,청라국제도시,158774,8396,167170
201801,2018,공항철도 1호선,인천공항2터미널,97313,15933,113246
201801,2018,공항철도 1호선,인천공항1터미널,482209,38551,520760
201801,2018,경춘선,가평,46317,10647,56964
201801,2018,경춘선,신내,12630,5847,18477
201801,2018,경춘선,상천,5173,4097,9270
201801,2018,경춘선,사릉,80123,16883,97006
201801,2018,경춘선,별내,51024,15385,66409
201801,2018,경춘선,백양리,10678,1157,11835
201801,2018,경춘선,평내호평,130822,37259,168081
201801,2018,경춘선,퇴계원,76601,21693,98294
201801,2018,경춘선,춘천,33702,14617,48319
201801,2018,경춘선,청평,47406,12953,60359
201801,2018,경춘선,천마산,27057,14158,41215
201801,2018,경춘선,마석,72343,27392,99735
201801,2018,경춘선,대성리,13876,3966,17842
201801,2018,경춘선,남춘천,57471,20656,78127
201801,2018,경춘선,김유정,8251,3053,11304
201801,2018,경춘선,금곡,28522,13925,42447
201801,2018,경춘선,굴봉산,3802,1419,5221
201801,2018,경춘선,강촌,10633,3239,13872
201801,2018,경춘선,갈매,48990,13156,62146
201801,2018,경인선,인천,81250,27516,108766
201801,2018,경인선,제물포,243721,55725,299446
201801,2018,경인선,개봉,550262,146031,696293
201801,2018,경인선,주안,605517,91603,697120
201801,2018,경인선,중동,231575,59890,291465
201801,2018,경인선,송내,827951,107071,935022
201801,2018,경인선,백운,197886,59837,257723
201801,2018,경인선,부개,226921,59188,286109
201801,2018,경인선,구일,196719,31452,228171
201801,2018,경인선,부천,994588,195018,1189606
201801,2018,경인선,부평,991132,135649,1126781
201801,2018,경인선,역곡,747077,137999,885076
201801,2018,경인선,오류동,255497,83577,339074
201801,2018,경인선,도원,65739,32081,97820
201801,2018,경인선,도화,77799,32888,110687
201801,2018,경인선,동암,459192,95447,554639
201801,2018,경인선,동인천,403637,112882,516519
201801,2018,경인선,온수(성공회대입구),149823,40860,190683
201801,2018,경인선,간석,150408,40050,190458
201801,2018,경인선,소사,303462,79480,382942
201801,2018,경의선,디지털미디어시티,51815,10405,62220
201801,2018,경의선,능곡,79647,26549,106196
201801,2018,경의선,김포공항,12,0,12
201801,2018,경의선,금촌,165260,39826,205086
201801,2018,경의선,금릉,113901,21894,135795
201801,2018,경의선,공덕,4,0,4
201801,2018,경의선,공덕,75886,10409,86295
201801,2018,경의선,곡산,11119,3831,14950
201801,2018,경의선,계양,2,0,2
201801,2018,경의선,검암,8,0,8
201801,2018,경의선,가좌,100176,40968,141144
201801,2018,경의선,일산,216102,50849,266951
201801,2018,경의선,탄현,185312,31792,217104
201801,2018,경의선,파주,29463,6535,35998
201801,2018,경의선,풍산,111533,25768,137301
201801,2018,경의선,행신,195013,32445,227458
201801,2018,경의선,홍대입구,45979,4887,50866
201801,2018,경의선,홍대입구,1,0,1
201801,2018,경의선,화전,39905,7320,47225
201801,2018,경의선,효창공원앞,57252,11394,68646
201801,2018,경의선,문산,138656,36927,175583
201801,2018,경의선,백마,164876,28171,193047
201801,2018,경의선,서강대,52740,8348,61088
201801,2018,경의선,서울역,72133,8280,80413
201801,2018,경의선,서울역,8,0,8
201801,2018,경의선,수색,53567,18057,71624
201801,2018,경의선,신촌,17210,2909,20119
201801,2018,경의선,야당,99243,22010,121253
201801,2018,경의선,운정,124771,27666,152437
201801,2018,경의선,월롱,62114,7163,69277
201801,2018,경의선,강매,61887,14436,76323
201801,2018,경원선,녹양,111347,30319,141666
201801,2018,경원선,응봉,37204,15974,53178
201801,2018,경원선,월계,93183,49390,142573
201801,2018,경원선,외대앞,268295,52478,320773
201801,2018,경원선,왕십리(성동구청),418277,57363,475640
201801,2018,경원선,옥수,1459,116,1575
201801,2018,경원선,양주,209310,46756,256066
201801,2018,경원선,신이문,222327,61378,283705
201801,2018,경원선,소요산,50170,51014,101184
201801,2018,경원선,석계,234698,58560,293258
201801,2018,경원선,서빙고,43412,14499,57911
201801,2018,경원선,보산,38558,12997,51555
201801,2018,경원선,방학,193662,97253,290915
201801,2018,경원선,회룡,238085,123878,361963
201801,2018,경원선,한남,96613,31880,128493
201801,2018,경원선,청량리(서울시립대입구),342194,133484,475678
201801,2018,경원선,창동,2,0,2
201801,2018,경원선,지행,161694,40964,202658
201801,2018,경원선,이촌(국립중앙박물관),101846,27130,128976
201801,2018,경원선,의정부,516588,110802,627390
201801,2018,경원선,망월사,160193,64629,224822
201801,2018,경원선,동두천중앙,73256,36542,109798
201801,2018,경원선,동두천,44085,16975,61060
201801,2018,경원선,도봉산,156414,76141,232555
201801,2018,경원선,도봉,126092,65069,191161
201801,2018,경원선,덕정,146877,31247,178124
201801,2018,경원선,덕계,45282,14331,59613
201801,2018,경원선,녹천,110908,36475,147383
201801,2018,경원선,가능,152184,54675,206859
201801,2018,경원선,광운대,208886,50965,259851
201801,2018,경부선,명학,240669,40821,281490
201801,2018,경부선,두정,135357,20637,155994
201801,2018,경부선,독산,430530,62269,492799
201801,2018,경부선,대방,382741,68881,451622
201801,2018,경부선,당정,176383,25769,202152
201801,2018,경부선,노량진,380026,45352,425378
201801,2018,경부선,남영,269402,35556,304958
201801,2018,경부선,금천구청,262037,68217,330254
201801,2018,경부선,금정,707213,98263,805476
201801,2018,경부선,군포,188525,32778,221303
201801,2018,경부선,구로,531137,91377,622514
201801,2018,경부선,광명,54972,3963,58935
201801,2018,경부선,관악,192527,49012,241539
201801,2018,경부선,가산디지털단지,423733,27546,451279
201801,2018,경부선,용산,1124660,121739,1246399
201801,2018,경부선,오산대,63201,12112,75313
201801,2018,경부선,오산,255587,38669,294256
201801,2018,경부선,영등포,1203961,264383,1468344
201801,2018,경부선,안양,615583,106381,721964
201801,2018,경부선,신도림,87839,19048,106887
201801,2018,경부선,신길,252951,42371,295322
201801,2018,경부선,수원,1117387,131877,1249264
201801,2018,경부선,송탄,120030,23256,143286
201801,2018,경부선,세마,66371,14020,80391
201801,2018,경부선,세류,98533,16555,115088
201801,2018,경부선,성환,82911,18328,101239
201801,2018,경부선,성균관대,392511,49655,442166
201801,2018,경부선,석수,285385,43830,329215
201801,2018,경부선,서정리,112098,24509,136607
201801,2018,경부선,서울역,185629,12311,197940
201801,2018,경부선,서동탄,36819,8100,44919
201801,2018,경부선,병점,364222,53157,417379
201801,2018,경부선,화서,197928,37098,235026
201801,2018,경부선,평택,325683,61762,387445
201801,2018,경부선,천안,141093,53046,194139
201801,2018,경부선,진위,39409,9600,49009
201801,2018,경부선,직산,21811,5693,27504
201801,2018,경부선,지제,54698,6213,60911
201801,2018,경부선,의왕,221884,36875,258759
201801,2018,경강선,삼동,46041,7054,53095
201801,2018,경강선,경기광주,152292,20730,173022
201801,2018,경강선,여주,41856,11968,53824
201801,2018,경강선,신둔도예촌,24422,4673,29095
201801,2018,경강선,세종대왕릉,5406,2369,7775
201801,2018,경강선,곤지암,47732,9963,57695
201801,2018,경강선,부발,42452,5258,47710
201801,2018,경강선,판교,87905,9397,97302
201801,2018,경강선,초월,57189,8874,66063
201801,2018,경강선,이천,60742,10353,71095
201801,2018,경강선,이매,34912,7923,42835
201801,2018,9호선2단계,선정릉,183648,19243,202891
201801,2018,9호선2단계,언주,231278,23178,254456
201801,2018,9호선2단계,종합운동장,175233,15399,190632
201801,2018,9호선2단계,삼성중앙,130981,20438,151419
201801,2018,9호선2단계,봉은사,373801,36655,410456
201801,2018,9호선,흑석(중앙대입구),203307,46543,249850
201801,2018,9호선,여의도,548267,40192,588459
201801,2018,9호선,양천향교,203920,35688,239608
201801,2018,9호선,신방화,198360,41756,240116
201801,2018,9호선,신반포,77561,21445,99006
201801,2018,9호선,신목동,101298,16311,117609
201801,2018,9호선,신논현,866895,49442,916337
201801,2018,9호선,선유도,181175,24129,205304
201801,2018,9호선,샛강,132099,24404,156503
201801,2018,9호선,사평,63868,11855,75723
201801,2018,9호선,마곡나루,197763,12961,210724
201801,2018,9호선,등촌,236440,73337,309777
201801,2018,9호선,동작(현충원),40388,10935,51323
201801,2018,9호선,당산,479235,58684,537919
201801,2018,9호선,노량진,762803,79103,841906
201801,2018,9호선,노들,110985,27601,138586
201801,2018,9호선,김포공항,273308,19068,292376
201801,2018,9호선,국회의사당,440349,49179,489528
201801,2018,9호선,구반포,69630,21696,91326
201801,2018,9호선,공항시장,66862,19447,86309
201801,2018,9호선,고속터미널,327710,45405,373115
201801,2018,9호선,개화,160848,30456,191304
201801,2018,9호선,가양,500713,114384,615097
201801,2018,8호선,강동구청,269467,59193,328660
201801,2018,8호선,장지,481517,65170,546687
201801,2018,8호선,잠실(송파구청),384044,64296,448340
201801,2018,8호선,암사,467153,88145,555298
201801,2018,8호선,신흥,102275,41340,143615
201801,2018,8호선,수진,119758,44961,164719
201801,2018,8호선,송파,126835,33928,160763
201801,2018,8호선,석촌,216694,56928,273622
201801,2018,8호선,산성,131247,30899,162146
201801,2018,8호선,복정,281185,43652,324837
201801,2018,8호선,문정,424191,45414,469605
201801,2018,8호선,몽촌토성(평화의문),169139,39081,208220
201801,2018,8호선,모란,90432,48226,138658
201801,2018,8호선,단대오거리,264009,63284,327293
201801,2018,8호선,남한산성입구(성남법원.검찰청),336625,69917,406542
201801,2018,8호선,천호(풍납토성),482599,87798,570397
201801,2018,8호선,가락시장,170498,51190,221688
201801,2018,7호선,강남구청,404080,45602,449682
201801,2018,7호선,하계,487694,100903,588597
201801,2018,7호선,태릉입구,210878,36205,247083
201801,2018,7호선,춘의,237927,26803,264730
201801,2018,7호선,청담,532246,70944,603190
201801,2018,7호선,철산,628313,91391,719704
201801,2018,7호선,천왕,211837,43410,255247
201801,2018,7호선,중화,278334,56113,334447
201801,2018,7호선,중곡,244989,57811,302800
201801,2018,7호선,중계,369240,84326,453566
201801,2018,7호선,장암,60145,5897,66042
201801,2018,7호선,장승배기,259198,74389,333587
201801,2018,7호선,이수,437511,74607,512118
201801,2018,7호선,용마산,155427,32588,188015
201801,2018,7호선,온수(성공회대입구),264311,31663,295974
201801,2018,7호선,어린이대공원(세종대),344345,38165,382510
201801,2018,7호선,신풍,279567,64627,344194
201801,2018,7호선,신중동,380621,45883,426504
201801,2018,7호선,신대방삼거리,404194,86598,490792
201801,2018,7호선,숭실대입구(살피재),336483,56248,392731
201801,2018,7호선,수락산,325328,78367,403695
201801,2018,7호선,상봉(시외버스터미널),455167,67770,522937
201801,2018,7호선,상동,391682,44283,435965
201801,2018,7호선,상도,263307,54679,317986
201801,2018,7호선,삼산체육관,129415,21337,150752
201801,2018,7호선,사가정,384117,87318,471435
201801,2018,7호선,부평구청,323560,28548,352108
201801,2018,7호선,부천종합운동장,134959,15315,150274
201801,2018,7호선,부천시청,332114,43971,376085
201801,2018,7호선,보라매,223283,40447,263730
201801,2018,7호선,반포,156380,30257,186637
201801,2018,7호선,면목,376459,79777,456236
201801,2018,7호선,먹골,265585,57062,322647
201801,2018,7호선,마들,285810,70593,356403
201801,2018,7호선,뚝섬유원지,184219,34145,218364
201801,2018,7호선,도봉산,225148,33422,258570
201801,2018,7호선,대림(구로구청),287000,34924,321924
201801,2018,7호선,노원,532373,111216,643589
201801,2018,7호선,내방,373262,61297,434559
201801,2018,7호선,남성,278462,65610,344072
201801,2018,7호선,남구로,439158,56312,495470
201801,2018,7호선,까치울,177074,20456,197530
201801,2018,7호선,굴포천,247201,32204,279405
201801,2018,7호선,군자(능동),366475,71590,438065
201801,2018,7호선,광명사거리,658560,137844,796404
201801,2018,7호선,공릉(서울과학기술대),302702,63012,365714
201801,2018,7호선,고속터미널,564588,75893,640481
201801,2018,7호선,건대입구,426560,54944,481504
201801,2018,7호선,학동,596291,57703,653994
201801,2018,7호선,가산디지털단지,1155727,73809,1229536
201801,2018,6호선,공덕,468603,68855,537458
201801,2018,6호선,화랑대(서울여대입구),322659,42900,365559
201801,2018,6호선,합정,426660,38078,464738
201801,2018,6호선,한강진,192805,13905,206710
201801,2018,6호선,태릉입구,129078,25733,154811
201801,2018,6호선,청구,92372,18407,110779
201801,2018,6호선,창신,87002,16509,103511
201801,2018,6호선,증산(명지대앞),246527,64007,310534
201801,2018,6호선,이태원,469424,32355,501779
201801,2018,6호선,응암,425724,102936,528660
201801,2018,6호선,월드컵경기장(성산),115677,42826,158503
201801,2018,6호선,월곡(동덕여대),293338,70985,364323
201801,2018,6호선,연신내,21,1,22
201801,2018,6호선,역촌,83634,31868,115502
201801,2018,6호선,약수,88381,23029,111410
201801,2018,6호선,안암(고대병원앞),311248,33107,344355
201801,2018,6호선,신당,226106,38821,264927
201801,2018,6호선,석계,311295,69030,380325
201801,2018,6호선,새절(신사),307527,78191,385718
201801,2018,6호선,상월곡(한국과학기술연구원),144649,36891,181540
201801,2018,6호선,상수,301606,21805,323411
201801,2018,6호선,삼각지,196784,17572,214356
201801,2018,6호선,불광,128929,39688,168617
201801,2018,6호선,봉화산(서울의료원),235906,48360,284266
201801,2018,6호선,보문,193799,31166,224965
201801,2018,6호선,버티고개,58074,13686,71760
201801,2018,6호선,망원,330793,77271,408064
201801,2018,6호선,마포구청,332270,74174,406444
201801,2018,6호선,디지털미디어시티,359497,51295,410792
201801,2018,6호선,동묘앞,203993,62091,266084
201801,2018,6호선,돌곶이,205120,57939,263059
201801,2018,6호선,독바위,67509,19045,86554
201801,2018,6호선,대흥(서강대앞),199690,42429,242119
201801,2018,6호선,녹사평(용산구청),171967,18189,190156
201801,2018,6호선,구산,183340,51097,234437
201801,2018,6호선,광흥창(서강),230184,53101,283285
201801,2018,6호선,효창공원앞,169702,36883,206585
201801,2018,6호선,고려대(종암),224331,31725,256056
201801,2018,5호선,개롱,157228,41237,198465
201801,2018,5호선,행당,209672,45586,255258
201801,2018,5호선,충정로(경기대입구),118428,15662,134090
201801,2018,5호선,청구,97338,25996,123334
201801,2018,5호선,천호(풍납토성),492254,139295,631549
201801,2018,5호선,종로3가,354407,118357,472764
201801,2018,5호선,장한평,468903,91108,560011
201801,2018,5호선,을지로4가,109022,40166,149188
201801,2018,5호선,우장산,378404,77784,456188
201801,2018,5호선,왕십리(성동구청),129509,23928,153437
201801,2018,5호선,올림픽공원(한국체대),129067,30504,159571
201801,2018,5호선,오목교(목동운동장앞),675467,81053,756520
201801,2018,5호선,오금,87459,16658,104117
201801,2018,5호선,영등포시장,205190,72659,277849
201801,2018,5호선,영등포구청,87976,18959,106935
201801,2018,5호선,여의도,671137,51117,722254
201801,2018,5호선,여의나루,188975,23664,212639
201801,2018,5호선,양평,165333,26756,192089
201801,2018,5호선,애오개,182490,36950,219440
201801,2018,5호선,아차산(어린이대공원후문),346020,85561,431581
201801,2018,5호선,신정(은행정),376269,56913,433182
201801,2018,5호선,신길,85031,11705,96736
201801,2018,5호선,신금호,142456,34411,176867
201801,2018,5호선,송정,217858,54422,272280
201801,2018,5호선,서대문,441205,67930,509135
201801,2018,5호선,상일동,293068,56936,350004
201801,2018,5호선,방화,175467,43773,219240
201801,2018,5호선,방이,180117,41690,221807
201801,2018,5호선,발산,407731,63100,470831
201801,2018,5호선,목동,467926,79257,547183
201801,2018,5호선,명일,185520,56054,241574
201801,2018,5호선,마포,366241,63060,429301
201801,2018,5호선,마천,103224,43618,146842
201801,2018,5호선,마장,139499,42755,182254
201801,2018,5호선,마곡,213373,24554,237927
201801,2018,5호선,둔촌동,232448,60887,293335
201801,2018,5호선,동대문역사문화공원,78146,9932,88078
201801,2018,5호선,답십리,411507,78928,490435
201801,2018,5호선,까치산,756656,142086,898742
201801,2018,5호선,김포공항,218015,28057,246072
201801,2018,5호선,길동,174109,56917,231026
201801,2018,5호선,굽은다리(강동구민회관앞),235521,60198,295719
201801,2018,5호선,군자(능동),294963,36817,331780
201801,2018,5호선,광화문(세종문화회관),1057436,78276,1135712
201801,2018,5호선,광나루(장신대),357251,60064,417315
201801,2018,5호선,공덕,357302,43422,400724
201801,2018,5호선,고덕,223740,56194,279934
201801,2018,5호선,거여,152088,47976,200064
201801,2018,5호선,개화산,145680,33130,178810
201801,2018,5호선,화곡,753316,134547,887863
201801,2018,5호선,강동,499060,94870,593930
201801,2018,4호선,남태령,66613,8344,74957
201801,2018,4호선,혜화,1122033,128886,1250919
201801,2018,4호선,한성대입구(삼선교),377811,73626,451437
201801,2018,4호선,충무로,793899,122722,916621
201801,2018,4호선,총신대입구(이수),504780,134507,639287
201801,2018,4호선,창동,679539,177371,856910
201801,2018,4호선,이촌(국립중앙박물관),234280,41976,276256
201801,2018,4호선,쌍문,838464,156605,995069
201801,2018,4호선,신용산,409214,46015,455229
201801,2018,4호선,숙대입구(갈월),398908,54481,453389
201801,2018,4호선,수유(강북구청),959031,201329,1160360
201801,2018,4호선,성신여대입구(돈암),611351,87149,698500
201801,2018,4호선,서울역,347662,39217,386879
201801,2018,4호선,상계,519744,107521,627265
201801,2018,4호선,삼각지,125910,26828,152738
201801,2018,4호선,사당,778762,85902,864664
201801,2018,4호선,미아사거리,729590,169004,898594
201801,2018,4호선,미아(서울사이버대학),401078,112049,513127
201801,2018,4호선,명동,1007432,69320,1076752
201801,2018,4호선,동작(현충원),44764,16612,61376
201801,2018,4호선,동대문역사문화공원,609509,62620,672129
201801,2018,4호선,동대문,588758,137915,726673
201801,2018,4호선,당고개,294194,83794,377988
201801,2018,4호선,노원,593497,86630,680127
201801,2018,4호선,회현(남대문시장),688347,175331,863678
201801,2018,4호선,길음,556397,116710,673107
201801,2018,3호선,경복궁(정부서울청사),605628,82148,687776
201801,2018,3호선,학여울,60687,17667,78354
201801,2018,3호선,충무로,52,1,53
201801,2018,3호선,지축,26400,8666,35066
201801,2018,3호선,종로3가,236861,53438,290299
201801,2018,3호선,잠원,145272,33031,178303
201801,2018,3호선,일원,209600,55019,264619
201801,2018,3호선,을지로3가,248606,58848,307454
201801,2018,3호선,옥수,236884,53869,290753
201801,2018,3호선,오금,179488,26327,205815
201801,2018,3호선,연신내,1005544,245615,1251159
201801,2018,3호선,양재(서초구청),1054814,153965,1208779
201801,2018,3호선,약수,338885,79841,418726
201801,2018,3호선,압구정,919232,137008,1056240
201801,2018,3호선,안국,605564,118639,724203
201801,2018,3호선,신사,901448,71389,972837
201801,2018,3호선,수서,436256,91893,528149
201801,2018,3호선,불광,421985,138718,560703
201801,2018,3호선,무악재,93648,29492,123140
201801,2018,3호선,매봉,283080,52161,335241
201801,2018,3호선,동대입구,265016,32938,297954
201801,2018,3호선,독립문,162274,64588,226862
201801,2018,3호선,남부터미널(예술의전당),951193,119031,1070224
201801,2018,3호선,금호,206758,52364,259122
201801,2018,3호선,구파발,504319,91112,595431
201801,2018,3호선,교대(법원.검찰청),356552,66247,422799
201801,2018,3호선,고속터미널,1614652,172444,1787096
201801,2018,3호선,경찰병원,197134,39320,236454
201801,2018,3호선,홍제,427065,138775,565840
201801,2018,3호선,가락시장,235081,68662,303743
201801,2018,2호선,강변(동서울터미널),1262456,131556,1394012
201801,2018,2호선,합정,932584,68597,1001181
201801,2018,2호선,한양대,232069,14147,246216
201801,2018,2호선,충정로(경기대입구),293445,50724,344169
201801,2018,2호선,종합운동장,286379,45961,332340
201801,2018,2호선,잠실새내,686103,111299,797402
201801,2018,2호선,잠실나루,425786,83811,509597
201801,2018,2호선,잠실(송파구청),2483509,213047,2696556
201801,2018,2호선,이대,459236,55248,514484
201801,2018,9호선,증미,174617,37978,212595
201801,2018,2호선,을지로입구,1396772,111049,1507821
201801,2018,2호선,을지로4가,281208,90079,371287
201801,2018,2호선,을지로3가,547851,85287,633138
201801,2018,2호선,용두(동대문구청),46947,21623,68570
201801,2018,2호선,용답,60283,15425,75708
201801,2018,2호선,왕십리(성동구청),514595,56056,570651
201801,2018,2호선,영등포구청,563201,102515,665716
201801,2018,2호선,역삼,1354325,153709,1508034
201801,2018,2호선,양천구청,159790,40457,200247
201801,2018,2호선,아현,237778,59522,297300
201801,2018,2호선,신촌,1320733,133863,1454596
201801,2018,2호선,신정네거리,224246,60313,284559
201801,2018,2호선,신설동,99142,35371,134513
201801,2018,2호선,신림,1891251,228068,2119319
201801,2018,2호선,신도림,1607072,192790,1799862
201801,2018,2호선,신대방,727396,119708,847104
201801,2018,2호선,신당,348611,98889,447500
201801,2018,2호선,신답,30720,9202,39922
201801,2018,2호선,시청,690197,55707,745904
201801,2018,2호선,성수,725202,100066,825268
201801,2018,2호선,선릉,1502590,210740,1713330
201801,2018,2호선,서초,597132,78945,676077
201801,2018,2호선,서울대입구(관악구청),1383920,192852,1576772
201801,2018,2호선,상왕십리,347403,64814,412217
201801,2018,2호선,삼성(무역센터),1647527,125825,1773352
201801,2018,2호선,사당,1056459,187237,1243696
201801,2018,우이신설선,솔샘,119628,28634,148262
201801,2018,2호선,봉천,562338,139361,701699
201801,2018,2호선,방배,496361,77135,573496
201801,2018,2호선,문래,504754,78160,582914
201801,2018,2호선,뚝섬,436272,59103,495375
201801,2018,2호선,동대문역사문화공원,452369,55533,507902
201801,2018,2호선,도림천,28037,6093,34130
201801,2018,2호선,대림(구로구청),775614,107428,883042
201801,2018,2호선,당산,548648,60304,608952
201801,2018,2호선,낙성대,798482,105563,904045
201801,2018,2호선,구의(광진구청),616619,100806,717425
201801,2018,2호선,구로디지털단지,1769875,161649,1931524
201801,2018,2호선,교대(법원.검찰청),945822,160261,1106083
201801,2018,2호선,건대입구,1220169,90299,1310468
201801,2018,2호선,홍대입구,2251967,107946,2359913
201801,2018,2호선,강남,3171113,170785,3341898
201801,2018,1호선,신설동,354824,114363,469187
201801,2018,1호선,종로5가,527233,244849,772082
201801,2018,1호선,종로3가,701897,337898,1039795
201801,2018,1호선,종각,1273091,148482,1421573
201801,2018,1호선,제기동,284793,305347,590140
201801,2018,1호선,청량리(서울시립대입구),480847,311669,792516
201801,2018,1호선,시청,647999,88361,736360
201801,2018,1호선,서울역,1409788,195218,1605006
201801,2018,1호선,동묘앞,159872,125158,285030
201801,2018,1호선,동대문,312260,122036,434296
201801,2018,우이신설선,신설동,31411,13265,44676
201801,2018,우이신설선,정릉,75815,35088,110903
201801,2018,우이신설선,삼양사거리,35131,27471,62602
201801,2018,일산선,대곡,35179,9114,44293
201801,2018,일산선,화정,456979,119273,576252
201801,2018,일산선,마두,176220,69845,246065
201801,2018,일산선,대화,348168,81844,430012
201801,2018,일산선,주엽,194908,86012,280920
201801,2018,일산선,정발산,208574,51269,259843
201801,2018,일산선,원흥,186537,36924,223461
201801,2018,일산선,원당,270694,76591,347285
201801,2018,일산선,삼송,388582,78145,466727
201801,2018,일산선,백석,280514,72384,352898
201801,2018,장항선,쌍용(나사렛대),50266,14057,64323
201801,2018,장항선,신창(순천향대),28100,6719,34819
201801,2018,장항선,온양온천,87617,62668,150285
201801,2018,장항선,봉명,26818,12815,39633
201801,2018,장항선,아산,69943,8998,78941
201801,2018,장항선,배방,23127,6494,29621
201801,2018,중앙선,구리,316658,75752,392410
201801,2018,중앙선,회기,678525,118949,797474
201801,2018,중앙선,덕소,137151,46252,183403
201801,2018,중앙선,도농,200998,50914,251912
201801,2018,중앙선,도심,57819,18173,75992
201801,2018,중앙선,망우,175956,62503,238459
201801,2018,중앙선,상봉(시외버스터미널),138335,35569,173904
201801,2018,중앙선,신원,3256,2124,5380
201801,2018,중앙선,아신,12646,4981,17627
201801,2018,중앙선,양수,37588,14115,51703
201801,2018,중앙선,양원,28994,14340,43334
201801,2018,중앙선,양정,16700,6136,22836
201801,2018,중앙선,양평,72228,31143,103371
201801,2018,중앙선,오빈,5953,5056,11009
201801,2018,중앙선,용문,39796,30989,70785
201801,2018,중앙선,운길산,14875,5190,20065
201801,2018,중앙선,원덕,6441,6501,12942
201801,2018,중앙선,중랑,123674,47841,171515
201801,2018,중앙선,지평,656,442,1098
201801,2018,중앙선,팔당,18261,5081,23342
201801,2018,중앙선,국수,13932,7247,21179
201801,2018,3호선,도곡,162763,27600,190363
201801,2018,7호선,논현,540980,50110,591090
201801,2018,9호선,염창,421446,57008,478454
201801,2018,우이신설선,솔밭공원,43250,21258,64508
201801,2018,우이신설선,성신여대입구(돈암),81494,28247,109741
201801,2018,우이신설선,화계,51655,30896,82551
201801,2018,우이신설선,삼양,34568,21463,56031
201801,2018,3호선,녹번,323306,60930,384236
201801,2018,3호선,대청,241933,48695,290628
201801,2018,3호선,대치,325964,59245,385209
201712,2017,6호선,대흥(서강대앞),218370,45420,263790
201712,2017,중앙선,국수,18057,8216,26273
201712,2017,중앙선,팔당,19700,5370,25070
201712,2017,중앙선,지평,925,434,1359
201712,2017,중앙선,중랑,131478,50735,182213
201712,2017,중앙선,원덕,7106,7342,14448
201712,2017,중앙선,운길산,16564,5509,22073
201712,2017,중앙선,용문,44627,33535,78162
201712,2017,중앙선,오빈,6761,5158,11919
201712,2017,중앙선,양평,80912,34160,115072
201712,2017,중앙선,양정,17450,6618,24068
201712,2017,중앙선,양원,38067,15635,53702
201712,2017,중앙선,양수,40986,15459,56445
201712,2017,중앙선,아신,15937,5666,21603
201712,2017,중앙선,신원,3540,2405,5945
201712,2017,중앙선,상봉(시외버스터미널),137445,36321,173766
201712,2017,중앙선,망우,192979,66528,259507
201712,2017,중앙선,도심,63557,19606,83163
201712,2017,중앙선,도농,218413,55878,274291
201712,2017,중앙선,덕소,150461,48330,198791
201712,2017,중앙선,회기,791185,127877,919062
201712,2017,중앙선,구리,343641,80023,423664
201712,2017,장항선,배방,25802,7469,33271
201712,2017,장항선,아산,84828,10340,95168
201712,2017,장항선,봉명,27618,12834,40452
201712,2017,장항선,온양온천,98217,70677,168894
201712,2017,장항선,신창(순천향대),46864,7737,54601
201712,2017,장항선,쌍용(나사렛대),63789,16702,80491
201712,2017,일산선,백석,305674,78299,383973
201712,2017,일산선,삼송,442251,85338,527589
201712,2017,일산선,원당,292783,83119,375902
201712,2017,일산선,원흥,202496,40525,243021
201712,2017,일산선,정발산,232897,56291,289188
201712,2017,일산선,주엽,210806,92929,303735
201712,2017,일산선,대화,382745,88248,470993
201712,2017,일산선,마두,185601,73371,258972
201712,2017,일산선,화정,490937,127978,618915
201712,2017,일산선,대곡,38700,9368,48068
201712,2017,우이신설선,삼양사거리,36202,27199,63401
201712,2017,우이신설선,정릉,80073,36815,116888
201712,2017,우이신설선,신설동,31230,13263,44493
201712,2017,우이신설선,솔샘,120556,29065,149621
201712,2017,우이신설선,솔밭공원,43584,20938,64522
201712,2017,우이신설선,성신여대입구(돈암),87508,28240,115748
201712,2017,우이신설선,화계,53624,30903,84527
201712,2017,우이신설선,삼양,35018,20835,55853
201712,2017,우이신설선,북한산우이,49178,27924,77102
201712,2017,우이신설선,북한산보국문,128345,34710,163055
201712,2017,우이신설선,보문,29244,12731,41975
201712,2017,우이신설선,가오리,73049,35958,109007
201712,2017,우이신설선,4.19민주묘지,53242,23156,76398
201712,2017,안산선,신길온천,46680,8290,54970
201712,2017,안산선,초지,113167,16307,129474
201712,2017,안산선,중앙,480346,56837,537183
201712,2017,안산선,정왕,261697,25236,286933
201712,2017,안산선,오이도,258285,34897,293182
201712,2017,안산선,안산,482060,41768,523828
201712,2017,안산선,한대앞,250854,38994,289848
201712,2017,안산선,수리산,106555,31233,137788
201712,2017,안산선,상록수,564111,83787,647898
201712,2017,안산선,산본,463909,102086,565995
201712,2017,안산선,반월,119731,27517,147248
201712,2017,안산선,대야미,102342,24138,126480
201712,2017,안산선,고잔,247209,36062,283271
201712,2017,수인선,연수,139202,28128,167330
201712,2017,수인선,인하대,157906,21644,179550
201712,2017,수인선,인천논현,165821,32593,198414
201712,2017,수인선,인천,23178,9554,32732
201712,2017,수인선,월곶,71014,12644,83658
201712,2017,수인선,원인재,121249,26626,147875
201712,2017,수인선,호구포,95719,16746,112465
201712,2017,수인선,신포,46948,11598,58546
201712,2017,수인선,숭의,76736,23697,100433
201712,2017,수인선,송도,71163,19969,91132
201712,2017,수인선,소래포구,106438,37673,144111
201712,2017,수인선,달월,2452,1539,3991
201712,2017,수인선,남동인더스파크,56401,5007,61408
201712,2017,분당선,강남구청,221460,38797,260257
201712,2017,분당선,태평,365065,90055,455120
201712,2017,분당선,청명,117016,17010,134026
201712,2017,분당선,죽전,424641,80248,504889
201712,2017,분당선,정자,457794,82280,540074
201712,2017,분당선,이매,149162,38397,187559
201712,2017,분당선,오리,356818,91491,448309
201712,2017,분당선,영통,267506,28742,296248
201712,2017,분당선,야탑,752035,162987,915022
201712,2017,분당선,압구정로데오,438854,39389,478243
201712,2017,분당선,신갈,113064,30817,143881
201712,2017,분당선,수원시청,340123,36241,376364
201712,2017,분당선,수원,272246,27446,299692
201712,2017,분당선,수서,377376,61388,438764
201712,2017,분당선,수내,363298,82645,445943
201712,2017,분당선,선정릉,194496,36225,230721
201712,2017,분당선,선릉,221059,27900,248959
201712,2017,분당선,서현,764842,133071,897913
201712,2017,분당선,서울숲,192733,22158,214891
201712,2017,분당선,상갈,133651,31205,164856
201712,2017,분당선,복정,3,0,3
201712,2017,분당선,보정,61787,25000,86787
201712,2017,분당선,미금,491849,123136,614985
201712,2017,분당선,모란,561003,150941,711944
201712,2017,분당선,매탄권선,128495,14769,143264
201712,2017,분당선,매교,72600,18267,90867
201712,2017,분당선,망포,390355,31937,422292
201712,2017,분당선,도곡,174205,42580,216785
201712,2017,분당선,대모산입구,68868,28390,97258
201712,2017,분당선,기흥,221358,32790,254148
201712,2017,분당선,구성,116527,39301,155828
201712,2017,분당선,구룡,48556,19733,68289
201712,2017,분당선,개포동,78412,20859,99271
201712,2017,분당선,한티,381203,67472,448675
201712,2017,분당선,가천대,270190,26372,296562
201712,2017,과천선,범계,841597,108840,950437
201712,2017,과천선,대공원,84351,28318,112669
201712,2017,과천선,선바위,247957,31944,279901
201712,2017,과천선,경마공원,165834,63506,229340
201712,2017,과천선,정부과천청사,323783,61981,385764
201712,2017,과천선,평촌,461403,63917,525320
201712,2017,과천선,인덕원,715035,104356,819391
201712,2017,과천선,과천,114745,31928,146673
201712,2017,공항철도 1호선,청라국제도시,157181,9154,166335
201712,2017,공항철도 1호선,서울역,334488,30633,365121
201712,2017,공항철도 1호선,인천공항1터미널,527320,41314,568634
201712,2017,공항철도 1호선,디지털미디어시티,343694,22979,366673
201712,2017,공항철도 1호선,영종,47432,11768,59200
201712,2017,공항철도 1호선,공항화물청사,65625,7039,72664
201712,2017,공항철도 1호선,공덕,51269,6561,57830
201712,2017,공항철도 1호선,계양,303657,29673,333330
201712,2017,공항철도 1호선,검암,248189,22385,270574
201712,2017,공항철도 1호선,김포공항,300381,17876,318257
201712,2017,공항철도 1호선,홍대입구,277158,16833,293991
201712,2017,공항철도 1호선,운서,163018,21729,184747
201712,2017,경춘선,굴봉산,3824,1517,5341
201712,2017,경춘선,금곡,31067,15302,46369
201712,2017,경춘선,김유정,9378,3353,12731
201712,2017,경춘선,남춘천,72688,22072,94760
201712,2017,경춘선,대성리,13520,4321,17841
201712,2017,경춘선,마석,82872,29155,112027
201712,2017,경춘선,백양리,9257,1143,10400
201712,2017,경춘선,별내,58583,17127,75710
201712,2017,경춘선,상천,5452,3893,9345
201712,2017,경춘선,사릉,89676,17999,107675
201712,2017,경춘선,신내,15031,6274,21305
201712,2017,경춘선,천마산,30333,14867,45200
201712,2017,경춘선,청평,51703,13326,65029
201712,2017,경춘선,춘천,43922,15246,59168
201712,2017,경춘선,퇴계원,82461,23096,105557
201712,2017,경춘선,평내호평,145531,40602,186133
201712,2017,경춘선,가평,52599,10918,63517
201712,2017,경춘선,갈매,53411,14115,67526
201712,2017,경춘선,강촌,13406,3541,16947
201712,2017,경인선,오류동,275064,91050,366114
201712,2017,경인선,도원,88133,33213,121346
201712,2017,경인선,부천,1084198,210826,1295024
201712,2017,경인선,중동,244246,65484,309730
201712,2017,경인선,주안,678153,100874,779027
201712,2017,경인선,제물포,289256,60066,349322
201712,2017,경인선,도화,87724,35954,123678
201712,2017,경인선,동암,496831,103583,600414
201712,2017,경인선,인천,94041,30806,124847
201712,2017,경인선,동인천,443604,122859,566463
201712,2017,경인선,백운,216995,65626,282621
201712,2017,경인선,송내,881745,115462,997207
201712,2017,경인선,부평,1052803,145926,1198729
201712,2017,경인선,역곡,820626,147583,968209
201712,2017,경인선,구일,277413,34994,312407
201712,2017,경인선,개봉,600465,157675,758140
201712,2017,경인선,부개,246525,63271,309796
201712,2017,경인선,간석,162993,44519,207512
201712,2017,경인선,소사,327793,85189,412982
201712,2017,경인선,온수(성공회대입구),177488,43582,221070
201712,2017,경의선,서울역,70869,8797,79666
201712,2017,경의선,서강대,57663,8962,66625
201712,2017,경의선,백마,177066,30312,207378
201712,2017,경의선,문산,151844,42934,194778
201712,2017,경의선,디지털미디어시티,58039,11640,69679
201712,2017,경의선,능곡,87220,29179,116399
201712,2017,경의선,김포공항,8,0,8
201712,2017,경의선,금촌,189624,43105,232729
201712,2017,경의선,금릉,126508,23732,150240
201712,2017,경의선,공덕,2,0,2
201712,2017,경의선,공덕,79441,11057,90498
201712,2017,경의선,곡산,12190,4271,16461
201712,2017,경의선,계양,5,0,5
201712,2017,경의선,검암,7,0,7
201712,2017,경의선,강매,64576,16307,80883
201712,2017,경의선,가좌,109144,44335,153479
201712,2017,경의선,효창공원앞,62512,11949,74461
201712,2017,경의선,화전,71950,8010,79960
201712,2017,경의선,홍대입구,1,0,1
201712,2017,경의선,홍대입구,50026,4910,54936
201712,2017,경의선,행신,210256,36041,246297
201712,2017,경의선,풍산,122794,28229,151023
201712,2017,경의선,파주,46395,9156,55551
201712,2017,경의선,탄현,201768,34870,236638
201712,2017,경의선,일산,237431,55152,292583
201712,2017,경의선,월롱,76614,7320,83934
201712,2017,경의선,운정,134082,29601,163683
201712,2017,경의선,야당,106681,23574,130255
201712,2017,경의선,신촌,20407,3130,23537
201712,2017,경의선,수색,53043,19489,72532
201712,2017,경의선,서울역,6,0,6
201712,2017,경원선,소요산,56085,55228,111313
201712,2017,경원선,보산,46141,13565,59706
201712,2017,경원선,방학,210877,104080,314957
201712,2017,경원선,망월사,203207,68659,271866
201712,2017,경원선,동두천중앙,81142,38334,119476
201712,2017,경원선,동두천,49477,17678,67155
201712,2017,경원선,도봉산,167408,82363,249771
201712,2017,경원선,도봉,133534,68814,202348
201712,2017,경원선,덕정,178762,33026,211788
201712,2017,경원선,덕계,49101,15138,64239
201712,2017,경원선,녹천,117877,38965,156842
201712,2017,경원선,녹양,120694,33014,153708
201712,2017,경원선,광운대,242931,54240,297171
201712,2017,경원선,가능,167330,58272,225602
201712,2017,4호선,미아사거리,794353,182909,977262
201712,2017,4호선,미아(서울사이버대학),442216,118843,561059
201712,2017,4호선,명동,1247930,81104,1329034
201712,2017,4호선,동작(현충원),49740,17509,67249
201712,2017,4호선,동대문역사문화공원,673342,67372,740714
201712,2017,4호선,동대문,635770,151761,787531
201712,2017,4호선,당고개,313919,89717,403636
201712,2017,4호선,노원,631324,94328,725652
201712,2017,4호선,회현(남대문시장),735095,199174,934269
201712,2017,4호선,길음,621689,127345,749034
201712,2017,3호선,경복궁(정부서울청사),689616,89694,779310
201712,2017,3호선,학여울,95968,15259,111227
201712,2017,3호선,충무로,64,0,64
201712,2017,3호선,지축,27809,9598,37407
201712,2017,3호선,종로3가,227847,55718,283565
201712,2017,3호선,잠원,157410,36167,193577
201712,2017,3호선,일원,218209,56506,274715
201712,2017,3호선,을지로3가,250925,61783,312708
201712,2017,3호선,옥수,252128,58070,310198
201712,2017,3호선,오금,185593,28790,214383
201712,2017,3호선,연신내,1068472,265314,1333786
201712,2017,3호선,양재(서초구청),1090835,172888,1263723
201712,2017,3호선,약수,355874,84853,440727
201712,2017,3호선,압구정,936257,151670,1087927
201712,2017,3호선,안국,670521,127074,797595
201712,2017,3호선,신사,926242,76617,1002859
201712,2017,3호선,수서,462837,98976,561813
201712,2017,3호선,불광,452917,150205,603122
201712,2017,3호선,무악재,97776,32393,130169
201712,2017,3호선,매봉,281215,57143,338358
201712,2017,3호선,동대입구,325530,39433,364963
201712,2017,3호선,독립문,181206,68952,250158
201712,2017,3호선,도곡,177297,32555,209852
201712,2017,3호선,대치,306458,64187,370645
201712,2017,3호선,대청,260797,52640,313437
201712,2017,경원선,회룡,257154,133508,390662
201712,2017,경원선,한남,100598,33044,133642
201712,2017,경원선,청량리(서울시립대입구),354429,139439,493868
201712,2017,경원선,창동,4,0,4
201712,2017,경원선,지행,189294,43108,232402
201712,2017,경원선,이촌(국립중앙박물관),110990,29456,140446
201712,2017,경원선,의정부,574366,119557,693923
201712,2017,경원선,응봉,41025,17440,58465
201712,2017,경원선,월계,135513,53246,188759
201712,2017,경원선,외대앞,324966,56014,380980
201712,2017,경원선,왕십리(성동구청),479073,63274,542347
201712,2017,경원선,옥수,1679,113,1792
201712,2017,경원선,양주,229676,51612,281288
201712,2017,경원선,신이문,234773,65033,299806
201712,2017,경원선,서빙고,48845,15910,64755
201712,2017,경원선,석계,258216,63722,321938
201712,2017,경부선,화서,216835,40944,257779
201712,2017,경부선,평택,384098,68034,452132
201712,2017,경부선,천안,192836,58787,251623
201712,2017,경부선,진위,44746,10919,55665
201712,2017,경부선,직산,23132,7037,30169
201712,2017,경부선,지제,55385,6904,62289
201712,2017,경부선,의왕,232964,38977,271941
201712,2017,경부선,용산,1231584,135319,1366903
201712,2017,경부선,오산대,82301,14760,97061
201712,2017,경부선,오산,292308,42805,335113
201712,2017,경부선,영등포,1344482,293947,1638429
201712,2017,경부선,안양,741856,115248,857104
201712,2017,경부선,신도림,93606,20611,114217
201712,2017,경부선,신길,266212,46787,312999
201712,2017,경부선,수원,1292353,147253,1439606
201712,2017,경부선,송탄,135554,24790,160344
201712,2017,경부선,세마,69917,14910,84827
201712,2017,경부선,세류,108762,18560,127322
201712,2017,경부선,성환,120018,21303,141321
201712,2017,경부선,성균관대,444693,53923,498616
201712,2017,경부선,석수,305615,46594,352209
201712,2017,경부선,서정리,138563,26164,164727
201712,2017,경부선,서울역,192995,12620,205615
201712,2017,경부선,서동탄,41135,8805,49940
201712,2017,경부선,병점,436707,57862,494569
201712,2017,경부선,명학,261971,42717,304688
201712,2017,경부선,두정,169908,22732,192640
201712,2017,경부선,독산,433736,65740,499476
201712,2017,경부선,대방,395700,74097,469797
201712,2017,경부선,당정,199444,28132,227576
201712,2017,경부선,노량진,413497,55201,468698
201712,2017,경부선,남영,305894,38978,344872
201712,2017,경부선,금천구청,279760,74759,354519
201712,2017,경부선,금정,746821,106829,853650
201712,2017,경부선,군포,195054,35766,230820
201712,2017,경부선,구로,569690,96485,666175
201712,2017,경부선,광명,58479,4479,62958
201712,2017,경부선,관악,208481,53415,261896
201712,2017,경부선,가산디지털단지,412525,28764,441289
201712,2017,경강선,신둔도예촌,29244,5213,34457
201712,2017,경강선,초월,61136,9520,70656
201712,2017,경강선,이천,68303,11459,79762
201712,2017,경강선,이매,38557,8596,47153
201712,2017,경강선,여주,52918,12788,65706
201712,2017,경강선,판교,89322,10473,99795
201712,2017,경강선,세종대왕릉,5655,2438,8093
201712,2017,경강선,삼동,48575,7469,56044
201712,2017,경강선,부발,49531,5844,55375
201712,2017,경강선,곤지암,57589,10620,68209
201712,2017,경강선,경기광주,165716,21874,187590
201712,2017,9호선2단계,봉은사,423513,38488,462001
201712,2017,9호선2단계,선정릉,181720,20365,202085
201712,2017,9호선2단계,삼성중앙,127234,20863,148097
201712,2017,9호선2단계,종합운동장,176587,15680,192267
201712,2017,9호선2단계,언주,235346,25619,260965
201712,2017,9호선,신방화,208605,44070,252675
201712,2017,9호선,신반포,84817,23639,108456
201712,2017,9호선,신목동,104858,18121,122979
201712,2017,9호선,신논현,863581,53344,916925
201712,2017,9호선,선유도,173536,25184,198720
201712,2017,9호선,샛강,130972,25806,156778
201712,2017,9호선,사평,71734,13767,85501
201712,2017,9호선,양천향교,206949,37899,244848
201712,2017,9호선,여의도,536840,44082,580922
201712,2017,9호선,염창,429733,60890,490623
201712,2017,9호선,증미,171338,39877,211215
201712,2017,9호선,개화,167249,33952,201201
201712,2017,9호선,마곡나루,186777,13104,199881
201712,2017,9호선,등촌,238920,77132,316052
201712,2017,9호선,동작(현충원),42376,11289,53665
201712,2017,9호선,당산,484976,64864,549840
201712,2017,9호선,노량진,791507,91000,882507
201712,2017,9호선,노들,113866,29604,143470
201712,2017,9호선,김포공항,287988,20084,308072
201712,2017,9호선,국회의사당,421859,56304,478163
201712,2017,9호선,구반포,75592,24282,99874
201712,2017,9호선,공항시장,68150,21089,89239
201712,2017,9호선,고속터미널,365650,50866,416516
201712,2017,9호선,흑석(중앙대입구),253867,50361,304228
201712,2017,9호선,가양,514690,121434,636124
201712,2017,8호선,강동구청,275294,62438,337732
201712,2017,8호선,장지,511375,69534,580909
201712,2017,8호선,잠실(송파구청),421646,68515,490161
201712,2017,8호선,암사,482060,93180,575240
201712,2017,8호선,신흥,106962,42745,149707
201712,2017,8호선,수진,124788,45717,170505
201712,2017,8호선,송파,137345,35474,172819
201712,2017,8호선,석촌,219614,58701,278315
201712,2017,8호선,산성,143389,32810,176199
201712,2017,8호선,복정,311106,47095,358201
201712,2017,8호선,문정,397073,45928,443001
201712,2017,8호선,몽촌토성(평화의문),173806,42406,216212
201712,2017,8호선,모란,98076,49625,147701
201712,2017,8호선,단대오거리,287308,65720,353028
201712,2017,8호선,남한산성입구(성남법원.검찰청),370189,71981,442170
201712,2017,8호선,천호(풍납토성),502647,93744,596391
201712,2017,8호선,가락시장,180485,54763,235248
201712,2017,7호선,강남구청,398992,47819,446811
201712,2017,7호선,하계,539336,106578,645914
201712,2017,7호선,태릉입구,236704,39153,275857
201712,2017,7호선,춘의,239328,27878,267206
201712,2017,7호선,청담,532905,75606,608511
201712,2017,7호선,철산,663426,100324,763750
201712,2017,7호선,천왕,222559,45125,267684
201712,2017,7호선,중화,288952,59818,348770
201712,2017,7호선,중곡,260631,60261,320892
201712,2017,7호선,중계,392379,90251,482630
201712,2017,7호선,장암,63066,6635,69701
201712,2017,7호선,장승배기,270396,77498,347894
201712,2017,7호선,이수,455165,80405,535570
201712,2017,7호선,용마산,163859,34359,198218
201712,2017,7호선,온수(성공회대입구),287455,33824,321279
201712,2017,7호선,어린이대공원(세종대),426176,41686,467862
201712,2017,7호선,신풍,294065,69480,363545
201712,2017,7호선,신중동,398597,48657,447254
201712,2017,7호선,신대방삼거리,415116,90837,505953
201712,2017,7호선,숭실대입구(살피재),403233,59330,462563
201712,2017,7호선,수락산,349606,85585,435191
201712,2017,7호선,상봉(시외버스터미널),473854,74447,548301
201712,2017,7호선,상동,411682,49261,460943
201712,2017,7호선,상도,296869,58969,355838
201712,2017,7호선,삼산체육관,145127,24286,169413
201712,2017,7호선,사가정,401216,92259,493475
201712,2017,7호선,부평구청,333846,30442,364288
201712,2017,7호선,부천종합운동장,140861,16218,157079
201712,2017,7호선,부천시청,349827,47472,397299
201712,2017,7호선,보라매,236219,41493,277712
201712,2017,7호선,반포,168512,32436,200948
201712,2017,7호선,면목,409249,84796,494045
201712,2017,7호선,먹골,277962,61037,338999
201712,2017,7호선,마들,298327,75002,373329
201712,2017,7호선,뚝섬유원지,192449,37563,230012
201712,2017,7호선,도봉산,240272,35725,275997
201712,2017,7호선,대림(구로구청),302911,36843,339754
201712,2017,7호선,논현,535484,53222,588706
201712,2017,7호선,노원,547855,114610,662465
201712,2017,7호선,내방,372929,63767,436696
201712,2017,7호선,남성,294361,69705,364066
201712,2017,7호선,남구로,434213,59102,493315
201712,2017,7호선,까치울,189464,23346,212810
201712,2017,7호선,굴포천,258437,34342,292779
201712,2017,7호선,군자(능동),370472,75481,445953
201712,2017,7호선,광명사거리,687921,147064,834985
201712,2017,7호선,공릉(서울과학기술대),333121,68247,401368
201712,2017,7호선,고속터미널,589982,81180,671162
201712,2017,7호선,건대입구,473104,56172,529276
201712,2017,7호선,학동,584658,62030,646688
201712,2017,7호선,가산디지털단지,1102596,78441,1181037
201712,2017,6호선,공덕,491307,74782,566089
201712,2017,6호선,화랑대(서울여대입구),360079,45903,405982
201712,2017,6호선,합정,449084,41461,490545
201712,2017,6호선,한강진,218789,15028,233817
201712,2017,6호선,태릉입구,138804,26982,165786
201712,2017,6호선,청구,95744,18765,114509
201712,2017,3호선,녹번,341363,65309,406672
201712,2017,3호선,남부터미널(예술의전당),988902,136080,1124982
201712,2017,3호선,금호,217032,56277,273309
201712,2017,3호선,구파발,529281,99394,628675
201712,2017,3호선,교대(법원.검찰청),362222,68542,430764
201712,2017,3호선,고속터미널,1843154,200178,2043332
201712,2017,3호선,경찰병원,193848,41374,235222
201712,2017,3호선,홍제,468106,148172,616278
201712,2017,3호선,가락시장,252467,75743,328210
201712,2017,2호선,강변(동서울터미널),1372688,144863,1517551
201712,2017,2호선,합정,972694,74961,1047655
201712,2017,2호선,한양대,356065,15723,371788
201712,2017,2호선,충정로(경기대입구),297393,52488,349881
201712,2017,2호선,종합운동장,352360,50208,402568
201712,2017,2호선,잠실새내,727468,120415,847883
201712,2017,2호선,잠실나루,456200,87974,544174
201712,2017,2호선,잠실(송파구청),2782605,236199,3018804
201712,2017,2호선,이대,576751,68591,645342
201712,2017,2호선,을지로입구,1499355,122345,1621700
201712,2017,2호선,을지로4가,291664,92741,384405
201712,2017,2호선,을지로3가,550014,90958,640972
201712,2017,2호선,용두(동대문구청),48936,23011,71947
201712,2017,2호선,용답,66554,16600,83154
201712,2017,2호선,왕십리(성동구청),574752,61683,636435
201712,2017,2호선,영등포구청,563733,106628,670361
201712,2017,2호선,역삼,1265021,159264,1424285
201712,2017,2호선,양천구청,168158,44232,212390
201712,2017,2호선,아현,261803,63777,325580
201712,2017,2호선,신촌,1434233,145217,1579450
201712,2017,2호선,신정네거리,236588,64701,301289
201712,2017,2호선,신설동,101161,37843,139004
201712,2017,2호선,신림,1966259,246453,2212712
201712,2017,2호선,신도림,1724813,208102,1932915
201712,2017,2호선,신대방,748679,127471,876150
201712,2017,2호선,신당,369756,104942,474698
201712,2017,2호선,신답,32880,10018,42898
201712,2017,2호선,시청,718081,61064,779145
201712,2017,2호선,성수,708808,101374,810182
201712,2017,2호선,선릉,1469709,214663,1684372
201712,2017,2호선,서초,630522,90510,721032
201712,2017,2호선,서울대입구(관악구청),1428443,203862,1632305
201712,2017,2호선,상왕십리,362922,67680,430602
201712,2017,2호선,삼성(무역센터),1844750,130990,1975740
201712,2017,2호선,사당,1140749,216670,1357419
201712,2017,2호선,봉천,576204,145967,722171
201712,2017,2호선,방배,547673,83849,631522
201712,2017,2호선,문래,499906,82401,582307
201712,2017,2호선,뚝섬,436308,62507,498815
201712,2017,2호선,동대문역사문화공원,517722,61880,579602
201712,2017,2호선,도림천,28201,6356,34557
201712,2017,2호선,대림(구로구청),802375,114807,917182
201712,2017,2호선,당산,584661,67224,651885
201712,2017,2호선,낙성대,826102,114714,940816
201712,2017,2호선,구의(광진구청),632152,107291,739443
201712,2017,2호선,구로디지털단지,1779700,171539,1951239
201712,2017,2호선,교대(법원.검찰청),940969,176469,1117438
201712,2017,2호선,건대입구,1311016,98292,1409308
201712,2017,2호선,홍대입구,2453067,117894,2570961
201712,2017,2호선,강남,2999217,175196,3174413
201712,2017,1호선,신설동,381805,121716,503521
201712,2017,1호선,종로5가,568364,266374,834738
201712,2017,1호선,종로3가,741139,381909,1123048
201712,2017,1호선,종각,1341757,166079,1507836
201712,2017,1호선,제기동,296747,321443,618190
201712,2017,1호선,청량리(서울시립대입구),526470,321642,848112
201712,2017,1호선,시청,705560,97384,802944
201712,2017,1호선,서울역,1485919,211349,1697268
201712,2017,1호선,동묘앞,174868,134444,309312
201712,2017,1호선,동대문,355005,137250,492255
201712,2017,6호선,창신,94527,17918,112445
201712,2017,6호선,증산(명지대앞),263162,68922,332084
201712,2017,6호선,이태원,561871,36214,598085
201712,2017,6호선,응암,446903,110006,556909
201712,2017,6호선,월드컵경기장(성산),128983,45417,174400
201712,2017,6호선,월곡(동덕여대),331379,75835,407214
201712,2017,6호선,연신내,23,0,23
201712,2017,6호선,역촌,86030,34225,120255
201712,2017,6호선,약수,90866,23423,114289
201712,2017,6호선,안암(고대병원앞),383025,33089,416114
201712,2017,6호선,신당,247338,40597,287935
201712,2017,6호선,석계,339034,75681,414715
201712,2017,6호선,새절(신사),342537,84981,427518
201712,2017,6호선,상월곡(한국과학기술연구원),158911,39648,198559
201712,2017,6호선,상수,335477,24172,359649
201712,2017,6호선,삼각지,235806,21493,257299
201712,2017,6호선,불광,138201,42138,180339
201712,2017,6호선,봉화산(서울의료원),241043,51172,292215
201712,2017,6호선,보문,206971,33630,240601
201712,2017,6호선,버티고개,62347,14695,77042
201712,2017,6호선,망원,341632,81991,423623
201712,2017,6호선,마포구청,340671,79232,419903
201712,2017,6호선,디지털미디어시티,368472,55724,424196
201712,2017,6호선,동묘앞,222499,66147,288646
201712,2017,6호선,돌곶이,219477,61526,281003
201712,2017,6호선,독바위,69033,20064,89097
201712,2017,6호선,녹사평(용산구청),200302,20058,220360
201712,2017,6호선,구산,197901,55034,252935
201712,2017,6호선,광흥창(서강),237358,58011,295369
201712,2017,6호선,효창공원앞,183248,39996,223244
201712,2017,6호선,고려대(종암),265982,34787,300769
201712,2017,5호선,개롱,168251,43474,211725
201712,2017,5호선,행당,216307,47818,264125
201712,2017,5호선,충정로(경기대입구),123450,20621,144071
201712,2017,5호선,청구,100922,26491,127413
201712,2017,5호선,천호(풍납토성),518924,146872,665796
201712,2017,5호선,종로3가,359159,128828,487987
201712,2017,5호선,장한평,486204,96097,582301
201712,2017,5호선,을지로4가,110247,41893,152140
201712,2017,5호선,우장산,403424,81252,484676
201712,2017,5호선,왕십리(성동구청),136844,25753,162597
201712,2017,5호선,올림픽공원(한국체대),179862,33547,213409
201712,2017,5호선,오목교(목동운동장앞),712613,87792,800405
201712,2017,5호선,오금,94065,17558,111623
201712,2017,5호선,영등포시장,210292,77402,287694
201712,2017,5호선,영등포구청,86694,19258,105952
201712,2017,5호선,여의도,658332,55268,713600
201712,2017,5호선,여의나루,244107,26997,271104
201712,2017,5호선,양평,162555,27699,190254
201712,2017,5호선,애오개,185549,39655,225204
201712,2017,5호선,아차산(어린이대공원후문),381341,92671,474012
201712,2017,5호선,신정(은행정),390784,59769,450553
201712,2017,5호선,신길,85657,12700,98357
201712,2017,5호선,신금호,152544,36378,188922
201712,2017,5호선,송정,229525,59938,289463
201712,2017,5호선,서대문,468363,70908,539271
201712,2017,5호선,상일동,303925,61277,365202
201712,2017,5호선,방화,186305,47484,233789
201712,2017,5호선,방이,186781,44651,231432
201712,2017,5호선,발산,421792,69882,491674
201712,2017,5호선,목동,481704,84942,566646
201712,2017,5호선,명일,197558,61377,258935
201712,2017,5호선,마포,370885,66970,437855
201712,2017,5호선,마천,111596,45379,156975
201712,2017,5호선,마장,154820,42383,197203
201712,2017,5호선,마곡,210714,26534,237248
201712,2017,5호선,둔촌동,252253,66461,318714
201712,2017,5호선,동대문역사문화공원,77456,10114,87570
201712,2017,5호선,답십리,429929,84808,514737
201712,2017,5호선,까치산,781816,152948,934764
201712,2017,5호선,김포공항,231422,29283,260705
201712,2017,5호선,길동,180762,60142,240904
201712,2017,5호선,굽은다리(강동구민회관앞),245950,65132,311082
201712,2017,5호선,군자(능동),308709,39948,348657
201712,2017,5호선,광화문(세종문화회관),1131753,89116,1220869
201712,2017,5호선,광나루(장신대),389195,64124,453319
201712,2017,5호선,공덕,369674,47742,417416
201712,2017,5호선,고덕,241111,62711,303822
201712,2017,5호선,거여,163316,51092,214408
201712,2017,5호선,개화산,147266,35225,182491
201712,2017,5호선,화곡,785882,141320,927202
201712,2017,5호선,강동,524621,101865,626486
201712,2017,4호선,남태령,95450,10603,106053
201712,2017,4호선,혜화,1366524,137539,1504063
201712,2017,4호선,한성대입구(삼선교),447697,80164,527861
201712,2017,4호선,충무로,869538,132595,1002133
201712,2017,4호선,총신대입구(이수),542639,144416,687055
201712,2017,4호선,창동,727979,187938,915917
201712,2017,4호선,이촌(국립중앙박물관),263025,46041,309066
201712,2017,4호선,쌍문,887117,166676,1053793
201712,2017,4호선,신용산,412955,50250,463205
201712,2017,4호선,숙대입구(갈월),471032,58807,529839
201712,2017,4호선,수유(강북구청),1024375,216877,1241252
201712,2017,4호선,성신여대입구(돈암),706882,95631,802513
201712,2017,4호선,서울역,360762,41360,402122
201712,2017,4호선,상계,556687,115349,672036
201712,2017,4호선,삼각지,129073,30469,159542
201712,2017,4호선,사당,817216,97018,914234
201711,2017,1호선,시청,712362,106545,818907
201711,2017,1호선,청량리(서울시립대입구),517875,321855,839730
201711,2017,1호선,신설동,384509,124640,509149
201711,2017,1호선,종각,1273073,160643,1433716
201711,2017,1호선,종로3가,717573,366199,1083772
201711,2017,1호선,종로5가,563382,269463,832845
201711,2017,1호선,제기동,301720,335549,637269
201711,2017,2호선,강남,2844199,173069,3017268
201711,2017,2호선,홍대입구,2208087,117738,2325825
201711,2017,2호선,건대입구,1268793,97793,1366586
201711,2017,2호선,교대(법원.검찰청),959639,173038,1132677
201711,2017,2호선,구로디지털단지,1784195,170324,1954519
201711,2017,2호선,구의(광진구청),628928,105902,734830
201711,2017,2호선,낙성대,836643,112875,949518
201711,2017,2호선,당산,598170,68432,666602
201711,2017,2호선,대림(구로구청),805816,116256,922072
201711,2017,2호선,동대문역사문화공원,512592,61247,573839
201711,2017,2호선,뚝섬,456635,65546,522181
201711,2017,2호선,문래,507521,86280,593801
201711,2017,2호선,도림천,28318,6453,34771
201711,2017,2호선,봉천,578586,147756,726342
201711,2017,2호선,사당,1095654,203515,1299169
201711,2017,2호선,삼성(무역센터),1664373,128310,1792683
201711,2017,2호선,상왕십리,360574,67974,428548
201711,2017,2호선,서울대입구(관악구청),1437651,209714,1647365
201711,2017,2호선,서초,643042,93233,736275
201711,2017,2호선,선릉,1491711,220554,1712265
201711,2017,2호선,성수,733882,104697,838579
201711,2017,2호선,시청,718021,64433,782454
201711,2017,2호선,신답,33490,10543,44033
201711,2017,2호선,신당,368071,104289,472360
201711,2017,2호선,신대방,753066,133267,886333
201711,2017,2호선,신도림,1682472,209069,1891541
201711,2017,2호선,방배,583842,85227,669069
201711,2017,2호선,신정네거리,233493,64211,297704
201711,2017,2호선,신촌,1405022,142686,1547708
201711,2017,2호선,아현,273083,66166,339249
201711,2017,2호선,양천구청,168260,46384,214644
201711,2017,2호선,역삼,1287692,157018,1444710
201711,2017,2호선,영등포구청,575979,107992,683971
201711,2017,2호선,왕십리(성동구청),580556,61273,641829
201711,2017,2호선,용답,68222,17053,85275
201711,2017,2호선,용두(동대문구청),47202,23565,70767
201711,2017,2호선,을지로3가,563037,90510,653547
201711,2017,2호선,을지로4가,297500,95116,392616
201711,2017,2호선,을지로입구,1439673,117852,1557525
201711,2017,2호선,이대,597160,71189,668349
201711,2017,2호선,잠실(송파구청),2469947,228720,2698667
201711,2017,2호선,잠실나루,459458,92648,552106
201711,2017,2호선,잠실새내,691891,120696,812587
201711,2017,2호선,신림,1924893,241516,2166409
201711,2017,2호선,신설동,95165,35542,130707
201711,2017,2호선,종합운동장,309633,59772,369405
201711,2017,2호선,충정로(경기대입구),308086,54388,362474
201711,2017,2호선,한양대,395403,19166,414569
201711,2017,2호선,합정,938074,76837,1014911
201711,2017,2호선,강변(동서울터미널),1319333,150204,1469537
201711,2017,3호선,가락시장,247860,76165,324025
201711,2017,3호선,홍제,481996,152024,634020
201711,2017,3호선,경찰병원,195467,39868,235335
201711,2017,3호선,고속터미널,1648109,192181,1840290
201711,2017,3호선,교대(법원.검찰청),384614,71745,456359
201711,2017,3호선,구파발,529389,101030,630419
201711,2017,3호선,금호,214997,56807,271804
201711,2017,3호선,남부터미널(예술의전당),964596,136243,1100839
201711,2017,3호선,녹번,343165,66828,409993
201711,2017,3호선,대청,264511,54273,318784
201711,2017,3호선,대치,321604,64423,386027
201711,2017,3호선,독립문,185848,74497,260345
201711,2017,3호선,동대입구,360797,42205,403002
201711,2017,3호선,매봉,286077,57720,343797
201711,2017,3호선,무악재,98526,34319,132845
201711,2017,3호선,도곡,179473,30565,210038
201711,2017,중앙선,국수,18607,11045,29652
201711,2017,중앙선,지평,1195,609,1804
201711,2017,중앙선,중랑,132767,52882,185649
201711,2017,중앙선,회기,838647,133333,971980
201711,2017,중앙선,원덕,7339,7249,14588
201711,2017,중앙선,운길산,18988,6811,25799
201711,2017,중앙선,용문,48037,42787,90824
201711,2017,중앙선,오빈,6576,5381,11957
201711,2017,중앙선,양평,80254,35150,115404
201711,2017,중앙선,양정,18573,8274,26847
201711,2017,중앙선,양원,41710,16994,58704
201711,2017,중앙선,양수,42740,17931,60671
201711,2017,중앙선,아신,18361,8559,26920
201711,2017,중앙선,신원,3992,2849,6841
201711,2017,중앙선,상봉(시외버스터미널),138182,37353,175535
201711,2017,중앙선,도농,227456,58145,285601
201711,2017,중앙선,덕소,151032,49858,200890
201711,2017,중앙선,망우,191579,69502,261081
201711,2017,중앙선,도심,66551,21055,87606
201711,2017,중앙선,팔당,20892,6681,27573
201711,2017,중앙선,구리,340858,83149,424007
201711,2017,장항선,배방,26433,7470,33903
201711,2017,장항선,아산,94853,10711,105564
201711,2017,장항선,봉명,29375,13463,42838
201711,2017,장항선,온양온천,96389,65391,161780
201711,2017,장항선,신창(순천향대),71016,7931,78947
201711,2017,장항선,쌍용(나사렛대),73945,18472,92417
201711,2017,일산선,삼송,427667,86330,513997
201711,2017,일산선,백석,287502,79741,367243
201711,2017,일산선,원당,289735,85891,375626
201711,2017,일산선,원흥,207529,41939,249468
201711,2017,일산선,정발산,207977,58470,266447
201711,2017,일산선,화정,476604,131931,608535
201711,2017,일산선,주엽,203520,97170,300690
201711,2017,일산선,대화,393463,94208,487671
201711,2017,일산선,마두,179701,75672,255373
201711,2017,일산선,지축,1,0,1
201711,2017,일산선,대곡,41364,11453,52817
201711,2017,우이신설선,삼양사거리,35286,26665,61951
201711,2017,우이신설선,신설동,32339,13857,46196
201711,2017,우이신설선,정릉,79852,37215,117067
201711,2017,우이신설선,솔샘,115814,29501,145315
201711,2017,우이신설선,솔밭공원,43669,22029,65698
201711,2017,우이신설선,성신여대입구(돈암),84578,29186,113764
201711,2017,우이신설선,화계,52224,30238,82462
201711,2017,우이신설선,삼양,34327,21460,55787
201711,2017,우이신설선,북한산우이,54879,30161,85040
201711,2017,우이신설선,북한산보국문,128847,35954,164801
201711,2017,우이신설선,보문,29312,13042,42354
201711,2017,우이신설선,가오리,71937,36124,108061
201711,2017,우이신설선,4.19민주묘지,67463,25318,92781
201711,2017,안산선,반월,120545,30623,151168
201711,2017,안산선,초지,132238,17099,149337
201711,2017,안산선,중앙,476065,57630,533695
201711,2017,안산선,정왕,276973,26468,303441
201711,2017,안산선,오이도,258823,36160,294983
201711,2017,안산선,안산,482632,43904,526536
201711,2017,안산선,한대앞,266526,41160,307686
201711,2017,안산선,신길온천,47532,10788,58320
201711,2017,안산선,수리산,110889,34847,145736
201711,2017,안산선,상록수,585793,85678,671471
201711,2017,안산선,산본,461008,102812,563820
201711,2017,안산선,대야미,104127,26772,130899
201711,2017,안산선,고잔,254427,37738,292165
201711,2017,수인선,연수,132747,28020,160767
201711,2017,수인선,인하대,165836,22273,188109
201711,2017,수인선,인천논현,162016,33376,195392
201711,2017,수인선,인천,22040,9730,31770
201711,2017,수인선,월곶,71681,13797,85478
201711,2017,수인선,원인재,120790,27941,148731
201711,2017,수인선,호구포,93747,16918,110665
201711,2017,수인선,신포,45900,11468,57368
201711,2017,수인선,숭의,77417,25029,102446
201711,2017,수인선,송도,69724,20984,90708
201711,2017,수인선,소래포구,109481,58989,168470
201711,2017,수인선,달월,2330,2961,5291
201711,2017,수인선,남동인더스파크,60591,6661,67252
201711,2017,분당선,강남구청,224447,40566,265013
201711,2017,분당선,태평,357194,90967,448161
201711,2017,분당선,청명,117941,17565,135506
201711,2017,분당선,죽전,437572,82690,520262
201711,2017,분당선,정자,440985,84485,525470
201711,2017,분당선,이매,147246,40097,187343
201711,2017,분당선,오리,353752,94224,447976
201711,2017,분당선,영통,268499,28491,296990
201711,2017,분당선,야탑,724926,163163,888089
201711,2017,분당선,압구정로데오,414803,40677,455480
201711,2017,분당선,미금,475095,126549,601644
201711,2017,분당선,신갈,110291,31418,141709
201711,2017,분당선,수원시청,316615,36524,353139
201711,2017,분당선,수원,275441,27338,302779
201711,2017,분당선,수서,374594,64506,439100
201711,2017,분당선,수내,354641,83031,437672
201711,2017,분당선,선정릉,201106,38706,239812
201711,2017,분당선,선릉,224122,27996,252118
201711,2017,분당선,서현,705111,133275,838386
201711,2017,분당선,서울숲,209856,23730,233586
201711,2017,분당선,상갈,133878,32338,166216
201711,2017,분당선,복정,2,0,2
201711,2017,분당선,보정,62167,25426,87593
201711,2017,분당선,도곡,170441,42828,213269
201711,2017,분당선,모란,553426,158646,712072
201711,2017,분당선,매탄권선,130096,15137,145233
201711,2017,분당선,매교,75166,18686,93852
201711,2017,분당선,망포,388823,32102,420925
201711,2017,분당선,대모산입구,71396,29490,100886
201711,2017,분당선,기흥,228210,32858,261068
201711,2017,분당선,구성,118305,39589,157894
201711,2017,분당선,구룡,52641,19741,72382
201711,2017,분당선,개포동,82288,22227,104515
201711,2017,분당선,한티,373072,70139,443211
201711,2017,분당선,가천대,307668,27695,335363
201711,2017,과천선,범계,827096,109687,936783
201711,2017,과천선,과천,113033,32896,145929
201711,2017,과천선,경마공원,142701,57300,200001
201711,2017,과천선,선바위,255702,33217,288919
201711,2017,과천선,대공원,90909,40702,131611
201711,2017,과천선,평촌,467409,65695,533104
201711,2017,과천선,정부과천청사,331957,65583,397540
201711,2017,과천선,인덕원,719831,102959,822790
201711,2017,공항철도 1호선,운서,149688,22612,172300
201711,2017,공항철도 1호선,김포공항,293761,18962,312723
201711,2017,공항철도 1호선,공항화물청사,67697,7583,75280
201711,2017,공항철도 1호선,공덕,49954,6369,56323
201711,2017,공항철도 1호선,계양,309816,30571,340387
201711,2017,공항철도 1호선,검암,248287,23214,271501
201711,2017,공항철도 1호선,디지털미디어시티,354090,23886,377976
201711,2017,공항철도 1호선,영종,45462,12344,57806
201711,2017,공항철도 1호선,서울역,317948,30414,348362
201711,2017,공항철도 1호선,홍대입구,264103,17161,281264
201711,2017,공항철도 1호선,청라국제도시,158371,9302,167673
201711,2017,공항철도 1호선,인천국제공항,469957,41214,511171
201711,2017,경춘선,강촌,16361,4584,20945
201711,2017,경춘선,마석,87173,31505,118678
201711,2017,경춘선,신내,16614,7343,23957
201711,2017,경춘선,대성리,14401,5195,19596
201711,2017,경춘선,굴봉산,3488,2083,5571
201711,2017,경춘선,금곡,33199,16078,49277
201711,2017,경춘선,천마산,32034,16180,48214
201711,2017,6호선,공덕,491662,75216,566878
201711,2017,7호선,가산디지털단지,1165174,80042,1245216
201711,2017,7호선,학동,607492,64846,672338
201711,2017,7호선,건대입구,463216,53944,517160
201711,2017,7호선,고속터미널,557076,83417,640493
201711,2017,7호선,공릉(서울과학기술대),356172,67759,423931
201711,2017,7호선,광명사거리,682882,146414,829296
201711,2017,7호선,군자(능동),366334,75217,441551
201711,2017,7호선,굴포천,251791,33680,285471
201711,2017,7호선,까치울,188206,24133,212339
201711,2017,7호선,남구로,438647,59220,497867
201711,2017,7호선,남성,301338,69986,371324
201711,2017,7호선,내방,387751,64427,452178
201711,2017,7호선,노원,524308,114401,638709
201711,2017,7호선,논현,545869,53222,599091
201711,2017,7호선,대림(구로구청),288509,36337,324846
201711,2017,경춘선,청평,49253,14800,64053
201711,2017,경춘선,춘천,51918,18696,70614
201711,2017,경춘선,퇴계원,86550,24574,111124
201711,2017,경춘선,평내호평,146923,42595,189518
201711,2017,경춘선,별내,61782,19119,80901
201711,2017,경춘선,가평,62997,13816,76813
201711,2017,경춘선,김유정,11575,4139,15714
201711,2017,경춘선,갈매,55882,14907,70789
201711,2017,경춘선,사릉,96228,19215,115443
201711,2017,경춘선,상천,7352,5634,12986
201711,2017,경춘선,백양리,3159,1217,4376
201711,2017,경춘선,남춘천,73924,22538,96462
201711,2017,경인선,인천,90890,34936,125826
201711,2017,경인선,제물포,308168,61030,369198
201711,2017,경인선,주안,693627,99025,792652
201711,2017,경인선,중동,248721,67302,316023
201711,2017,경인선,부개,248522,65320,313842
201711,2017,경인선,부천,1072271,209089,1281360
201711,2017,경인선,부평,1008733,141992,1150725
201711,2017,경인선,소사,336502,86816,423318
201711,2017,경인선,송내,917989,118871,1036860
201711,2017,경인선,역곡,855493,147559,1003052
201711,2017,경인선,오류동,276394,92160,368554
201711,2017,경인선,온수(성공회대입구),185876,46207,232083
201711,2017,경인선,간석,163739,45383,209122
201711,2017,경인선,개봉,605495,158571,764066
201711,2017,경인선,구일,219053,35797,254850
201711,2017,경인선,도원,95058,35791,130849
201711,2017,경인선,도화,88222,37670,125892
201711,2017,경인선,동암,498368,105667,604035
201711,2017,경인선,동인천,429002,123914,552916
201711,2017,경인선,백운,222895,67912,290807
201711,2017,경의선,백마,181290,32532,213822
201711,2017,경의선,디지털미디어시티,60293,11752,72045
201711,2017,경의선,능곡,89252,30142,119394
201711,2017,경의선,금촌,183861,45758,229619
201711,2017,경의선,금릉,125836,25025,150861
201711,2017,경의선,공덕,78876,11232,90108
201711,2017,경의선,곡산,12819,4959,17778
201711,2017,경의선,강매,68486,17590,86076
201711,2017,경의선,가좌,113393,46737,160130
201711,2017,경의선,월롱,79709,9423,89132
201711,2017,경의선,운정,131904,31703,163607
201711,2017,경의선,야당,102065,24391,126456
201711,2017,경의선,신촌,22652,3603,26255
201711,2017,경의선,문산,149441,56239,205680
201711,2017,경의선,수색,58077,20690,78767
201711,2017,경의선,서울역,1,0,1
201711,2017,경의선,서울역,75127,10219,85346
201711,2017,경의선,서강대,63639,9684,73323
201711,2017,경의선,홍대입구,1,0,1
201711,2017,경의선,홍대입구,46322,5256,51578
201711,2017,경의선,행신,213349,37134,250483
201711,2017,경의선,풍산,121920,29567,151487
201711,2017,경의선,파주,52038,9186,61224
201711,2017,경의선,탄현,203386,37996,241382
201711,2017,경의선,효창공원앞,65930,12533,78463
201711,2017,경의선,화전,88292,10466,98758
201711,2017,경의선,일산,241876,59549,301425
201711,2017,경원선,방학,212765,106457,319222
201711,2017,경원선,도봉산,175018,90416,265434
201711,2017,경원선,도봉,136344,71250,207594
201711,2017,경원선,덕정,191495,35516,227011
201711,2017,경원선,망월사,230213,71091,301304
201711,2017,경원선,동두천중앙,82077,39238,121315
201711,2017,경원선,동두천,51043,18907,69950
201711,2017,경원선,덕계,50662,18073,68735
201711,2017,경원선,녹천,122949,41031,163980
201711,2017,경원선,녹양,121690,34823,156513
201711,2017,경원선,광운대,266862,55548,322410
201711,2017,경원선,가능,170121,59393,229514
201711,2017,경원선,이촌(국립중앙박물관),110383,30726,141109
201711,2017,경원선,의정부,542930,118968,661898
201711,2017,경원선,응봉,43271,18882,62153
201711,2017,경원선,월계,149786,57047,206833
201711,2017,경원선,외대앞,345693,58119,403812
201711,2017,경원선,왕십리(성동구청),479930,61607,541537
201711,2017,경원선,옥수,1792,123,1915
201711,2017,경원선,양주,237219,55607,292826
201711,2017,경원선,신이문,237088,67518,304606
201711,2017,경원선,소요산,60610,73808,134418
201711,2017,경원선,석계,268313,65282,333595
201711,2017,경원선,서빙고,50116,16994,67110
201711,2017,경원선,보산,43161,14742,57903
201711,2017,경원선,한남,103138,35607,138745
201711,2017,경원선,청량리(서울시립대입구),326636,138238,464874
201711,2017,경원선,창동,10,0,10
201711,2017,경원선,지행,187268,44854,232122
201711,2017,경원선,회룡,258258,138821,397079
201711,2017,경부선,화서,222903,42432,265335
201711,2017,경부선,명학,290292,43919,334211
201711,2017,경부선,지제,53720,6880,60600
201711,2017,경부선,직산,23422,7277,30699
201711,2017,경부선,진위,48099,10301,58400
201711,2017,경부선,천안,211180,59592,270772
201711,2017,경부선,평택,391112,66941,458053
201711,2017,경부선,병점,461351,58421,519772
201711,2017,경부선,서동탄,42192,9021,51213
201711,2017,경부선,서울역,166737,12376,179113
201711,2017,경부선,서정리,151113,26192,177305
201711,2017,경부선,석수,324017,48681,372698
201711,2017,경부선,두정,184551,22470,207021
201711,2017,경부선,독산,454483,66413,520896
201711,2017,경부선,대방,413852,75000,488852
201711,2017,경부선,당정,212095,29961,242056
201711,2017,경부선,노량진,422180,53482,475662
201711,2017,경부선,남영,328811,40324,369135
201711,2017,경부선,금천구청,287341,77397,364738
201711,2017,경부선,금정,756273,107164,863437
201711,2017,경부선,군포,204589,36338,240927
201711,2017,경부선,구로,571981,98305,670286
201711,2017,경부선,광명,56316,4478,60794
201711,2017,경부선,관악,216687,54048,270735
201711,2017,경부선,가산디지털단지,448598,31216,479814
201711,2017,경부선,의왕,245439,40299,285738
201711,2017,경부선,용산,1130609,137838,1268447
201711,2017,경부선,오산대,90555,15915,106470
201711,2017,경부선,오산,297274,43574,340848
201711,2017,경부선,영등포,1219722,275645,1495367
201711,2017,경부선,안양,775017,114919,889936
201711,2017,경부선,신도림,101465,22324,123789
201711,2017,경부선,신길,274314,49043,323357
201711,2017,경부선,수원,1283353,145301,1428654
201711,2017,경부선,송탄,135534,24803,160337
201711,2017,경부선,세마,69889,15635,85524
201711,2017,경부선,세류,111005,18735,129740
201711,2017,경부선,성환,153065,21494,174559
201711,2017,경부선,성균관대,468431,53191,521622
201711,2017,경강선,이매,39702,9013,48715
201711,2017,경강선,부발,48998,6012,55010
201711,2017,경강선,삼동,44758,7635,52393
201711,2017,경강선,판교,87080,10775,97855
201711,2017,경강선,신둔도예촌,34890,5414,40304
201711,2017,경강선,세종대왕릉,5423,2754,8177
201711,2017,경강선,이천,63656,11715,75371
201711,2017,경강선,초월,60722,9759,70481
201711,2017,경강선,경기광주,161800,22268,184068
201711,2017,경강선,곤지암,62769,13822,76591
201711,2017,경강선,여주,55091,14334,69425
201711,2017,9호선2단계,봉은사,392721,37273,429994
201711,2017,9호선2단계,선정릉,192989,21202,214191
201711,2017,9호선2단계,삼성중앙,130326,19987,150313
201711,2017,9호선2단계,언주,234106,25137,259243
201711,2017,9호선2단계,종합운동장,180685,16309,196994
201711,2017,9호선,염창,441422,61389,502811
201711,2017,9호선,여의도,568441,44569,613010
201711,2017,9호선,양천향교,214325,38891,253216
201711,2017,9호선,신논현,843654,53015,896669
201711,2017,9호선,선유도,184334,26065,210399
201711,2017,9호선,샛강,133243,26570,159813
201711,2017,9호선,사평,70452,14342,84794
201711,2017,9호선,신목동,108919,18793,127712
201711,2017,9호선,신반포,87702,25333,113035
201711,2017,9호선,신방화,210441,44843,255284
201711,2017,9호선,흑석(중앙대입구),275071,52061,327132
201711,2017,9호선,개화,177508,35952,213460
201711,2017,9호선,마곡나루,185128,13714,198842
201711,2017,9호선,등촌,245723,80484,326207
201711,2017,9호선,동작(현충원),46989,14809,61798
201711,2017,9호선,당산,490378,62991,553369
201711,2017,9호선,노량진,792239,89408,881647
201711,2017,9호선,노들,115645,30338,145983
201711,2017,9호선,김포공항,271893,20138,292031
201711,2017,9호선,국회의사당,466526,59819,526345
201711,2017,9호선,구반포,79663,25574,105237
201711,2017,9호선,공항시장,67801,22283,90084
201711,2017,9호선,고속터미널,352754,49859,402613
201711,2017,9호선,증미,176525,40296,216821
201711,2017,9호선,가양,530929,123682,654611
201711,2017,8호선,강동구청,273939,63710,337649
201711,2017,8호선,장지,489580,69551,559131
201711,2017,8호선,잠실(송파구청),360177,64175,424352
201711,2017,8호선,암사,481763,92924,574687
201711,2017,8호선,신흥,100205,41364,141569
201711,2017,8호선,문정,409344,48439,457783
201711,2017,8호선,수진,116862,43945,160807
201711,2017,8호선,송파,138128,35979,174107
201711,2017,8호선,석촌,212006,58976,270982
201711,2017,8호선,산성,146638,35447,182085
201711,2017,8호선,복정,325487,47909,373396
201711,2017,8호선,몽촌토성(평화의문),172521,44456,216977
201711,2017,8호선,모란,93724,51395,145119
201711,2017,8호선,단대오거리,293714,67157,360871
201711,2017,8호선,남한산성입구(성남법원.검찰청),393528,74936,468464
201711,2017,8호선,천호(풍납토성),487352,93158,580510
201711,2017,8호선,가락시장,169669,55539,225208
201711,2017,7호선,강남구청,412247,49183,461430
201711,2017,7호선,하계,527582,106532,634114
201711,2017,7호선,태릉입구,254110,40073,294183
201711,2017,7호선,춘의,245148,28432,273580
201711,2017,7호선,청담,556169,76907,633076
201711,2017,7호선,철산,649640,98408,748048
201711,2017,7호선,천왕,224082,46452,270534
201711,2017,7호선,중화,288039,60121,348160
201711,2017,7호선,중곡,264911,61242,326153
201711,2017,7호선,중계,402599,94788,497387
201711,2017,7호선,장암,67736,7197,74933
201711,2017,7호선,장승배기,267095,78384,345479
201711,2017,7호선,이수,441539,78658,520197
201711,2017,7호선,용마산,163819,35840,199659
201711,2017,7호선,온수(성공회대입구),301267,34667,335934
201711,2017,7호선,어린이대공원(세종대),477401,45215,522616
201711,2017,7호선,신풍,296558,70145,366703
201711,2017,7호선,신중동,391187,47979,439166
201711,2017,7호선,반포,171210,33115,204325
201711,2017,7호선,신대방삼거리,418851,93883,512734
201711,2017,7호선,숭실대입구(살피재),453677,60276,513953
201711,2017,7호선,수락산,344419,87067,431486
201711,2017,7호선,상봉(시외버스터미널),464744,73216,537960
201711,2017,7호선,상동,399083,49161,448244
201711,2017,7호선,상도,309226,59608,368834
201711,2017,7호선,삼산체육관,141018,24397,165415
201711,2017,7호선,사가정,401401,91457,492858
201711,2017,7호선,부평구청,338634,29979,368613
201711,2017,7호선,부천종합운동장,142164,17391,159555
201711,2017,7호선,부천시청,344808,47375,392183
201711,2017,7호선,보라매,244078,42368,286446
201711,2017,7호선,면목,428328,85211,513539
201711,2017,7호선,먹골,273649,59897,333546
201711,2017,7호선,마들,297589,75945,373534
201711,2017,7호선,뚝섬유원지,194542,38645,233187
201711,2017,7호선,도봉산,253513,39079,292592
201711,2017,1호선,서울역,1454647,215758,1670405
201711,2017,1호선,동묘앞,179052,138707,317759
201711,2017,1호선,동대문,351125,138837,489962
201711,2017,6호선,한강진,219324,15867,235191
201711,2017,6호선,태릉입구,142809,26956,169765
201711,2017,6호선,청구,99241,19187,118428
201711,2017,6호선,창신,97435,18155,115590
201711,2017,6호선,증산(명지대앞),262487,70641,333128
201711,2017,6호선,효창공원앞,190879,42244,233123
201711,2017,6호선,화랑대(서울여대입구),381878,46468,428346
201711,2017,6호선,이태원,467030,35981,503011
201711,2017,6호선,응암,443635,112404,556039
201711,2017,6호선,월드컵경기장(성산),160773,61566,222339
201711,2017,6호선,월곡(동덕여대),348326,76324,424650
201711,2017,6호선,연신내,26,1,27
201711,2017,6호선,역촌,84664,34258,118922
201711,2017,6호선,약수,93521,23899,117420
201711,2017,6호선,안암(고대병원앞),435148,33915,469063
201711,2017,6호선,신당,231887,40867,272754
201711,2017,6호선,석계,345920,74527,420447
201711,2017,6호선,새절(신사),356571,86498,443069
201711,2017,6호선,상월곡(한국과학기술연구원),164637,40433,205070
201711,2017,6호선,상수,320367,23593,343960
201711,2017,6호선,삼각지,215305,19592,234897
201711,2017,6호선,불광,130669,40685,171354
201711,2017,6호선,봉화산(서울의료원),245517,53520,299037
201711,2017,6호선,보문,212594,34961,247555
201711,2017,6호선,버티고개,64680,14980,79660
201711,2017,6호선,망원,338867,84479,423346
201711,2017,6호선,마포구청,349077,83144,432221
201711,2017,6호선,디지털미디어시티,382762,57764,440526
201711,2017,6호선,동묘앞,221429,67051,288480
201711,2017,6호선,돌곶이,228849,61608,290457
201711,2017,6호선,독바위,69643,20665,90308
201711,2017,6호선,대흥(서강대앞),231014,46227,277241
201711,2017,6호선,녹사평(용산구청),191263,21360,212623
201711,2017,6호선,구산,200802,56094,256896
201711,2017,6호선,광흥창(서강),240669,61622,302291
201711,2017,6호선,합정,431055,41716,472771
201711,2017,6호선,고려대(종암),280455,35523,315978
201711,2017,5호선,화곡,781474,141190,922664
201711,2017,5호선,행당,216595,48905,265500
201711,2017,5호선,충정로(경기대입구),126481,17812,144293
201711,2017,5호선,청구,102998,26891,129889
201711,2017,5호선,천호(풍납토성),493529,147088,640617
201711,2017,5호선,종로3가,336693,121917,458610
201711,2017,5호선,장한평,480886,95823,576709
201711,2017,5호선,을지로4가,113695,42225,155920
201711,2017,5호선,우장산,405508,81814,487322
201711,2017,5호선,왕십리(성동구청),133753,26082,159835
201711,2017,5호선,올림픽공원(한국체대),152480,37078,189558
201711,2017,5호선,오목교(목동운동장앞),694425,86306,780731
201711,2017,5호선,오금,96333,17517,113850
201711,2017,5호선,영등포시장,203886,74658,278544
201711,2017,5호선,영등포구청,90299,20511,110810
201711,2017,5호선,여의도,671560,55545,727105
201711,2017,5호선,여의나루,217728,27779,245507
201711,2017,5호선,양평,165523,28069,193592
201711,2017,5호선,애오개,190154,41854,232008
201711,2017,5호선,아차산(어린이대공원후문),379587,92999,472586
201711,2017,5호선,신정(은행정),394543,60292,454835
201711,2017,5호선,발산,407715,69089,476804
201711,2017,5호선,신길,87938,13321,101259
201711,2017,5호선,신금호,150375,36724,187099
201711,2017,5호선,송정,226487,60766,287253
201711,2017,5호선,서대문,492079,70721,562800
201711,2017,5호선,상일동,310994,63020,374014
201711,2017,5호선,방화,186707,48296,235003
201711,2017,5호선,방이,180910,43839,224749
201711,2017,5호선,목동,490642,85442,576084
201711,2017,5호선,명일,196976,62965,259941
201711,2017,5호선,마포,370859,66245,437104
201711,2017,5호선,마천,111008,46524,157532
201711,2017,5호선,마장,155445,43675,199120
201711,2017,5호선,마곡,212568,26523,239091
201711,2017,5호선,둔촌동,268587,70502,339089
201711,2017,5호선,동대문역사문화공원,77491,9950,87441
201711,2017,5호선,답십리,430124,85011,515135
201711,2017,5호선,까치산,778888,153802,932690
201711,2017,5호선,김포공항,213950,28071,242021
201711,2017,5호선,길동,175820,58997,234817
201711,2017,5호선,굽은다리(강동구민회관앞),241551,63443,304994
201711,2017,5호선,군자(능동),306894,38544,345438
201711,2017,5호선,광화문(세종문화회관),1075116,88909,1164025
201711,2017,5호선,광나루(장신대),395582,66946,462528
201711,2017,5호선,공덕,377887,46918,424805
201711,2017,5호선,고덕,242326,65209,307535
201711,2017,5호선,거여,162670,50804,213474
201711,2017,5호선,개화산,149070,35154,184224
201711,2017,5호선,개롱,169680,45147,214827
201711,2017,5호선,강동,524040,100969,625009
201711,2017,4호선,남태령,94499,10277,104776
201711,2017,4호선,한성대입구(삼선교),462096,81697,543793
201711,2017,4호선,충무로,915181,132936,1048117
201711,2017,4호선,총신대입구(이수),536526,144863,681389
201711,2017,4호선,창동,725853,190914,916767
201711,2017,4호선,회현(남대문시장),729865,204924,934789
201711,2017,4호선,이촌(국립중앙박물관),249709,48048,297757
201711,2017,3호선,불광,459511,150422,609933
201711,2017,3호선,수서,453737,102604,556341
201711,2017,3호선,안국,705601,133621,839222
201711,2017,3호선,압구정,884548,154057,1038605
201711,2017,3호선,약수,358079,86615,444694
201711,2017,3호선,양재(서초구청),1115353,169752,1285105
201711,2017,3호선,연신내,1057365,268607,1325972
201711,2017,3호선,오금,189857,28667,218524
201711,2017,3호선,옥수,253412,60311,313723
201711,2017,3호선,을지로3가,251430,60910,312340
201711,2017,3호선,일원,226717,59320,286037
201711,2017,3호선,잠원,160302,37445,197747
201711,2017,3호선,신사,866146,76117,942263
201711,2017,3호선,종로3가,229484,54631,284115
201711,2017,3호선,지축,28720,10301,39021
201711,2017,3호선,충무로,58,2,60
201711,2017,3호선,학여울,69752,16601,86353
201711,2017,3호선,경복궁(정부서울청사),713594,94382,807976
201711,2017,4호선,길음,656325,129593,785918
201711,2017,4호선,혜화,1245198,142395,1387593
201711,2017,4호선,노원,611557,94657,706214
201711,2017,4호선,당고개,312986,90855,403841
201711,2017,4호선,동대문,640701,159130,799831
201711,2017,4호선,동대문역사문화공원,663746,65538,729284
201711,2017,4호선,동작(현충원),54852,20238,75090
201711,2017,4호선,명동,1177454,78201,1255655
201711,2017,4호선,사당,825336,94156,919492
201711,2017,4호선,삼각지,130220,30354,160574
201711,2017,4호선,상계,557871,117967,675838
201711,2017,4호선,서울역,359176,41614,400790
201711,2017,4호선,성신여대입구(돈암),694059,96976,791035
201711,2017,4호선,수유(강북구청),1021206,218361,1239567
201711,2017,4호선,숙대입구(갈월),497986,60552,558538
201711,2017,4호선,미아(서울사이버대학),443778,121386,565164
201711,2017,4호선,미아사거리,775544,182429,957973
201711,2017,4호선,신용산,385037,49876,434913
201711,2017,4호선,쌍문,875833,169056,1044889
201710,2017,경의선,풍산,112694,30290,142984
201710,2017,경의선,홍대입구,50893,4877,55770
201710,2017,경의선,화전,69594,9885,79479
201710,2017,경의선,효창공원앞,56200,11772,67972
201710,2017,경의선,서강대,55663,9545,65208
201710,2017,경의선,서울역,75949,12303,88252
201710,2017,경의선,수색,48863,18059,66922
201710,2017,경의선,신촌,20093,3423,23516
201710,2017,경의선,야당,92444,23826,116270
201710,2017,경의선,운정,122355,32461,154816
201710,2017,경의선,월롱,68189,9519,77708
201710,2017,경의선,가좌,100608,44725,145333
201710,2017,경의선,강매,61908,17540,79448
201710,2017,경의선,곡산,11911,5254,17165
201710,2017,경의선,공덕,66902,10773,77675
201710,2017,경의선,금릉,121179,25012,146191
201710,2017,경의선,금촌,180880,45677,226557
201710,2017,경의선,능곡,83970,30485,114455
201710,2017,경의선,디지털미디어시티,57095,11035,68130
201710,2017,경의선,문산,152072,55460,207532
201710,2017,경의선,탄현,183974,38149,222123
201710,2017,경인선,인천,121447,51694,173141
201710,2017,경인선,제물포,275484,60615,336099
201710,2017,경인선,주안,645132,100707,745839
201710,2017,경인선,중동,229249,65322,294571
201710,2017,경인선,백운,205882,67988,273870
201710,2017,경인선,부개,230984,64393,295377
201710,2017,경인선,부천,1036691,208196,1244887
201710,2017,경인선,부평,1006834,142334,1149168
201710,2017,경인선,소사,314028,85033,399061
201710,2017,경인선,송내,829240,115253,944493
201710,2017,경인선,역곡,770765,146485,917250
201710,2017,경인선,오류동,259437,90688,350125
201710,2017,경인선,온수(성공회대입구),171673,45667,217340
201710,2017,경인선,간석,151388,44957,196345
201710,2017,경인선,개봉,560976,156344,717320
201710,2017,경인선,구일,174022,35391,209413
201710,2017,경인선,도원,82642,35862,118504
201710,2017,경인선,도화,82165,36751,118916
201710,2017,경인선,동암,477534,106471,584005
201710,2017,경인선,동인천,414718,129225,543943
201710,2017,경춘선,평내호평,142292,42406,184698
201710,2017,경춘선,천마산,31476,16311,47787
201710,2017,경춘선,춘천,68195,29390,97585
201710,2017,경춘선,굴봉산,6905,2868,9773
201710,2017,경춘선,청평,57770,17904,75674
201710,2017,경춘선,강촌,23679,6963,30642
201710,2017,경춘선,갈매,50345,15693,66038
201710,2017,경춘선,가평,86720,19232,105952
201710,2017,경춘선,마석,88336,33871,122207
201710,2017,경춘선,남춘천,78489,26655,105144
201710,2017,경춘선,백양리,3161,1464,4625
201710,2017,경춘선,김유정,18569,5576,24145
201710,2017,경춘선,별내,59518,19149,78667
201710,2017,경춘선,사릉,92768,20330,113098
201710,2017,경춘선,상천,11065,8262,19327
201710,2017,경춘선,대성리,18022,6555,24577
201710,2017,경춘선,금곡,32159,16398,48557
201710,2017,경춘선,신내,15774,7115,22889
201710,2017,경춘선,퇴계원,82308,24776,107084
201710,2017,공항철도 1호선,공항화물청사,63288,7371,70659
201710,2017,공항철도 1호선,공덕,44288,6121,50409
201710,2017,공항철도 1호선,계양,287120,31501,318621
201710,2017,공항철도 1호선,검암,233863,24850,258713
201710,2017,공항철도 1호선,운서,141756,24010,165766
201710,2017,공항철도 1호선,영종,43765,12614,56379
201710,2017,공항철도 1호선,서울역,312667,28446,341113
201710,2017,공항철도 1호선,홍대입구,267207,16450,283657
201710,2017,공항철도 1호선,청라국제도시,142286,9203,151489
201710,2017,공항철도 1호선,인천국제공항,496911,47252,544163
201710,2017,공항철도 1호선,디지털미디어시티,285507,20758,306265
201710,2017,공항철도 1호선,김포공항,289482,18659,308141
201710,2017,과천선,범계,747663,104768,852431
201710,2017,과천선,인덕원,632300,99547,731847
201710,2017,과천선,평촌,403004,61646,464650
201710,2017,과천선,대공원,212017,58581,270598
201710,2017,과천선,정부과천청사,277273,60830,338103
201710,2017,과천선,선바위,216004,32814,248818
201710,2017,과천선,경마공원,135282,52592,187874
201710,2017,과천선,과천,103736,31690,135426
201710,2017,분당선,가천대,254318,23933,278251
201710,2017,분당선,한티,336207,63373,399580
201710,2017,분당선,구룡,44507,18069,62576
201710,2017,분당선,구성,105504,37565,143069
201710,2017,분당선,기흥,206434,31743,238177
201710,2017,분당선,대모산입구,62364,26913,89277
201710,2017,분당선,도곡,143195,38168,181363
201710,2017,분당선,망포,332197,29473,361670
201710,2017,분당선,매교,65745,17862,83607
201710,2017,분당선,매탄권선,111832,14588,126420
201710,2017,분당선,모란,524305,155017,679322
201710,2017,분당선,미금,422746,116096,538842
201710,2017,분당선,보정,53939,23888,77827
201710,2017,분당선,복정,1,0,1
201710,2017,분당선,상갈,124410,31312,155722
201710,2017,분당선,서울숲,204671,24392,229063
201710,2017,분당선,서현,633449,122935,756384
201710,2017,분당선,선릉,186561,23585,210146
201710,2017,분당선,선정릉,159110,31924,191034
201710,2017,분당선,수내,305529,77681,383210
201710,2017,분당선,수서,333322,58932,392254
201710,2017,분당선,수원,264671,27762,292433
201710,2017,분당선,수원시청,285010,33733,318743
201710,2017,분당선,신갈,98404,29545,127949
201710,2017,분당선,압구정로데오,357305,35947,393252
201710,2017,분당선,야탑,646782,154229,801011
201710,2017,분당선,영통,235033,26522,261555
201710,2017,분당선,오리,311285,87815,399100
201710,2017,분당선,이매,133649,39203,172852
201710,2017,분당선,정자,379912,75779,455691
201710,2017,분당선,죽전,394409,79691,474100
201710,2017,분당선,청명,102947,16756,119703
201710,2017,분당선,태평,337858,87011,424869
201710,2017,분당선,강남구청,183725,36365,220090
201710,2017,수인선,남동인더스파크,51289,6141,57430
201710,2017,수인선,달월,1886,2657,4543
201710,2017,수인선,소래포구,128229,85109,213338
201710,2017,수인선,송도,68803,21432,90235
201710,2017,수인선,숭의,71629,24918,96547
201710,2017,수인선,신포,45256,12269,57525
201710,2017,수인선,호구포,86328,16254,102582
201710,2017,수인선,원인재,116241,27523,143764
201710,2017,수인선,월곶,70352,13923,84275
201710,2017,수인선,인천,30224,10972,41196
201710,2017,수인선,인천논현,152123,31644,183767
201710,2017,수인선,인하대,149186,22059,171245
201710,2017,수인선,연수,126986,26190,153176
201710,2017,안산선,고잔,237782,37751,275533
201710,2017,안산선,대야미,99158,27778,126936
201710,2017,안산선,반월,116238,31012,147250
201710,2017,안산선,산본,426759,99451,526210
201710,2017,안산선,상록수,546435,85288,631723
201710,2017,안산선,수리산,99740,33756,133496
201710,2017,안산선,한대앞,238635,40518,279153
201710,2017,안산선,안산,505949,43714,549663
201710,2017,안산선,오이도,255018,41219,296237
201710,2017,안산선,정왕,260787,25622,286409
201710,2017,안산선,중앙,470886,55281,526167
201710,2017,안산선,초지,117539,15935,133474
201710,2017,안산선,신길온천,45959,10948,56907
201710,2017,우이신설선,4.19민주묘지,59273,27495,86768
201710,2017,우이신설선,가오리,64993,34157,99150
201710,2017,우이신설선,보문,25585,12083,37668
201710,2017,우이신설선,북한산보국문,112183,34913,147096
201710,2017,우이신설선,북한산우이,69075,42600,111675
201710,2017,우이신설선,삼양,32286,20734,53020
201710,2017,우이신설선,화계,48605,29981,78586
201710,2017,우이신설선,성신여대입구(돈암),79571,27823,107394
201710,2017,우이신설선,솔밭공원,40618,23055,63673
201710,2017,우이신설선,솔샘,103320,27674,130994
201710,2017,우이신설선,신설동,28716,13383,42099
201710,2017,우이신설선,정릉,70225,35689,105914
201710,2017,우이신설선,삼양사거리,32764,25361,58125
201710,2017,일산선,대곡,38982,11945,50927
201710,2017,일산선,화정,448764,126670,575434
201710,2017,분당선,개포동,73760,21051,94811
201710,2017,중앙선,국수,19742,11507,31249
201710,2017,중앙선,팔당,32046,9352,41398
201710,2017,중앙선,지평,1200,661,1861
201710,2017,중앙선,중랑,124774,51443,176217
201710,2017,중앙선,원덕,8692,6797,15489
201710,2017,중앙선,운길산,29943,11124,41067
201710,2017,중앙선,용문,62050,58193,120243
201710,2017,중앙선,오빈,7009,5231,12240
201710,2017,중앙선,양평,87788,37637,125425
201710,2017,중앙선,양정,17804,9507,27311
201710,2017,중앙선,양원,36577,16205,52782
201710,2017,중앙선,양수,51895,21921,73816
201710,2017,중앙선,아신,20074,8200,28274
201710,2017,중앙선,신원,5840,3922,9762
201710,2017,중앙선,상봉(시외버스터미널),143604,39577,183181
201710,2017,중앙선,망우,183230,69123,252353
201710,2017,중앙선,도심,62665,21588,84253
201710,2017,중앙선,도농,209745,57531,267276
201710,2017,중앙선,덕소,146554,50736,197290
201710,2017,중앙선,회기,723612,129767,853379
201710,2017,중앙선,구리,328461,84018,412479
201710,2017,장항선,배방,25539,7613,33152
201710,2017,장항선,아산,89021,10315,99336
201710,2017,장항선,봉명,26185,12891,39076
201710,2017,장항선,온양온천,102027,67434,169461
201710,2017,장항선,신창(순천향대),61727,9517,71244
201710,2017,장항선,쌍용(나사렛대),67308,18056,85364
201710,2017,일산선,백석,265938,76833,342771
201710,2017,일산선,대화,345513,88085,433598
201710,2017,일산선,마두,164105,72287,236392
201710,2017,일산선,삼송,426882,87346,514228
201710,2017,일산선,원당,270207,86262,356469
201710,2017,일산선,원흥,184617,40965,225582
201710,2017,일산선,정발산,218282,65610,283892
201710,2017,일산선,주엽,191126,92612,283738
201710,2017,3호선,독립문,178610,72788,251398
201710,2017,3호선,동대입구,307416,40315,347731
201710,2017,3호선,매봉,236449,50577,287026
201710,2017,3호선,무악재,87590,32258,119848
201710,2017,3호선,불광,421865,147020,568885
201710,2017,3호선,수서,398878,93893,492771
201710,2017,3호선,신사,757261,66955,824216
201710,2017,3호선,안국,673244,118594,791838
201710,2017,3호선,압구정,777430,141546,918976
201710,2017,3호선,약수,315126,81159,396285
201710,2017,3호선,양재(서초구청),897430,151469,1048899
201710,2017,3호선,연신내,972288,261749,1234037
201710,2017,3호선,오금,164052,26357,190409
201710,2017,3호선,옥수,228429,58711,287140
201710,2017,3호선,을지로3가,203126,52864,255990
201710,2017,3호선,일원,187664,52781,240445
201710,2017,3호선,잠원,138147,33981,172128
201710,2017,3호선,종로3가,187224,49632,236856
201710,2017,3호선,지축,26718,10815,37533
201710,2017,3호선,충무로,38,1,39
201710,2017,3호선,학여울,48804,13569,62373
201710,2017,3호선,경복궁(정부서울청사),698946,98092,797038
201710,2017,4호선,길음,580498,125557,706055
201710,2017,4호선,회현(남대문시장),643742,193151,836893
201710,2017,4호선,노원,565997,90900,656897
201710,2017,4호선,당고개,295223,91333,386556
201710,2017,4호선,동대문,572688,140314,713002
201710,2017,4호선,동대문역사문화공원,618923,60110,679033
201710,2017,4호선,동작(현충원),59422,21938,81360
201710,2017,4호선,명동,1118512,74085,1192597
201710,2017,4호선,미아(서울사이버대학),394655,117718,512373
201710,2017,4호선,미아사거리,704653,176759,881412
201710,2017,4호선,사당,742831,88928,831759
201710,2017,4호선,삼각지,109247,30860,140107
201710,2017,4호선,상계,504875,113972,618847
201710,2017,4호선,서울역,311949,39120,351069
201710,2017,4호선,성신여대입구(돈암),617570,92024,709594
201710,2017,4호선,수유(강북구청),938087,212220,1150307
201710,2017,4호선,숙대입구(갈월),419418,54575,473993
201710,2017,4호선,신용산,333413,46444,379857
201710,2017,4호선,쌍문,790598,162737,953335
201710,2017,4호선,이촌(국립중앙박물관),222622,45418,268040
201710,2017,4호선,창동,663636,184018,847654
201710,2017,4호선,총신대입구(이수),478367,136439,614806
201710,2017,4호선,충무로,768319,122893,891212
201710,2017,4호선,한성대입구(삼선교),415878,78861,494739
201710,2017,4호선,혜화,1082648,125944,1208592
201710,2017,4호선,남태령,72586,9383,81969
201710,2017,5호선,강동,457424,94040,551464
201710,2017,5호선,화곡,698035,135117,833152
201710,2017,5호선,개화산,131619,34189,165808
201710,2017,5호선,거여,144349,47762,192111
201710,2017,5호선,고덕,211881,59493,271374
201710,2017,5호선,공덕,311432,42260,353692
201710,2017,5호선,광나루(장신대),351981,65639,417620
201710,2017,5호선,광화문(세종문화회관),938804,86847,1025651
201710,2017,5호선,군자(능동),273381,36988,310369
201710,2017,5호선,굽은다리(강동구민회관앞),215486,60199,275685
201710,2017,5호선,길동,156110,55373,211483
201710,2017,5호선,김포공항,205096,27771,232867
201710,2017,5호선,까치산,701652,149247,850899
201710,2017,5호선,답십리,374989,80167,455156
201710,2017,5호선,동대문역사문화공원,62397,8656,71053
201710,2017,5호선,둔촌동,242625,68535,311160
201710,2017,5호선,마곡,178772,24652,203424
201710,2017,5호선,마장,135977,40040,176017
201710,2017,5호선,마천,102501,46074,148575
201710,2017,5호선,마포,305388,60880,366268
201710,2017,5호선,명일,174606,59068,233674
201710,2017,5호선,목동,434765,80978,515743
201710,2017,5호선,발산,346783,64341,411124
201710,2017,5호선,방이,158638,39685,198323
201710,2017,5호선,방화,168260,47567,215827
201710,2017,5호선,상일동,270855,60331,331186
201710,2017,5호선,서대문,403149,65070,468219
201710,2017,5호선,송정,205685,60769,266454
201710,2017,5호선,신금호,133274,34265,167539
201710,2017,5호선,신길,75134,12800,87934
201710,2017,5호선,신정(은행정),348562,56597,405159
201710,2017,5호선,아차산(어린이대공원후문),361255,93633,454888
201710,2017,5호선,애오개,160348,38387,198735
201710,2017,5호선,양평,138483,25947,164430
201710,2017,5호선,여의나루,338450,31174,369624
201710,2017,5호선,여의도,528424,47857,576281
201710,2017,5호선,영등포구청,77625,18655,96280
201710,2017,5호선,영등포시장,178965,72412,251377
201710,2017,5호선,오금,83388,16258,99646
201710,2017,5호선,오목교(목동운동장앞),609588,79523,689111
201710,2017,5호선,올림픽공원(한국체대),170052,36358,206410
201710,2017,5호선,왕십리(성동구청),119549,24367,143916
201710,2017,5호선,우장산,360618,76425,437043
201710,2017,5호선,을지로4가,94989,37711,132700
201710,2017,5호선,장한평,422326,91538,513864
201710,2017,5호선,종로3가,308664,118670,427334
201710,2017,5호선,천호(풍납토성),449922,137038,586960
201710,2017,5호선,청구,89696,24682,114378
201710,2017,5호선,충정로(경기대입구),103365,16911,120276
201710,2017,5호선,행당,191942,46525,238467
201710,2017,5호선,개롱,149903,40414,190317
201710,2017,6호선,고려대(종암),246377,33683,280060
201710,2017,6호선,공덕,420075,69188,489263
201710,2017,6호선,광흥창(서강),209460,54306,263766
201710,2017,6호선,구산,181762,54638,236400
201710,2017,6호선,녹사평(용산구청),217322,21210,238532
201710,2017,6호선,대흥(서강대앞),194108,41757,235865
201710,2017,6호선,독바위,64812,20537,85349
201710,2017,6호선,돌곶이,208861,59014,267875
201710,2017,6호선,동묘앞,205724,66992,272716
201710,2017,6호선,디지털미디어시티,332489,56189,388678
201710,2017,6호선,마포구청,316490,82625,399115
201710,2017,6호선,망원,309708,80480,390188
201710,2017,6호선,버티고개,56296,14115,70411
201710,2017,6호선,보문,188972,34008,222980
201710,2017,6호선,봉화산(서울의료원),216297,50487,266784
201710,2017,6호선,불광,121859,39116,160975
201710,2017,6호선,삼각지,196123,20359,216482
201710,2017,6호선,상수,288384,21968,310352
201710,2017,6호선,상월곡(한국과학기술연구원),143201,37603,180804
201710,2017,6호선,새절(신사),317409,85974,403383
201710,2017,6호선,석계,306529,71523,378052
201710,2017,6호선,신당,209984,37425,247409
201710,2017,6호선,안암(고대병원앞),357559,29960,387519
201710,2017,6호선,약수,81371,21876,103247
201710,2017,6호선,역촌,75820,33656,109476
201710,2017,6호선,연신내,13,1,14
201710,2017,6호선,월곡(동덕여대),301076,72771,373847
201710,2017,6호선,월드컵경기장(성산),299852,127971,427823
201710,2017,6호선,응암,404952,110305,515257
201710,2017,6호선,이태원,580419,36941,617360
201710,2017,6호선,증산(명지대앞),236195,69656,305851
201710,2017,6호선,창신,85504,16743,102247
201710,2017,1호선,동대문,350143,134384,484527
201710,2017,1호선,동묘앞,182618,152946,335564
201710,2017,1호선,서울역,1369481,210117,1579598
201710,2017,1호선,시청,613320,105529,718849
201710,2017,1호선,청량리(서울시립대입구),487736,326341,814077
201710,2017,1호선,제기동,270014,307409,577423
201710,2017,1호선,종각,1074643,148607,1223250
201710,2017,1호선,종로3가,653518,369532,1023050
201710,2017,1호선,종로5가,486810,256719,743529
201710,2017,1호선,신설동,334833,119500,454333
201710,2017,2호선,강남,2458591,148027,2606618
201710,2017,2호선,홍대입구,2174343,109200,2283543
201710,2017,2호선,건대입구,1187698,92297,1279995
201710,2017,2호선,교대(법원.검찰청),800024,144014,944038
201710,2017,2호선,구로디지털단지,1559931,158450,1718381
201710,2017,2호선,구의(광진구청),549919,98392,648311
201710,2017,2호선,낙성대,733742,106008,839750
201710,2017,2호선,당산,521767,65486,587253
201710,2017,2호선,대림(구로구청),767474,110595,878069
201710,2017,2호선,도림천,21934,5730,27664
201710,2017,2호선,동대문역사문화공원,486327,55863,542190
201710,2017,2호선,뚝섬,399852,61219,461071
201710,2017,2호선,문래,434392,76044,510436
201710,2017,2호선,방배,493660,75235,568895
201710,2017,2호선,봉천,515842,139105,654947
201710,2017,2호선,사당,961353,184317,1145670
201710,2017,2호선,삼성(무역센터),1333471,109615,1443086
201710,2017,2호선,상왕십리,310417,62778,373195
201710,2017,2호선,서울대입구(관악구청),1265634,195354,1460988
201710,2017,2호선,서초,528158,77182,605340
201710,2017,2호선,선릉,1184701,177072,1361773
201710,2017,2호선,성수,607008,91717,698725
201710,2017,2호선,시청,590348,57661,648009
201710,2017,2호선,신답,29010,10428,39438
201710,2017,2호선,신당,330643,100539,431182
201710,2017,2호선,신대방,696319,130463,826782
201710,2017,2호선,신도림,1514672,193840,1708512
201710,2017,2호선,신림,1743848,229193,1973041
201710,2017,2호선,신설동,83490,34403,117893
201710,2017,2호선,신정네거리,213860,62721,276581
201710,2017,2호선,신촌,1210589,130653,1341242
201710,2017,2호선,아현,237822,62630,300452
201710,2017,2호선,양천구청,148650,43684,192334
201710,2017,2호선,역삼,992801,129698,1122499
201710,2017,2호선,영등포구청,480088,97108,577196
201710,2017,2호선,왕십리(성동구청),503666,56137,559803
201710,2017,2호선,용답,62821,16551,79372
201710,2017,2호선,용두(동대문구청),41143,22087,63230
201710,2017,2호선,을지로3가,458163,80869,539032
201710,2017,2호선,을지로4가,248770,83310,332080
201710,2017,2호선,을지로입구,1231739,105783,1337522
201710,2017,2호선,이대,512973,60553,573526
201710,2017,2호선,잠실(송파구청),2369214,220480,2589694
201710,2017,2호선,잠실나루,395611,83785,479396
201710,2017,2호선,잠실새내,613214,109582,722796
201710,2017,2호선,종합운동장,364843,56696,421539
201710,2017,2호선,충정로(경기대입구),258076,49385,307461
201710,2017,2호선,한양대,322909,15805,338714
201710,2017,2호선,합정,853260,72030,925290
201710,2017,2호선,강변(동서울터미널),1287217,149369,1436586
201710,2017,3호선,가락시장,211929,69252,281181
201710,2017,3호선,홍제,429213,145924,575137
201710,2017,3호선,경찰병원,166013,35969,201982
201710,2017,3호선,고속터미널,1587940,179880,1767820
201710,2017,3호선,교대(법원.검찰청),324980,63892,388872
201710,2017,3호선,구파발,483632,99439,583071
201710,2017,3호선,금호,192812,54326,247138
201710,2017,3호선,남부터미널(예술의전당),857663,122698,980361
201710,2017,3호선,녹번,302701,64198,366899
201710,2017,3호선,대청,225714,49697,275411
201710,2017,3호선,대치,295331,56572,351903
201710,2017,3호선,도곡,151636,26835,178471
201710,2017,6호선,청구,88610,17796,106406
201710,2017,6호선,태릉입구,126501,26380,152881
201710,2017,6호선,한강진,193586,14116,207702
201710,2017,6호선,합정,404660,41034,445694
201710,2017,6호선,화랑대(서울여대입구),333077,44867,377944
201710,2017,6호선,효창공원앞,169595,42555,212150
201710,2017,7호선,가산디지털단지,936197,69181,1005378
201710,2017,7호선,학동,490783,56684,547467
201710,2017,7호선,건대입구,406270,49218,455488
201710,2017,7호선,고속터미널,529792,76947,606739
201710,2017,7호선,공릉(서울과학기술대),304496,64344,368840
201710,2017,7호선,광명사거리,637407,144188,781595
201710,2017,7호선,군자(능동),329979,72970,402949
201710,2017,7호선,굴포천,226440,31676,258116
201710,2017,7호선,까치울,173559,26338,199897
201710,2017,7호선,남구로,392929,56140,449069
201710,2017,7호선,남성,264123,65388,329511
201710,2017,7호선,내방,324966,58587,383553
201710,2017,7호선,노원,476904,106431,583335
201710,2017,7호선,논현,455958,46580,502538
201710,2017,7호선,대림(구로구청),300038,34311,334349
201710,2017,7호선,도봉산,235497,44336,279833
201710,2017,7호선,뚝섬유원지,243514,44068,287582
201710,2017,7호선,마들,265695,72978,338673
201710,2017,7호선,먹골,247126,56842,303968
201710,2017,7호선,면목,386900,82195,469095
201710,2017,7호선,반포,149709,30100,179809
201710,2017,7호선,보라매,209214,39723,248937
201710,2017,7호선,부천시청,305592,45231,350823
201710,2017,7호선,부천종합운동장,133354,18273,151627
201710,2017,7호선,부평구청,297987,29024,327011
201710,2017,7호선,사가정,368791,89881,458672
201710,2017,7호선,삼산체육관,130725,24040,154765
201710,2017,7호선,상도,265008,55573,320581
201710,2017,7호선,상동,352723,44906,397629
201710,2017,7호선,상봉(시외버스터미널),416225,69368,485593
201710,2017,7호선,수락산,320908,87667,408575
201710,2017,7호선,숭실대입구(살피재),380968,55519,436487
201710,2017,7호선,신대방삼거리,366194,86482,452676
201710,2017,7호선,신중동,349222,46251,395473
201710,2017,7호선,신풍,269598,65281,334879
201710,2017,7호선,어린이대공원(세종대),442814,47242,490056
201710,2017,7호선,온수(성공회대입구),261648,32869,294517
201710,2017,7호선,용마산,148765,35043,183808
201710,2017,7호선,이수,388867,72570,461437
201710,2017,7호선,장승배기,237782,73120,310902
201710,2017,7호선,장암,61217,8129,69346
201710,2017,7호선,중계,355886,89534,445420
201710,2017,7호선,중곡,237079,58098,295177
201710,2017,7호선,중화,261237,56888,318125
201710,2017,7호선,천왕,201219,44361,245580
201710,2017,7호선,철산,583840,95355,679195
201710,2017,7호선,청담,468453,68254,536707
201710,2017,7호선,춘의,215284,26449,241733
201710,2017,7호선,태릉입구,224683,38777,263460
201710,2017,7호선,하계,470606,101076,571682
201710,2017,7호선,강남구청,342588,43886,386474
201710,2017,8호선,가락시장,147041,51166,198207
201710,2017,8호선,천호(풍납토성),434233,87216,521449
201710,2017,8호선,남한산성입구(성남법원.검찰청),352271,74291,426562
201710,2017,8호선,단대오거리,269406,63131,332537
201710,2017,8호선,모란,92536,50613,143149
201710,2017,8호선,몽촌토성(평화의문),170635,43810,214445
201710,2017,8호선,문정,325272,43266,368538
201710,2017,8호선,복정,277295,45254,322549
201710,2017,8호선,산성,142769,35214,177983
201710,2017,8호선,석촌,180539,53953,234492
201710,2017,8호선,송파,118625,32911,151536
201710,2017,8호선,수진,108040,41441,149481
201710,2017,8호선,신흥,94759,40367,135126
201710,2017,8호선,암사,430215,89076,519291
201710,2017,8호선,잠실(송파구청),328813,59947,388760
201710,2017,8호선,장지,424023,63397,487420
201710,2017,8호선,강동구청,232958,57783,290741
201710,2017,9호선,가양,467430,119009,586439
201710,2017,9호선,흑석(중앙대입구),236243,50010,286253
201710,2017,9호선,고속터미널,349082,47488,396570
201710,2017,9호선,공항시장,61767,21140,82907
201710,2017,9호선,구반포,66698,21421,88119
201710,2017,9호선,국회의사당,351640,48694,400334
201710,2017,9호선,김포공항,261221,19303,280524
201710,2017,9호선,노들,102758,29348,132106
201710,2017,9호선,노량진,729104,84570,813674
201710,2017,9호선,당산,426002,57095,483097
201710,2017,9호선,동작(현충원),47886,15695,63581
201710,2017,9호선,등촌,214378,76382,290760
201710,2017,9호선,마곡나루,155254,12063,167317
201710,2017,9호선,개화,159516,35662,195178
201710,2017,9호선,증미,150382,39490,189872
201710,2017,9호선,염창,393308,57899,451207
201710,2017,9호선,여의도,457294,38633,495927
201710,2017,9호선,양천향교,184978,36989,221967
201710,2017,9호선,사평,59059,13169,72228
201710,2017,9호선,샛강,110069,23655,133724
201710,2017,9호선,선유도,154630,24146,178776
201710,2017,9호선,신논현,725927,46767,772694
201710,2017,9호선,신목동,95504,17671,113175
201710,2017,9호선,신반포,77351,23464,100815
201710,2017,9호선,신방화,188798,42565,231363
201710,2017,9호선2단계,언주,188880,21703,210583
201710,2017,9호선2단계,종합운동장,158881,14470,173351
201710,2017,9호선2단계,삼성중앙,106559,16963,123522
201710,2017,9호선2단계,선정릉,159830,17534,177364
201710,2017,9호선2단계,봉은사,310081,34003,344084
201710,2017,경강선,초월,57500,9955,67455
201710,2017,경강선,판교,78352,10631,88983
201710,2017,경강선,부발,45509,6320,51829
201710,2017,경강선,삼동,37187,6859,44046
201710,2017,경강선,세종대왕릉,7263,4004,11267
201710,2017,경강선,곤지암,60607,15489,76096
201710,2017,경강선,여주,62440,20442,82882
201710,2017,경강선,이매,39126,9594,48720
201710,2017,경강선,이천,65776,13493,79269
201710,2017,경강선,경기광주,151457,22086,173543
201710,2017,경강선,신둔도예촌,31464,5747,37211
201710,2017,경부선,지제,48249,6272,54521
201710,2017,경부선,명학,248452,41510,289962
201710,2017,경부선,진위,43103,9869,52972
201710,2017,경부선,천안,210775,64081,274856
201710,2017,경부선,평택,395281,70154,465435
201710,2017,경부선,화서,206062,42344,248406
201710,2017,경부선,병점,420839,58827,479666
201710,2017,경부선,서동탄,39669,9155,48824
201710,2017,경부선,서울역,161659,11652,173311
201710,2017,경부선,서정리,142373,25768,168141
201710,2017,경부선,석수,291933,49061,340994
201710,2017,경부선,성균관대,408382,52363,460745
201710,2017,경부선,성환,139945,22398,162343
201710,2017,경부선,세류,107195,19429,126624
201710,2017,경부선,세마,64987,14232,79219
201710,2017,경부선,송탄,134273,24650,158923
201710,2017,경부선,수원,1290255,152404,1442659
201710,2017,경부선,신길,249653,47814,297467
201710,2017,경부선,신도림,95269,22494,117763
201710,2017,경부선,안양,728766,115591,844357
201710,2017,경부선,영등포,1162654,278081,1440735
201710,2017,경부선,오산,290589,43459,334048
201710,2017,경부선,오산대,85459,17407,102866
201710,2017,경부선,용산,1135469,141604,1277073
201710,2017,경부선,의왕,218677,40593,259270
201710,2017,경부선,가산디지털단지,382490,29048,411538
201710,2017,경부선,관악,201158,55335,256493
201710,2017,경부선,광명,53122,4509,57631
201710,2017,경부선,구로,519484,92788,612272
201710,2017,경부선,군포,182025,35603,217628
201710,2017,경부선,금정,694732,106264,800996
201710,2017,경부선,금천구청,262977,76474,339451
201710,2017,경부선,남영,277958,39065,317023
201710,2017,경부선,노량진,421949,54944,476893
201710,2017,경부선,당정,190535,28991,219526
201710,2017,경부선,대방,356482,71258,427740
201710,2017,경부선,독산,390921,63996,454917
201710,2017,경부선,두정,171179,22152,193331
201710,2017,경부선,직산,23508,7768,31276
201710,2017,경원선,지행,181183,45851,227034
201710,2017,경원선,방학,198300,104492,302792
201710,2017,경원선,청량리(서울시립대입구),325388,141967,467355
201710,2017,경원선,한남,93873,32665,126538
201710,2017,경원선,회룡,241230,140101,381331
201710,2017,경원선,보산,45339,15775,61114
201710,2017,경원선,서빙고,49797,16556,66353
201710,2017,경원선,석계,250224,67282,317506
201710,2017,경원선,소요산,84377,115485,199862
201710,2017,경원선,신이문,217491,66521,284012
201710,2017,경원선,양주,245297,62115,307412
201710,2017,경원선,옥수,1651,115,1766
201710,2017,경원선,왕십리(성동구청),428616,59348,487964
201710,2017,경원선,외대앞,303455,56798,360253
201710,2017,경원선,월계,130889,55919,186808
201710,2017,경원선,응봉,41708,18687,60395
201710,2017,경원선,의정부,551208,121670,672878
201710,2017,경원선,이촌(국립중앙박물관),104855,30113,134968
201710,2017,경원선,가능,163054,61765,224819
201710,2017,경원선,광운대,231246,54629,285875
201710,2017,경원선,녹양,115538,35751,151289
201710,2017,경원선,녹천,113463,41152,154615
201710,2017,경원선,덕계,48510,18629,67139
201710,2017,경원선,덕정,187231,37296,224527
201710,2017,경원선,도봉,126361,70576,196937
201710,2017,경원선,도봉산,184310,106312,290622
201710,2017,경원선,동두천,50291,20253,70544
201710,2017,경원선,동두천중앙,83008,41240,124248
201710,2017,경원선,망월사,204410,70623,275033
201710,2017,경원선,창동,5,0,5
201710,2017,경의선,일산,221108,59490,280598
201710,2017,경의선,백마,163259,31894,195153
201710,2017,경의선,파주,47420,8848,56268
201710,2017,경의선,행신,194662,36391,231053
201709,2017,경춘선,별내,63000,19635,82635
201709,2017,경부선,관악,220625,57999,278624
201709,2017,경부선,가산디지털단지,452225,31756,483981
201709,2017,경부선,의왕,243361,42703,286064
201709,2017,경부선,용산,1098115,140906,1239021
201709,2017,경부선,오산대,92335,16423,108758
201709,2017,경부선,오산,293906,45425,339331
201709,2017,경부선,영등포,1190018,287713,1477731
201709,2017,경부선,안양,786749,120735,907484
201709,2017,경부선,신도림,110172,25608,135780
201709,2017,경부선,신길,280880,50891,331771
201709,2017,경부선,수원,1282636,152974,1435610
201709,2017,경부선,송탄,136926,25710,162636
201709,2017,경부선,세마,70034,14316,84350
201709,2017,경부선,세류,115948,21285,137233
201709,2017,경부선,성환,153340,23111,176451
201709,2017,경부선,성균관대,463706,52797,516503
201709,2017,경부선,석수,326506,52887,379393
201709,2017,경부선,서정리,152431,27321,179752
201709,2017,경부선,서울역,157136,11720,168856
201709,2017,경부선,서동탄,42285,9225,51510
201709,2017,경부선,병점,458809,62145,520954
201709,2017,경부선,화서,226419,44526,270945
201709,2017,경부선,평택,397069,72917,469986
201709,2017,경부선,천안,217765,63343,281108
201709,2017,경부선,진위,47169,10394,57563
201709,2017,경부선,명학,285585,45144,330729
201709,2017,경부선,지제,50944,6584,57528
201709,2017,경강선,신둔도예촌,33921,5955,39876
201709,2017,경강선,경기광주,159078,22580,181658
201709,2017,경강선,이천,63626,12193,75819
201709,2017,경강선,이매,39988,9760,49748
201709,2017,경강선,여주,57940,17274,75214
201709,2017,경강선,곤지암,57445,12708,70153
201709,2017,경강선,세종대왕릉,5799,3334,9133
201709,2017,경강선,삼동,39971,7485,47456
201709,2017,경강선,부발,47876,6112,53988
201709,2017,경강선,판교,82522,10743,93265
201709,2017,경강선,초월,61748,10602,72350
201709,2017,9호선2단계,봉은사,370113,39370,409483
201709,2017,9호선2단계,선정릉,192103,20734,212837
201709,2017,9호선2단계,삼성중앙,129330,19907,149237
201709,2017,9호선2단계,종합운동장,187215,16056,203271
201709,2017,9호선2단계,언주,227796,25365,253161
201709,2017,9호선,신방화,212626,46033,258659
201709,2017,9호선,신반포,92962,26354,119316
201709,2017,9호선,신목동,109477,19074,128551
201709,2017,9호선,신논현,848752,53193,901945
201709,2017,9호선,선유도,182739,27428,210167
201709,2017,9호선,샛강,148883,27781,176664
201709,2017,9호선,사평,69697,14786,84483
201709,2017,9호선,양천향교,210363,39929,250292
201709,2017,9호선,여의도,578553,46349,624902
201709,2017,9호선,염창,440754,63249,504003
201709,2017,9호선,증미,173350,43079,216429
201709,2017,9호선,개화,180031,38856,218887
201709,2017,9호선,마곡나루,149287,13123,162410
201709,2017,9호선,등촌,243498,81979,325477
201709,2017,9호선,동작(현충원),51749,13855,65604
201709,2017,9호선,당산,491656,63659,555315
201709,2017,9호선,노량진,806415,93876,900291
201709,2017,9호선,노들,130581,32606,163187
201709,2017,9호선,김포공항,270372,19333,289705
201709,2017,9호선,국회의사당,447910,56993,504903
201709,2017,9호선,구반포,79626,24414,104040
201709,2017,9호선,공항시장,67454,21822,89276
201709,2017,9호선,고속터미널,383154,51710,434864
201709,2017,9호선,흑석(중앙대입구),284255,54924,339179
201709,2017,9호선,가양,523207,126994,650201
201709,2017,8호선,강동구청,264031,65327,329358
201709,2017,8호선,장지,463784,67716,531500
201709,2017,8호선,잠실(송파구청),332636,62618,395254
201709,2017,8호선,암사,475636,95788,571424
201709,2017,8호선,신흥,101225,44121,145346
201709,2017,8호선,수진,115635,44712,160347
201709,2017,8호선,송파,136264,36814,173078
201709,2017,8호선,석촌,202274,59716,261990
201709,2017,8호선,산성,155857,38629,194486
201709,2017,8호선,복정,315828,47914,363742
201709,2017,8호선,문정,381195,48361,429556
201709,2017,8호선,몽촌토성(평화의문),182604,48386,230990
201709,2017,8호선,모란,90002,55910,145912
201709,2017,8호선,단대오거리,298711,68869,367580
201709,2017,8호선,남한산성입구(성남법원.검찰청),392670,78996,471666
201709,2017,8호선,천호(풍납토성),475043,95345,570388
201709,2017,8호선,가락시장,165435,59469,224904
201709,2017,7호선,학동,586359,63971,650330
201709,2017,7호선,하계,522592,112175,634767
201709,2017,7호선,태릉입구,253428,41408,294836
201709,2017,7호선,춘의,241344,28449,269793
201709,2017,7호선,청담,547644,77519,625163
201709,2017,7호선,철산,652193,103310,755503
201709,2017,7호선,천왕,221957,47710,269667
201709,2017,7호선,중화,286713,61567,348280
201709,2017,7호선,중곡,258441,63188,321629
201709,2017,7호선,중계,397375,97239,494614
201709,2017,7호선,장암,69715,9110,78825
201709,2017,7호선,장승배기,266394,82437,348831
201709,2017,7호선,이수,438154,81192,519346
201709,2017,7호선,용마산,162703,36405,199108
201709,2017,7호선,온수(성공회대입구),300569,35504,336073
201709,2017,7호선,어린이대공원(세종대),495878,49063,544941
201709,2017,7호선,신풍,289813,72003,361816
201709,2017,7호선,신중동,390348,50848,441196
201709,2017,7호선,신대방삼거리,410530,97049,507579
201709,2017,7호선,숭실대입구(살피재),453786,59896,513682
201709,2017,7호선,수락산,346836,93506,440342
201709,2017,7호선,상봉(시외버스터미널),444264,72261,516525
201709,2017,7호선,상동,388165,48013,436178
201709,2017,7호선,상도,308464,61822,370286
201709,2017,7호선,삼산체육관,142328,25826,168154
201709,2017,7호선,사가정,399545,96822,496367
201709,2017,7호선,부평구청,336954,30859,367813
201709,2017,7호선,부천종합운동장,145732,19132,164864
201709,2017,7호선,부천시청,335289,48552,383841
201709,2017,7호선,보라매,237777,43510,281287
201709,2017,7호선,반포,169690,33183,202873
201709,2017,5호선,여의나루,437714,34725,472439
201709,2017,5호선,여의도,679496,58602,738098
201709,2017,5호선,영등포구청,89894,20965,110859
201709,2017,5호선,영등포시장,192197,77446,269643
201709,2017,5호선,오금,95641,17755,113396
201709,2017,5호선,오목교(목동운동장앞),701118,87754,788872
201709,2017,5호선,올림픽공원(한국체대),180626,38575,219201
201709,2017,5호선,왕십리(성동구청),131595,27137,158732
201709,2017,5호선,우장산,410274,84307,494581
201709,2017,5호선,을지로4가,110649,46350,156999
201709,2017,5호선,장한평,468543,99477,568020
201709,2017,5호선,종로3가,317582,123988,441570
201709,2017,5호선,천호(풍납토성),477579,151036,628615
201709,2017,5호선,청구,101060,28276,129336
201709,2017,5호선,충정로(경기대입구),123058,19526,142584
201709,2017,5호선,행당,213175,50474,263649
201709,2017,5호선,개롱,167163,44588,211751
201709,2017,6호선,고려대(종암),277482,36697,314179
201709,2017,6호선,효창공원앞,189658,44151,233809
201709,2017,6호선,광흥창(서강),239450,61871,301321
201709,2017,6호선,구산,200648,59338,259986
201709,2017,6호선,녹사평(용산구청),210059,21431,231490
201709,2017,6호선,대흥(서강대앞),225377,48484,273861
201709,2017,6호선,독바위,69451,22029,91480
201709,2017,6호선,돌곶이,231323,67370,298693
201709,2017,6호선,동묘앞,212907,68829,281736
201709,2017,6호선,디지털미디어시티,373330,59787,433117
201709,2017,6호선,마포구청,344757,85146,429903
201709,2017,6호선,망원,339747,88219,427966
201709,2017,6호선,버티고개,63103,15213,78316
201709,2017,6호선,보문,213195,36808,250003
201709,2017,6호선,봉화산(서울의료원),239715,55069,294784
201709,2017,6호선,불광,126003,41559,167562
201709,2017,6호선,삼각지,216921,22296,239217
201709,2017,6호선,상수,316902,25558,342460
201709,2017,6호선,상월곡(한국과학기술연구원),160342,41501,201843
201709,2017,6호선,새절(신사),351117,91175,442292
201709,2017,6호선,석계,341059,78239,419298
201709,2017,6호선,신당,226800,41697,268497
201709,2017,6호선,안암(고대병원앞),427572,33945,461517
201709,2017,6호선,약수,91594,24638,116232
201709,2017,6호선,역촌,84329,37375,121704
201709,2017,6호선,연신내,24,2,26
201709,2017,6호선,월곡(동덕여대),346132,76568,422700
201709,2017,6호선,월드컵경기장(성산),176980,63810,240790
201709,2017,6호선,응암,439914,115990,555904
201709,2017,6호선,이태원,481394,37095,518489
201709,2017,6호선,증산(명지대앞),257203,72944,330147
201709,2017,6호선,창신,95977,18472,114449
201709,2017,6호선,청구,98970,19928,118898
201709,2017,6호선,태릉입구,140144,27957,168101
201709,2017,6호선,한강진,201733,15064,216797
201709,2017,6호선,합정,429983,42609,472592
201709,2017,6호선,화랑대(서울여대입구),380710,48640,429350
201709,2017,6호선,공덕,484590,75796,560386
201709,2017,7호선,가산디지털단지,1105572,76592,1182164
201709,2017,7호선,강남구청,403714,49341,453055
201709,2017,7호선,건대입구,459715,53583,513298
201709,2017,7호선,고속터미널,541794,81581,623375
201709,2017,7호선,공릉(서울과학기술대),342252,69554,411806
201709,2017,7호선,광명사거리,683400,155097,838497
201709,2017,5호선,애오개,184292,42282,226574
201709,2017,5호선,아차산(어린이대공원후문),381468,97520,478988
201709,2017,5호선,신정(은행정),391720,62174,453894
201709,2017,5호선,신길,87998,13370,101368
201709,2017,5호선,신금호,147738,37703,185441
201709,2017,5호선,송정,225792,63929,289721
201709,2017,5호선,서대문,471346,70710,542056
201709,2017,5호선,상일동,300047,64587,364634
201709,2017,5호선,방화,186669,50526,237195
201709,2017,5호선,방이,179854,43628,223482
201709,2017,5호선,발산,391515,69887,461402
201709,2017,5호선,목동,493868,87671,581539
201709,2017,5호선,명일,194300,65380,259680
201709,2017,5호선,마포,370683,67346,438029
201709,2017,5호선,마천,111124,49209,160333
201709,2017,5호선,마장,150170,47189,197359
201709,2017,5호선,마곡,167879,26196,194075
201709,2017,5호선,둔촌동,282956,77158,360114
201709,2017,5호선,동대문역사문화공원,75586,10415,86001
201709,2017,5호선,답십리,417236,87649,504885
201709,2017,5호선,까치산,769884,161144,931028
201709,2017,5호선,김포공항,204727,28096,232823
201709,2017,5호선,길동,174010,61692,235702
201709,2017,5호선,굽은다리(강동구민회관앞),236937,66039,302976
201709,2017,5호선,군자(능동),300352,38621,338973
201709,2017,5호선,광화문(세종문화회관),1009698,91596,1101294
201709,2017,5호선,광나루(장신대),389875,70393,460268
201709,2017,5호선,공덕,367258,47257,414515
201709,2017,5호선,고덕,242876,68019,310895
201709,2017,5호선,거여,161647,52662,214309
201709,2017,5호선,개화산,145337,36708,182045
201709,2017,5호선,화곡,774917,146598,921515
201709,2017,5호선,강동,509044,100923,609967
201709,2017,4호선,남태령,90438,10731,101169
201709,2017,4호선,혜화,1155137,139917,1295054
201709,2017,4호선,한성대입구(삼선교),462633,84753,547386
201709,2017,4호선,충무로,875909,132425,1008334
201709,2017,4호선,총신대입구(이수),532115,148559,680674
201709,2017,4호선,창동,732577,199428,932005
201709,2017,4호선,이촌(국립중앙박물관),234431,47508,281939
201709,2017,4호선,쌍문,871161,174128,1045289
201709,2017,4호선,신용산,370155,50580,420735
201709,2017,4호선,숙대입구(갈월),484176,60884,545060
201709,2017,4호선,수유(강북구청),1035943,234348,1270291
201709,2017,4호선,성신여대입구(돈암),699572,103264,802836
201709,2017,4호선,서울역,344252,41669,385921
201709,2017,4호선,상계,558544,123380,681924
201709,2017,4호선,삼각지,126260,34819,161079
201709,2017,4호선,사당,829684,97144,926828
201709,2017,4호선,미아사거리,769363,189700,959063
201709,2017,4호선,미아(서울사이버대학),442863,129652,572515
201709,2017,4호선,명동,1116744,74471,1191215
201709,2017,4호선,동작(현충원),67988,22374,90362
201709,2017,4호선,동대문역사문화공원,627322,64202,691524
201709,2017,4호선,동대문,615953,156111,772064
201709,2017,4호선,당고개,318584,97737,416321
201709,2017,4호선,노원,607208,96302,703510
201709,2017,4호선,회현(남대문시장),712850,210026,922876
201709,2017,4호선,길음,667055,136409,803464
201709,2017,3호선,경복궁(정부서울청사),696089,96020,792109
201709,2017,3호선,학여울,69884,19966,89850
201709,2017,3호선,충무로,51,0,51
201709,2017,3호선,지축,28658,11445,40103
201709,2017,3호선,종로3가,217588,54552,272140
201709,2017,3호선,잠원,158966,38224,197190
201709,2017,3호선,일원,218765,59511,278276
201709,2017,3호선,을지로3가,232047,60887,292934
201709,2017,3호선,옥수,254373,64632,319005
201709,2017,3호선,오금,185473,28982,214455
201709,2017,3호선,연신내,1049288,280145,1329433
201709,2017,3호선,양재(서초구청),1091732,176641,1268373
201709,2017,3호선,약수,351338,88644,439982
201709,2017,3호선,압구정,889947,159518,1049465
201709,2017,3호선,안국,665478,133513,798991
201709,2017,3호선,신사,858116,75025,933141
201709,2017,3호선,수서,428572,102650,531222
201709,2017,3호선,불광,448300,156111,604411
201709,2017,3호선,무악재,96449,35060,131509
201709,2017,3호선,매봉,280933,58081,339014
201709,2017,3호선,동대입구,340820,41183,382003
201709,2017,3호선,독립문,182875,78062,260937
201709,2017,3호선,도곡,176771,31190,207961
201709,2017,3호선,대치,327898,65211,393109
201709,2017,3호선,대청,261812,54690,316502
201709,2017,3호선,녹번,334425,69568,403993
201709,2017,3호선,남부터미널(예술의전당),949485,135970,1085455
201709,2017,3호선,금호,212735,58563,271298
201709,2017,3호선,구파발,514880,105844,620724
201709,2017,3호선,교대(법원.검찰청),394580,75896,470476
201709,2017,3호선,고속터미널,1653096,192596,1845692
201709,2017,3호선,경찰병원,191243,40669,231912
201709,2017,3호선,홍제,473616,158471,632087
201709,2017,3호선,가락시장,240336,79149,319485
201709,2017,2호선,강변(동서울터미널),1330613,156734,1487347
201709,2017,2호선,합정,931856,78689,1010545
201709,2017,2호선,한양대,387123,17165,404288
201709,2017,2호선,충정로(경기대입구),300606,55867,356473
201709,2017,2호선,종합운동장,504821,61579,566400
201709,2017,2호선,잠실새내,692066,122876,814942
201709,2017,2호선,잠실나루,455518,93869,549387
201709,2017,2호선,잠실(송파구청),2426373,228599,2654972
201709,2017,2호선,이대,573164,72973,646137
201709,2017,2호선,을지로입구,1359623,116519,1476142
201709,2017,2호선,을지로4가,290920,103027,393947
201709,2017,2호선,을지로3가,524836,91134,615970
201709,2017,2호선,용두(동대문구청),46826,26053,72879
201709,2017,2호선,용답,68730,17948,86678
201709,2017,2호선,왕십리(성동구청),575234,62287,637521
201709,2017,2호선,영등포구청,559972,111968,671940
201709,2017,2호선,역삼,1222778,159015,1381793
201709,2017,2호선,양천구청,166491,47652,214143
201709,2017,2호선,아현,268933,69721,338654
201709,2017,2호선,신촌,1363517,147723,1511240
201709,2017,2호선,신정네거리,234360,68010,302370
201709,2017,2호선,신설동,92100,36513,128613
201709,2017,2호선,신림,1910524,248977,2159501
201709,2017,2호선,신도림,1673926,217049,1890975
201709,2017,2호선,신대방,754505,141559,896064
201709,2017,2호선,신당,362910,109625,472535
201709,2017,2호선,신답,33645,11492,45137
201709,2017,2호선,시청,668739,66044,734783
201709,2017,2호선,성수,709934,104408,814342
201709,2017,2호선,선릉,1433732,210382,1644114
201709,2017,2호선,서초,627740,90545,718285
201709,2017,2호선,서울대입구(관악구청),1441299,217532,1658831
201709,2017,2호선,상왕십리,349717,69160,418877
201709,2017,2호선,삼성(무역센터),1566773,130484,1697257
201709,2017,2호선,사당,1077485,208689,1286174
201709,2017,2호선,봉천,574204,153928,728132
201709,2017,2호선,방배,580625,85585,666210
201709,2017,2호선,문래,504582,87278,591860
201709,2017,2호선,뚝섬,456465,67978,524443
201709,2017,2호선,동대문역사문화공원,492386,59556,551942
201709,2017,2호선,도림천,26627,6840,33467
201709,2017,2호선,대림(구로구청),801958,118695,920653
201709,2017,2호선,당산,606824,71537,678361
201709,2017,2호선,낙성대,838181,115320,953501
201709,2017,2호선,구의(광진구청),620952,109106,730058
201709,2017,2호선,구로디지털단지,1754065,172335,1926400
201709,2017,2호선,교대(법원.검찰청),960846,172173,1133019
201709,2017,2호선,건대입구,1279524,100226,1379750
201709,2017,2호선,홍대입구,2185141,117910,2303051
201709,2017,2호선,강남,2848004,172990,3020994
201709,2017,1호선,신설동,373655,131358,505013
201709,2017,1호선,종로5가,524179,280083,804262
201709,2017,1호선,종로3가,696609,380830,1077439
201709,2017,1호선,종각,1199768,161440,1361208
201709,2017,1호선,제기동,302068,363915,665983
201709,2017,1호선,청량리(서울시립대입구),521417,364681,886098
201709,2017,1호선,시청,664050,119067,783117
201709,2017,1호선,서울역,1393335,213661,1606996
201709,2017,1호선,동묘앞,179208,149526,328734
201709,2017,1호선,동대문,334288,139085,473373
201709,2017,경원선,석계,277192,70383,347575
201709,2017,경원선,소요산,59793,88883,148676
201709,2017,경원선,신이문,235471,70791,306262
201709,2017,경원선,양주,248272,64291,312563
201709,2017,경원선,옥수,1789,150,1939
201709,2017,경원선,왕십리(성동구청),475566,63767,539333
201709,2017,경원선,외대앞,344248,60126,404374
201709,2017,경원선,월계,152220,58569,210789
201709,2017,경원선,응봉,44837,20105,64942
201709,2017,경원선,의정부,549824,126036,675860
201709,2017,경원선,이촌(국립중앙박물관),127182,31937,159119
201709,2017,경원선,가능,175227,65089,240316
201709,2017,경원선,광운대,267265,58853,326118
201709,2017,경원선,녹양,124241,37893,162134
201709,2017,경원선,녹천,124946,43238,168184
201709,2017,경원선,덕계,52947,19085,72032
201709,2017,경원선,덕정,196690,39013,235703
201709,2017,경원선,도봉,135622,75309,210931
201709,2017,경원선,도봉산,179844,98883,278727
201709,2017,경원선,동두천,53263,22175,75438
201709,2017,경원선,동두천중앙,83989,42555,126544
201709,2017,경원선,망월사,225046,74449,299495
201709,2017,경원선,창동,2,0,2
201709,2017,경의선,일산,243999,65968,309967
201709,2017,경의선,백마,182588,34456,217044
201709,2017,경의선,파주,53293,8625,61918
201709,2017,경의선,풍산,123162,32372,155534
201709,2017,경의선,행신,212480,38845,251325
201709,2017,경의선,홍대입구,50941,5361,56302
201709,2017,경의선,화전,86075,11116,97191
201709,2017,경의선,효창공원앞,63476,12807,76283
201709,2017,경의선,서강대,63264,10251,73515
201709,2017,경의선,서울역,83390,12764,96154
201709,2017,경의선,수색,57722,19207,76929
201709,2017,경의선,신촌,22916,3914,26830
201709,2017,경의선,야당,99995,25092,125087
201709,2017,경의선,운정,133230,34834,168064
201709,2017,경의선,월롱,76287,10253,86540
201709,2017,경의선,가좌,111055,48371,159426
201709,2017,경의선,강매,68388,18135,86523
201709,2017,경의선,곡산,13533,5533,19066
201709,2017,경의선,공덕,75692,11314,87006
201709,2017,경의선,금릉,129720,27988,157708
201709,2017,경의선,금촌,185804,50575,236379
201709,2017,경의선,능곡,91028,32780,123808
201709,2017,경의선,디지털미디어시티,62598,11002,73600
201709,2017,경의선,문산,154635,51050,205685
201709,2017,경의선,탄현,202949,41092,244041
201709,2017,경인선,인천,105841,46844,152685
201709,2017,경인선,제물포,309680,62257,371937
201709,2017,경인선,주안,702726,105538,808264
201709,2017,경인선,중동,248873,69476,318349
201709,2017,경인선,백운,224064,71462,295526
201709,2017,경인선,부개,252767,69866,322633
201709,2017,경인선,부천,1086302,220224,1306526
201709,2017,경인선,부평,1016243,147082,1163325
201709,2017,경인선,소사,331478,89820,421298
201709,2017,경인선,송내,922119,123662,1045781
201709,2017,경인선,역곡,852581,154421,1007002
201709,2017,경인선,오류동,279170,92754,371924
201709,2017,경인선,온수(성공회대입구),187138,48357,235495
201709,2017,경인선,간석,167281,48820,216101
201709,2017,경인선,개봉,604812,165861,770673
201709,2017,경인선,구일,218822,38508,257330
201709,2017,경인선,도원,98242,38325,136567
201709,2017,경인선,도화,88077,39529,127606
201709,2017,경인선,동암,511229,112386,623615
201709,2017,경인선,동인천,442891,132010,574901
201709,2017,경춘선,평내호평,151048,45442,196490
201709,2017,경춘선,천마산,31808,16730,48538
201709,2017,경춘선,춘천,59671,23607,83278
201709,2017,경춘선,굴봉산,5526,2980,8506
201709,2017,경춘선,청평,53562,19431,72993
201709,2017,경춘선,강촌,21231,6596,27827
201709,2017,경춘선,갈매,47098,13681,60779
201709,2017,경춘선,가평,57566,17329,74895
201709,2017,경춘선,마석,92074,36673,128747
201709,2017,경춘선,남춘천,80588,26494,107082
201709,2017,경춘선,백양리,3101,1415,4516
201709,2017,경춘선,김유정,13396,4597,17993
201709,2017,경춘선,사릉,100442,21894,122336
201709,2017,경춘선,상천,9243,7408,16651
201709,2017,경춘선,대성리,23511,6995,30506
201709,2017,경춘선,금곡,34025,16787,50812
201709,2017,경춘선,신내,16896,8305,25201
201709,2017,경춘선,퇴계원,87897,27193,115090
201709,2017,공항철도 1호선,공항화물청사,70516,7934,78450
201709,2017,공항철도 1호선,공덕,49503,6300,55803
201709,2017,공항철도 1호선,계양,313635,32785,346420
201709,2017,공항철도 1호선,검암,253706,25226,278932
201709,2017,공항철도 1호선,운서,147705,25111,172816
201709,2017,공항철도 1호선,영종,45273,13465,58738
201709,2017,공항철도 1호선,서울역,312694,28793,341487
201709,2017,공항철도 1호선,홍대입구,272169,17507,289676
201709,2017,공항철도 1호선,청라국제도시,159897,9828,169725
201709,2017,공항철도 1호선,인천국제공항,468995,44802,513797
201709,2017,공항철도 1호선,디지털미디어시티,343770,22872,366642
201709,2017,공항철도 1호선,김포공항,301682,18316,319998
201709,2017,과천선,범계,820601,114777,935378
201709,2017,과천선,인덕원,713209,107744,820953
201709,2017,과천선,평촌,460088,67578,527666
201709,2017,과천선,대공원,126036,49462,175498
201709,2017,과천선,정부과천청사,321438,65047,386485
201709,2017,과천선,선바위,255186,36373,291559
201709,2017,과천선,경마공원,166440,69576,236016
201709,2017,과천선,과천,114295,35127,149422
201709,2017,분당선,가천대,326337,26249,352586
201709,2017,분당선,한티,368991,71856,440847
201709,2017,분당선,개포동,87231,23414,110645
201709,2017,분당선,구룡,52410,19539,71949
201709,2017,분당선,구성,117541,41302,158843
201709,2017,분당선,기흥,228124,34076,262200
201709,2017,분당선,대모산입구,72460,30187,102647
201709,2017,분당선,도곡,169624,43093,212717
201709,2017,분당선,망포,373068,32478,405546
201709,2017,분당선,매교,77935,19576,97511
201709,2017,분당선,매탄권선,127484,15827,143311
201709,2017,분당선,모란,546210,173978,720188
201709,2017,분당선,미금,471203,129651,600854
201709,2017,분당선,보정,61594,26358,87952
201709,2017,분당선,복정,1,0,1
201709,2017,분당선,상갈,133256,33484,166740
201709,2017,분당선,서울숲,227416,25613,253029
201709,2017,분당선,서현,690840,134930,825770
201709,2017,분당선,선릉,231578,28335,259913
201709,2017,분당선,선정릉,194244,38996,233240
201709,2017,분당선,수내,343821,84475,428296
201709,2017,분당선,수서,359117,64922,424039
201709,2017,분당선,수원,279755,28958,308713
201709,2017,분당선,수원시청,310304,37836,348140
201709,2017,분당선,신갈,109060,32432,141492
201709,2017,분당선,압구정로데오,405607,40778,446385
201709,2017,분당선,야탑,711878,168476,880354
201709,2017,분당선,영통,263565,29187,292752
201709,2017,분당선,오리,350521,98080,448601
201709,2017,분당선,이매,146127,41479,187606
201709,2017,분당선,정자,431905,84875,516780
201709,2017,분당선,죽전,436657,83845,520502
201709,2017,분당선,청명,115741,17758,133499
201709,2017,분당선,태평,360908,94795,455703
201709,2017,분당선,강남구청,221342,41023,262365
201709,2017,수인선,남동인더스파크,60793,6600,67393
201709,2017,수인선,달월,2333,1976,4309
201709,2017,수인선,소래포구,138525,77333,215858
201709,2017,수인선,송도,73076,22582,95658
201709,2017,수인선,숭의,79500,26931,106431
201709,2017,수인선,신포,47664,12603,60267
201709,2017,수인선,호구포,95744,18245,113989
201709,2017,수인선,원인재,125772,29535,155307
201709,2017,수인선,월곶,76216,15898,92114
201709,2017,수인선,인천,25145,11420,36565
201709,2017,수인선,인천논현,166586,35477,202063
201709,2017,수인선,인하대,173490,24096,197586
201709,2017,수인선,연수,136561,29315,165876
201709,2017,안산선,고잔,265367,39365,304732
201709,2017,안산선,대야미,107149,29370,136519
201709,2017,안산선,반월,125324,32445,157769
201709,2017,안산선,산본,468939,106833,575772
201709,2017,안산선,상록수,593182,90450,683632
201709,2017,안산선,수리산,111035,36045,147080
201709,2017,안산선,한대앞,269524,43310,312834
201709,2017,안산선,안산,480411,46317,526728
201709,2017,안산선,오이도,260957,40821,301778
201709,2017,안산선,정왕,282247,26415,308662
201709,2017,안산선,중앙,485227,59703,544930
201709,2017,안산선,초지,135524,17102,152626
201709,2017,안산선,신길온천,48474,11551,60025
201709,2017,우이신설선,4.19민주묘지,64367,27955,92322
201709,2017,우이신설선,가오리,63357,33084,96441
201709,2017,우이신설선,보문,25269,12300,37569
201709,2017,우이신설선,북한산보국문,106706,34537,141243
201709,2017,우이신설선,북한산우이,61729,47256,108985
201709,2017,우이신설선,삼양,30641,20070,50711
201709,2017,우이신설선,화계,45907,29614,75521
201709,2017,우이신설선,성신여대입구(돈암),82441,28334,110775
201709,2017,우이신설선,솔밭공원,41082,23352,64434
201709,2017,우이신설선,솔샘,102487,27492,129979
201709,2017,우이신설선,신설동,29076,15847,44923
201709,2017,우이신설선,정릉,67352,34740,102092
201709,2017,우이신설선,삼양사거리,32551,25504,58055
201709,2017,일산선,대곡,43066,12456,55522
201709,2017,일산선,화정,484872,139874,624746
201709,2017,일산선,마두,179653,80022,259675
201709,2017,일산선,대화,375319,97982,473301
201709,2017,일산선,지축,1,0,1
201709,2017,일산선,주엽,207705,103875,311580
201709,2017,일산선,정발산,215106,63711,278817
201709,2017,일산선,원흥,202282,44439,246721
201709,2017,일산선,원당,291875,90495,382370
201709,2017,일산선,백석,287100,84043,371143
201709,2017,일산선,삼송,467608,93972,561580
201709,2017,장항선,쌍용(나사렛대),75217,18757,93974
201709,2017,장항선,신창(순천향대),76417,8859,85276
201709,2017,장항선,온양온천,97010,63024,160034
201709,2017,장항선,봉명,30130,14942,45072
201709,2017,장항선,아산,91994,10435,102429
201709,2017,장항선,배방,26695,9360,36055
201709,2017,중앙선,구리,350944,89667,440611
201709,2017,중앙선,회기,822943,137227,960170
201709,2017,중앙선,덕소,156565,54421,210986
201709,2017,중앙선,도농,231867,61849,293716
201709,2017,중앙선,도심,67828,22805,90633
201709,2017,중앙선,망우,195203,75808,271011
201709,2017,중앙선,상봉(시외버스터미널),155123,42379,197502
201709,2017,중앙선,신원,5607,4215,9822
201709,2017,중앙선,아신,20108,8547,28655
201709,2017,중앙선,양수,48811,22486,71297
201709,2017,중앙선,양원,42310,18108,60418
201709,2017,중앙선,양정,19429,9654,29083
201709,2017,중앙선,양평,89476,40988,130464
201709,2017,중앙선,오빈,7073,4930,12003
201709,2017,중앙선,용문,52007,52953,104960
201709,2017,중앙선,운길산,24455,10246,34701
201709,2017,중앙선,원덕,8151,6685,14836
201709,2017,5호선,양평,159991,28756,188747
201709,2017,중앙선,중랑,135237,56239,191476
201709,2017,중앙선,지평,1299,698,1997
201709,2017,중앙선,팔당,27666,9380,37046
201709,2017,중앙선,국수,21177,12009,33186
201709,2017,경원선,서빙고,54635,17778,72413
201709,2017,경원선,보산,44730,16356,61086
201709,2017,경원선,회룡,263929,149026,412955
201709,2017,경원선,한남,103189,35617,138806
201709,2017,경원선,청량리(서울시립대입구),323900,149212,473112
201709,2017,경원선,방학,213363,110621,323984
201709,2017,7호선,면목,427063,89339,516402
201709,2017,7호선,먹골,270798,61142,331940
201709,2017,7호선,마들,296513,79059,375572
201709,2017,7호선,뚝섬유원지,308151,48672,356823
201709,2017,7호선,도봉산,249785,42954,292739
201709,2017,7호선,대림(구로구청),280296,35942,316238
201709,2017,7호선,논현,535028,52377,587405
201709,2017,7호선,노원,514023,116517,630540
201709,2017,7호선,내방,379795,65844,445639
201709,2017,7호선,남성,298175,72382,370557
201709,2017,7호선,남구로,425674,60256,485930
201709,2017,7호선,까치울,191490,27153,218643
201709,2017,7호선,굴포천,247192,34145,281337
201709,2017,7호선,군자(능동),364203,78207,442410
201709,2017,경원선,지행,189063,48786,237849
201709,2017,경부선,직산,24322,7320,31642
201709,2017,경부선,두정,189380,24429,213809
201709,2017,경부선,독산,439350,69652,509002
201709,2017,경부선,대방,424420,78530,502950
201709,2017,경부선,당정,212566,32737,245303
201709,2017,경부선,노량진,456626,62218,518844
201709,2017,경부선,남영,322965,42867,365832
201709,2017,경부선,금천구청,286379,80731,367110
201709,2017,경부선,금정,759468,113522,872990
201709,2017,경부선,군포,201369,37826,239195
201709,2017,경부선,구로,558235,99639,657874
201709,2017,경부선,광명,52335,4455,56790
201708,2017,경춘선,갈매,40711,12063,52774
201708,2017,경춘선,강촌,21658,6021,27679
201708,2017,경춘선,청평,78157,18783,96940
201708,2017,경춘선,굴봉산,7588,2534,10122
201708,2017,경춘선,춘천,51438,29047,80485
201708,2017,경춘선,천마산,28606,16283,44889
201708,2017,경춘선,평내호평,140630,42550,183180
201708,2017,경인선,동인천,416110,128773,544883
201708,2017,경인선,동암,485554,108252,593806
201708,2017,경인선,도화,82255,38549,120804
201708,2017,경인선,도원,78375,34663,113038
201708,2017,경인선,구일,208967,35453,244420
201708,2017,경인선,개봉,559209,156336,715545
201708,2017,경인선,간석,155324,46192,201516
201708,2017,경인선,온수(성공회대입구),161834,43966,205800
201708,2017,경인선,오류동,262265,84472,346737
201708,2017,경인선,역곡,747598,145050,892648
201708,2017,경인선,송내,843574,117820,961394
201708,2017,경인선,소사,297568,83523,381091
201708,2017,경인선,부평,978738,140806,1119544
201708,2017,경인선,부천,1025157,212684,1237841
201708,2017,경인선,부개,235549,64862,300411
201708,2017,경인선,백운,205946,67460,273406
201708,2017,경인선,중동,232136,65176,297312
201708,2017,경인선,주안,640421,101181,741602
201708,2017,경인선,제물포,254518,57060,311578
201708,2017,경인선,인천,107031,46078,153109
201708,2017,경의선,탄현,187606,37807,225413
201708,2017,경의선,문산,146890,51035,197925
201708,2017,경의선,디지털미디어시티,57284,9601,66885
201708,2017,경의선,능곡,82390,31049,113439
201708,2017,경의선,금촌,174610,47741,222351
201708,2017,경의선,금릉,120844,26299,147143
201708,2017,경의선,공덕,72742,11219,83961
201708,2017,경의선,곡산,12290,6065,18355
201708,2017,경의선,강매,60730,16643,77373
201708,2017,경의선,가좌,99951,45384,145335
201708,2017,경의선,월롱,60272,8987,69259
201708,2017,경의선,운정,121293,31248,152541
201708,2017,경의선,야당,90837,22565,113402
201708,2017,경의선,신촌,19690,3472,23162
201708,2017,경의선,수색,56198,17879,74077
201708,2017,경의선,서울역,77248,11541,88789
201708,2017,경의선,서강대,56646,9619,66265
201708,2017,경의선,효창공원앞,52812,12188,65000
201708,2017,경의선,화전,47051,10673,57724
201708,2017,경의선,홍대입구,47604,5141,52745
201708,2017,경의선,행신,194592,35633,230225
201708,2017,경의선,풍산,112694,29493,142187
201708,2017,경의선,파주,31803,7891,39694
201708,2017,경의선,백마,165932,32040,197972
201708,2017,경의선,일산,219794,57185,276979
201708,2017,경원선,창동,2,0,2
201708,2017,경원선,망월사,163803,69921,233724
201708,2017,경원선,동두천중앙,79176,39832,119008
201708,2017,경원선,동두천,44235,20445,64680
201708,2017,경원선,도봉산,162973,90513,253486
201708,2017,경원선,도봉,127477,71428,198905
201708,2017,경원선,덕정,160093,35897,195990
201708,2017,경원선,덕계,48471,17895,66366
201708,2017,경원선,녹천,116980,40145,157125
201708,2017,경원선,녹양,113097,34995,148092
201708,2017,경원선,광운대,217185,55386,272571
201708,2017,경원선,가능,161569,61680,223249
201708,2017,경원선,이촌(국립중앙박물관),106283,28598,134881
201708,2017,경원선,의정부,529670,125670,655340
201708,2017,경원선,응봉,40570,19164,59734
201708,2017,경원선,월계,97799,53741,151540
201708,2017,경원선,외대앞,280659,56551,337210
201708,2017,경원선,왕십리(성동구청),445691,62966,508657
201708,2017,경원선,옥수,1547,108,1655
201708,2017,경원선,양주,220665,56431,277096
201708,2017,경원선,신이문,222336,66208,288544
201708,2017,경원선,소요산,63701,97287,160988
201708,2017,경원선,석계,248189,65068,313257
201708,2017,경원선,서빙고,48717,16103,64820
201708,2017,경원선,보산,39704,15619,55323
201708,2017,경원선,회룡,244577,137209,381786
201708,2017,경원선,한남,99063,33481,132544
201708,2017,경원선,청량리(서울시립대입구),323429,143534,466963
201708,2017,경원선,방학,197742,102610,300352
201708,2017,경원선,지행,169175,46149,215324
201708,2017,경부선,직산,22445,5738,28183
201708,2017,경부선,두정,144480,23005,167485
201708,2017,경부선,독산,409129,64136,473265
201708,2017,경부선,대방,377788,72479,450267
201708,2017,경부선,당정,178000,30295,208295
201708,2017,경부선,노량진,410815,46428,457243
201708,2017,경부선,남영,273856,38992,312848
201708,2017,경부선,금천구청,259494,73502,332996
201708,2017,경부선,금정,704713,104880,809593
201708,2017,경부선,군포,186292,35298,221590
201708,2017,경부선,구로,528901,92694,621595
201708,2017,경부선,광명,50314,4401,54715
201708,2017,경부선,관악,200583,54897,255480
201708,2017,경부선,가산디지털단지,425737,29342,455079
201708,2017,경부선,의왕,217530,38667,256197
201708,2017,경부선,용산,1133686,135996,1269682
201708,2017,경부선,오산대,68042,14748,82790
201708,2017,경부선,오산,263131,43404,306535
201708,2017,경부선,영등포,1192115,287574,1479689
201708,2017,경부선,안양,651777,117041,768818
201708,2017,경부선,신도림,96026,22265,118291
201708,2017,경부선,신길,256461,46480,302941
201708,2017,경부선,수원,1166493,147169,1313662
201708,2017,경부선,송탄,123735,25048,148783
201708,2017,경부선,세마,63015,13278,76293
201708,2017,경부선,세류,105574,19961,125535
201708,2017,경부선,성환,100480,21927,122407
201708,2017,경부선,성균관대,388477,47865,436342
201708,2017,경부선,석수,289385,48003,337388
201708,2017,경부선,서정리,121521,26591,148112
201708,2017,경부선,서울역,177244,12022,189266
201708,2017,경부선,서동탄,38461,9091,47552
201708,2017,경부선,병점,366050,58468,424518
201708,2017,경부선,화서,198825,40515,239340
201708,2017,경부선,평택,351448,69732,421180
201708,2017,경부선,천안,164404,62355,226759
201708,2017,경부선,진위,40208,8962,49170
201708,2017,경부선,명학,244976,42076,287052
201708,2017,경부선,지제,46621,6119,52740
201708,2017,경강선,신둔도예촌,27328,5563,32891
201708,2017,경강선,경기광주,148369,20675,169044
201708,2017,경강선,이천,60797,11395,72192
201708,2017,경강선,이매,36538,8875,45413
201708,2017,경강선,여주,47683,16636,64319
201708,2017,경강선,곤지암,48009,11294,59303
201708,2017,경강선,세종대왕릉,5571,2954,8525
201708,2017,경강선,삼동,36101,6946,43047
201708,2017,경강선,부발,41915,5837,47752
201708,2017,경강선,판교,82179,10513,92692
201708,2017,경강선,초월,57745,9639,67384
201708,2017,9호선2단계,선정릉,186755,19202,205957
201708,2017,9호선2단계,언주,222318,23789,246107
201708,2017,9호선2단계,종합운동장,176960,15077,192037
201708,2017,9호선2단계,삼성중앙,128544,19421,147965
201708,2017,9호선2단계,봉은사,364662,39058,403720
201708,2017,9호선,흑석(중앙대입구),220405,51091,271496
201708,2017,9호선,증미,171208,41590,212798
201708,2017,9호선,염창,417311,59494,476805
201708,2017,9호선,여의도,541766,41597,583363
201708,2017,9호선,양천향교,199094,38181,237275
201708,2017,1호선,동대문,309280,128976,438256
201708,2017,1호선,동묘앞,157243,130611,287854
201708,2017,1호선,서울역,1364076,201406,1565482
201708,2017,1호선,시청,608146,90914,699060
201708,2017,1호선,청량리(서울시립대입구),472646,338117,810763
201708,2017,1호선,제기동,275569,307312,582881
201708,2017,1호선,종각,1204542,154068,1358610
201708,2017,1호선,종로3가,677440,363996,1041436
201708,2017,1호선,종로5가,487432,265077,752509
201708,2017,1호선,신설동,333605,117640,451245
201708,2017,2호선,강남,3017517,165636,3183153
201708,2017,2호선,홍대입구,2267398,112439,2379837
201708,2017,2호선,건대입구,1213568,92767,1306335
201708,2017,2호선,교대(법원.검찰청),936473,156274,1092747
201708,2017,2호선,구로디지털단지,1705205,166726,1871931
201708,2017,2호선,구의(광진구청),590243,102715,692958
201708,2017,2호선,낙성대,794488,107802,902290
201708,2017,2호선,당산,548204,64890,613094
201708,2017,2호선,대림(구로구청),781497,112511,894008
201708,2017,2호선,도림천,26066,6447,32513
201708,2017,2호선,동대문역사문화공원,497324,56649,553973
201708,2017,2호선,뚝섬,426286,63919,490205
201708,2017,2호선,문래,481818,83103,564921
201708,2017,2호선,방배,509415,77427,586842
201708,2017,2호선,봉천,556535,149914,706449
201708,2017,2호선,사당,1018250,187826,1206076
201708,2017,2호선,삼성(무역센터),1602107,128585,1730692
201708,2017,2호선,상왕십리,327060,65535,392595
201708,2017,2호선,서울대입구(관악구청),1354126,210635,1564761
201708,2017,2호선,서초,585742,79383,665125
201708,2017,2호선,선릉,1419160,200961,1620121
201708,2017,2호선,성수,677048,97186,774234
201708,2017,2호선,시청,646515,56083,702598
201708,2017,2호선,신답,30288,10231,40519
201708,2017,2호선,신당,337277,104894,442171
201708,2017,2호선,신대방,723795,131129,854924
201708,2017,2호선,신도림,1601288,206355,1807643
201708,2017,2호선,신림,1858747,236426,2095173
201708,2017,2호선,신설동,81673,32484,114157
201708,2017,2호선,신정네거리,221087,65034,286121
201708,2017,2호선,신촌,1302829,138727,1441556
201708,2017,2호선,아현,237857,64752,302609
201708,2017,2호선,양천구청,151517,42801,194318
201708,2017,2호선,역삼,1219521,151752,1371273
201708,2017,2호선,영등포구청,530445,106544,636989
201708,2017,2호선,왕십리(성동구청),515798,58251,574049
201708,2017,2호선,용답,59645,16461,76106
201708,2017,2호선,용두(동대문구청),45441,22949,68390
201708,2017,2호선,을지로3가,512121,84524,596645
201708,2017,2호선,을지로4가,276294,92368,368662
201708,2017,2호선,을지로입구,1334361,110915,1445276
201708,2017,2호선,이대,463376,58282,521658
201708,2017,2호선,잠실(송파구청),2490353,222955,2713308
201708,2017,2호선,잠실나루,428148,86793,514941
201708,2017,2호선,잠실새내,676881,116785,793666
201708,2017,2호선,종합운동장,465717,53179,518896
201708,2017,2호선,충정로(경기대입구),283253,52131,335384
201708,2017,2호선,한양대,230431,14538,244969
201708,2017,2호선,합정,916823,71450,988273
201708,2017,2호선,강변(동서울터미널),1322874,142316,1465190
201708,2017,3호선,가락시장,224502,70425,294927
201708,2017,3호선,홍제,427388,149230,576618
201708,2017,3호선,경찰병원,184092,39074,223166
201708,2017,3호선,고속터미널,1690548,188120,1878668
201708,2017,3호선,교대(법원.검찰청),368207,67851,436058
201708,2017,3호선,구파발,510412,104188,614600
201708,2017,3호선,금호,201217,54956,256173
201708,2017,3호선,남부터미널(예술의전당),928832,122743,1051575
201708,2017,3호선,녹번,313393,64703,378096
201708,2017,3호선,대청,252715,56217,308932
201708,2017,3호선,대치,322364,59836,382200
201708,2017,3호선,도곡,166083,28821,194904
201708,2017,3호선,독립문,173857,71238,245095
201708,2017,3호선,동대입구,274389,35292,309681
201708,2017,3호선,매봉,267976,53746,321722
201708,2017,3호선,무악재,90745,33086,123831
201708,2017,3호선,불광,424664,154613,579277
201708,2017,3호선,수서,410032,94883,504915
201708,2017,3호선,신사,851407,69988,921395
201708,2017,3호선,안국,630221,127607,757828
201708,2017,3호선,압구정,866289,139642,1005931
201708,2017,3호선,약수,337062,83941,421003
201708,2017,3호선,양재(서초구청),995567,156465,1152032
201708,2017,3호선,연신내,1008057,262612,1270669
201708,2017,3호선,오금,176019,27153,203172
201708,2017,3호선,옥수,239665,61007,300672
201708,2017,3호선,을지로3가,226084,59457,285541
201708,2017,3호선,일원,203993,54637,258630
201708,2017,3호선,잠원,144748,33953,178701
201708,2017,3호선,종로3가,210337,54873,265210
201708,2017,3호선,지축,24315,10489,34804
201708,2017,3호선,충무로,34,1,35
201708,2017,3호선,학여울,55481,14293,69774
201708,2017,3호선,경복궁(정부서울청사),620017,84381,704398
201708,2017,4호선,길음,610164,142399,752563
201708,2017,4호선,회현(남대문시장),673182,205590,878772
201708,2017,4호선,노원,588193,90453,678646
201708,2017,4호선,당고개,304625,95945,400570
201708,2017,4호선,동대문,573804,144739,718543
201708,2017,4호선,동대문역사문화공원,637427,62406,699833
201708,2017,4호선,동작(현충원),52247,19912,72159
201708,2017,4호선,명동,1096459,67831,1164290
201708,2017,4호선,미아(서울사이버대학),419590,130022,549612
201708,2017,4호선,미아사거리,780353,189654,970007
201708,2017,4호선,사당,778319,89953,868272
201708,2017,4호선,삼각지,119229,32453,151682
201708,2017,4호선,상계,523440,115469,638909
201708,2017,4호선,서울역,326591,38963,365554
201708,2017,4호선,성신여대입구(돈암),657940,105767,763707
201708,2017,4호선,수유(강북구청),1078037,256286,1334323
201708,2017,4호선,숙대입구(갈월),395981,57418,453399
201708,2017,4호선,신용산,356370,47703,404073
201708,2017,4호선,쌍문,832100,166523,998623
201708,2017,4호선,이촌(국립중앙박물관),265501,44240,309741
201708,2017,4호선,창동,690438,184127,874565
201708,2017,4호선,총신대입구(이수),499669,138907,638576
201708,2017,4호선,충무로,780514,126375,906889
201708,2017,4호선,한성대입구(삼선교),374752,77533,452285
201708,2017,4호선,혜화,1102590,131846,1234436
201708,2017,4호선,남태령,64732,9446,74178
201708,2017,5호선,강동,465961,94712,560673
201708,2017,5호선,화곡,739443,139641,879084
201708,2017,5호선,개화산,141495,35109,176604
201708,2017,5호선,거여,151373,50272,201645
201708,2017,5호선,고덕,224653,64728,289381
201708,2017,5호선,공덕,343997,44110,388107
201708,2017,5호선,광나루(장신대),345709,61346,407055
201708,2017,5호선,광화문(세종문화회관),1001094,79358,1080452
201708,2017,5호선,군자(능동),287413,37872,325285
201708,2017,5호선,굽은다리(강동구민회관앞),229237,64004,293241
201708,2017,5호선,길동,164195,59489,223684
201708,2017,5호선,김포공항,216304,33657,249961
201708,2017,5호선,까치산,737800,153376,891176
201708,2017,5호선,답십리,393185,82907,476092
201708,2017,5호선,동대문역사문화공원,74832,10898,85730
201708,2017,5호선,둔촌동,275625,74338,349963
201708,2017,5호선,마곡,156756,23744,180500
201708,2017,5호선,마장,134075,44020,178095
201708,2017,5호선,마천,106076,47778,153854
201708,2017,5호선,마포,345429,63449,408878
201708,2017,5호선,명일,178310,59784,238094
201708,2017,5호선,목동,462953,83167,546120
201708,2017,5호선,발산,356224,63228,419452
201708,2017,5호선,방이,167678,41884,209562
201708,2017,5호선,방화,177070,48218,225288
201708,2017,5호선,상일동,275589,60217,335806
201708,2017,5호선,서대문,420598,69403,490001
201708,2017,5호선,송정,210537,60855,271392
201708,2017,5호선,신금호,138558,35352,173910
201708,2017,5호선,신길,81630,12649,94279
201708,2017,5호선,신정(은행정),370491,58297,428788
201708,2017,5호선,아차산(어린이대공원후문),347360,89338,436698
201708,2017,5호선,애오개,171714,39362,211076
201708,2017,5호선,양평,155337,27200,182537
201708,2017,5호선,여의나루,324827,30803,355630
201708,2017,5호선,여의도,610056,51275,661331
201708,2017,5호선,영등포구청,83833,19340,103173
201708,2017,5호선,영등포시장,176957,73247,250204
201708,2017,5호선,오금,88839,16832,105671
201708,2017,5호선,오목교(목동운동장앞),661154,84638,745792
201708,2017,5호선,올림픽공원(한국체대),141097,33240,174337
201708,2017,5호선,왕십리(성동구청),125864,25643,151507
201708,2017,5호선,우장산,382040,79816,461856
201708,2017,5호선,을지로4가,103529,41529,145058
201708,2017,5호선,장한평,444988,96792,541780
201708,2017,5호선,종로3가,316292,124033,440325
201708,2017,5호선,천호(풍납토성),468725,150789,619514
201708,2017,5호선,청구,92671,27363,120034
201708,2017,5호선,충정로(경기대입구),108567,18168,126735
201708,2017,5호선,행당,200419,46949,247368
201708,2017,5호선,개롱,157157,43893,201050
201708,2017,6호선,고려대(종암),227934,32895,260829
201708,2017,6호선,효창공원앞,165099,40181,205280
201708,2017,6호선,광흥창(서강),229689,56782,286471
201708,2017,6호선,구산,188981,56295,245276
201708,2017,6호선,녹사평(용산구청),199265,19911,219176
201708,2017,6호선,대흥(서강대앞),191540,42570,234110
201708,2017,6호선,독바위,67397,20476,87873
201708,2017,6호선,돌곶이,216906,65860,282766
201708,2017,6호선,동묘앞,193573,61684,255257
201708,2017,6호선,디지털미디어시티,352958,56658,409616
201708,2017,6호선,마포구청,322331,78393,400724
201708,2017,6호선,망원,329219,82907,412126
201708,2017,6호선,버티고개,55517,13935,69452
201708,2017,6호선,보문,208381,36980,245361
201708,2017,6호선,봉화산(서울의료원),223210,52395,275605
201708,2017,6호선,불광,132054,44741,176795
201708,2017,6호선,삼각지,200173,20054,220227
201708,2017,6호선,상수,296318,23222,319540
201708,2017,6호선,상월곡(한국과학기술연구원),130797,37604,168401
201708,2017,6호선,새절(신사),308057,85398,393455
201708,2017,6호선,석계,306597,74413,381010
201708,2017,6호선,신당,202917,38758,241675
201708,2017,6호선,안암(고대병원앞),311383,30757,342140
201708,2017,6호선,약수,84875,23669,108544
201708,2017,6호선,역촌,81764,36014,117778
201708,2017,6호선,연신내,12,0,12
201708,2017,6호선,월곡(동덕여대),287413,71052,358465
201708,2017,6호선,월드컵경기장(성산),158058,55281,213339
201708,2017,6호선,응암,418783,109380,528163
201708,2017,6호선,이태원,473741,33973,507714
201708,2017,6호선,증산(명지대앞),243196,69211,312407
201708,2017,6호선,창신,84219,17181,101400
201708,2017,6호선,청구,93212,19021,112233
201708,2017,6호선,태릉입구,125378,25857,151235
201708,2017,6호선,한강진,192024,13752,205776
201708,2017,6호선,합정,420034,39831,459865
201708,2017,6호선,화랑대(서울여대입구),324189,45479,369668
201708,2017,6호선,공덕,452279,69116,521395
201708,2017,7호선,가산디지털단지,1077332,72877,1150209
201708,2017,7호선,학동,556973,58218,615191
201708,2017,7호선,건대입구,436233,53525,489758
201708,2017,7호선,고속터미널,564661,78294,642955
201708,2017,7호선,공릉(서울과학기술대),298291,65307,363598
201708,2017,7호선,광명사거리,649241,149977,799218
201708,2017,7호선,군자(능동),358530,76272,434802
201708,2017,7호선,굴포천,235510,32347,267857
201708,2017,7호선,까치울,176628,24800,201428
201708,2017,7호선,남구로,415436,58037,473473
201708,2017,7호선,남성,275219,69859,345078
201708,2017,7호선,내방,359422,61562,420984
201708,2017,7호선,노원,517701,116229,633930
201708,2017,7호선,논현,522689,50547,573236
201708,2017,7호선,대림(구로구청),283587,35186,318773
201708,2017,7호선,도봉산,220089,41281,261370
201708,2017,7호선,뚝섬유원지,250140,45419,295559
201708,2017,7호선,마들,277569,74815,352384
201708,2017,7호선,먹골,259005,58083,317088
201708,2017,7호선,면목,375981,85407,461388
201708,2017,7호선,반포,158263,30918,189181
201708,2017,7호선,보라매,220045,40214,260259
201708,2017,7호선,부천시청,326064,47405,373469
201708,2017,7호선,부천종합운동장,134456,17256,151712
201708,2017,7호선,부평구청,316754,30165,346919
201708,2017,7호선,사가정,377564,92690,470254
201708,2017,7호선,삼산체육관,134890,24280,159170
201708,2017,7호선,상도,267594,58854,326448
201708,2017,7호선,상동,370057,44886,414943
201708,2017,7호선,상봉(시외버스터미널),427374,69493,496867
201708,2017,7호선,수락산,329527,91328,420855
201708,2017,7호선,숭실대입구(살피재),327235,55541,382776
201708,2017,7호선,신대방삼거리,391692,91179,482871
201708,2017,7호선,신중동,374774,48126,422900
201708,2017,7호선,신풍,276165,67954,344119
201708,2017,7호선,어린이대공원(세종대),376198,44663,420861
201708,2017,7호선,온수(성공회대입구),265953,33689,299642
201708,2017,7호선,용마산,152821,34812,187633
201708,2017,7호선,이수,422384,77050,499434
201708,2017,7호선,장승배기,253921,78460,332381
201708,2017,7호선,장암,69078,10941,80019
201708,2017,7호선,중계,365758,89297,455055
201708,2017,7호선,중곡,239438,60692,300130
201708,2017,7호선,중화,271611,59170,330781
201708,2017,7호선,천왕,206611,44883,251494
201708,2017,7호선,철산,616930,100542,717472
201708,2017,7호선,청담,525670,71307,596977
201708,2017,7호선,춘의,227433,27169,254602
201708,2017,7호선,태릉입구,218515,39410,257925
201708,2017,7호선,하계,480829,106241,587070
201708,2017,7호선,강남구청,386975,45642,432617
201708,2017,8호선,가락시장,155672,50032,205704
201708,2017,8호선,천호(풍납토성),457326,92150,549476
201708,2017,8호선,남한산성입구(성남법원.검찰청),339532,73316,412848
201708,2017,8호선,단대오거리,271582,65984,337566
201708,2017,8호선,모란,86646,51771,138417
201708,2017,8호선,몽촌토성(평화의문),153665,40309,193974
201708,2017,8호선,문정,362830,45855,408685
201708,2017,8호선,복정,261614,42852,304466
201708,2017,8호선,산성,153501,38066,191567
201708,2017,8호선,석촌,195761,56836,252597
201708,2017,8호선,송파,127167,34569,161736
201708,2017,8호선,수진,115815,45792,161607
201708,2017,8호선,신흥,100780,43938,144718
201708,2017,8호선,암사,451072,91598,542670
201708,2017,8호선,잠실(송파구청),350283,66977,417260
201708,2017,8호선,장지,446878,64806,511684
201708,2017,8호선,강동구청,251853,60461,312314
201708,2017,9호선,가양,502305,120344,622649
201708,2017,9호선,개화,162117,33811,195928
201708,2017,9호선,고속터미널,362941,48916,411857
201708,2017,9호선,공항시장,66971,21847,88818
201708,2017,9호선,구반포,73142,22616,95758
201708,2017,9호선,국회의사당,415886,52362,468248
201708,2017,9호선,김포공항,280039,21854,301893
201708,2017,9호선,노들,111669,29601,141270
201708,2017,9호선,노량진,772753,83186,855939
201708,2017,9호선,당산,471323,59984,531307
201708,2017,9호선,동작(현충원),43632,13232,56864
201708,2017,9호선,등촌,238984,78933,317917
201708,2017,9호선,마곡나루,139028,11796,150824
201708,2017,9호선,사평,66561,13636,80197
201708,2017,9호선,샛강,130051,25277,155328
201708,2017,9호선,선유도,174819,25685,200504
201708,2017,9호선,신논현,852342,50690,903032
201708,2017,9호선,신목동,101354,17188,118542
201708,2017,9호선,신반포,83058,22921,105979
201708,2017,9호선,신방화,200483,44423,244906
201708,2017,중앙선,지평,1110,745,1855
201708,2017,중앙선,팔당,24118,9078,33196
201708,2017,중앙선,국수,18709,10598,29307
201708,2017,공항철도 1호선,계양,294876,30593,325469
201708,2017,공항철도 1호선,공덕,47046,6051,53097
201708,2017,공항철도 1호선,공항화물청사,68560,8178,76738
201708,2017,경춘선,퇴계원,79982,24736,104718
201708,2017,경춘선,신내,14993,7941,22934
201708,2017,경춘선,금곡,31213,14167,45380
201708,2017,경춘선,대성리,30232,6172,36404
201708,2017,경춘선,상천,9215,5317,14532
201708,2017,경춘선,사릉,87465,20026,107491
201708,2017,경춘선,별내,57391,16666,74057
201708,2017,경춘선,김유정,15360,3728,19088
201708,2017,경춘선,백양리,4756,1508,6264
201708,2017,경춘선,남춘천,69688,26806,96494
201708,2017,경춘선,마석,84767,32933,117700
201708,2017,분당선,복정,2,0,2
201708,2017,분당선,보정,57107,23863,80970
201708,2017,분당선,미금,465522,121791,587313
201708,2017,분당선,모란,515256,158371,673627
201708,2017,분당선,매탄권선,115498,14492,129990
201708,2017,분당선,매교,68336,18223,86559
201708,2017,분당선,망포,339459,29397,368856
201708,2017,분당선,도곡,155557,36757,192314
201708,2017,분당선,대모산입구,67178,28667,95845
201708,2017,분당선,기흥,193096,31832,224928
201708,2017,분당선,구성,109259,37793,147052
201708,2017,분당선,구룡,46337,18413,64750
201708,2017,분당선,개포동,84112,21443,105555
201708,2017,분당선,한티,376325,67606,443931
201708,2017,분당선,가천대,166827,24609,191436
201708,2017,과천선,과천,104686,32959,137645
201708,2017,경춘선,가평,91701,16203,107904
201708,2017,과천선,경마공원,145401,58774,204175
201708,2017,과천선,선바위,226564,31786,258350
201708,2017,과천선,정부과천청사,309345,66859,376204
201708,2017,과천선,대공원,109636,36133,145769
201708,2017,과천선,평촌,427569,63744,491313
201708,2017,과천선,인덕원,646944,99179,746123
201708,2017,과천선,범계,769588,105984,875572
201708,2017,공항철도 1호선,김포공항,307596,18774,326370
201708,2017,공항철도 1호선,디지털미디어시티,331973,21789,353762
201708,2017,공항철도 1호선,인천국제공항,545461,59577,605038
201708,2017,공항철도 1호선,청라국제도시,151141,8906,160047
201708,2017,공항철도 1호선,홍대입구,265509,16709,282218
201708,2017,공항철도 1호선,서울역,314632,28846,343478
201708,2017,공항철도 1호선,영종,44931,12307,57238
201708,2017,공항철도 1호선,운서,150357,23862,174219
201708,2017,공항철도 1호선,검암,246378,23644,270022
201708,2017,분당선,상갈,126208,30453,156661
201708,2017,분당선,서울숲,192553,22322,214875
201708,2017,분당선,서현,702060,128982,831042
201708,2017,분당선,선릉,228590,26652,255242
201708,2017,분당선,선정릉,189959,35990,225949
201708,2017,분당선,수내,344058,80104,424162
201708,2017,분당선,수서,345792,60493,406285
201708,2017,분당선,수원,260744,28108,288852
201708,2017,분당선,수원시청,292835,34090,326925
201708,2017,분당선,신갈,106869,30531,137400
201708,2017,분당선,압구정로데오,404084,37390,441474
201708,2017,분당선,야탑,689950,158503,848453
201708,2017,분당선,영통,231966,26704,258670
201708,2017,분당선,오리,340637,92664,433301
201708,2017,분당선,이매,137481,37798,175279
201708,2017,분당선,정자,429312,78273,507585
201708,2017,분당선,죽전,386722,80427,467149
201708,2017,분당선,청명,105938,16909,122847
201708,2017,분당선,태평,349692,90829,440521
201708,2017,분당선,강남구청,212367,37642,250009
201708,2017,수인선,남동인더스파크,56075,6460,62535
201708,2017,수인선,달월,2386,1427,3813
201708,2017,수인선,소래포구,99720,51915,151635
201708,2017,수인선,송도,66789,20979,87768
201708,2017,수인선,숭의,71474,24814,96288
201708,2017,수인선,신포,42902,12146,55048
201708,2017,수인선,호구포,88425,18338,106763
201708,2017,수인선,원인재,114665,27137,141802
201708,2017,수인선,월곶,68016,15129,83145
201708,2017,수인선,인천,25249,12474,37723
201708,2017,수인선,인천논현,156129,33613,189742
201708,2017,수인선,인하대,136999,22276,159275
201708,2017,수인선,연수,126015,27450,153465
201708,2017,안산선,고잔,228874,33539,262413
201708,2017,안산선,대야미,99243,25084,124327
201708,2017,안산선,반월,115741,30340,146081
201708,2017,안산선,산본,442106,101716,543822
201708,2017,안산선,상록수,532838,83764,616602
201708,2017,안산선,수리산,101443,33722,135165
201708,2017,안산선,한대앞,223188,39356,262544
201708,2017,안산선,안산,469590,44154,513744
201708,2017,안산선,오이도,234819,40725,275544
201708,2017,안산선,정왕,218732,24030,242762
201708,2017,안산선,중앙,450843,56143,506986
201708,2017,안산선,초지,101322,14961,116283
201708,2017,안산선,신길온천,43063,10782,53845
201708,2017,일산선,대곡,37606,11969,49575
201708,2017,일산선,화정,461932,132879,594811
201708,2017,일산선,마두,172959,76500,249459
201708,2017,일산선,대화,351902,97586,449488
201708,2017,일산선,주엽,205241,101470,306711
201708,2017,일산선,정발산,213764,60882,274646
201708,2017,일산선,원흥,181192,40282,221474
201708,2017,일산선,원당,271910,84992,356902
201708,2017,일산선,삼송,415580,88549,504129
201708,2017,일산선,백석,278300,79545,357845
201708,2017,장항선,쌍용(나사렛대),53234,15671,68905
201708,2017,장항선,신창(순천향대),38985,9124,48109
201708,2017,장항선,온양온천,89585,57633,147218
201708,2017,장항선,봉명,27895,14891,42786
201708,2017,장항선,아산,73280,9106,82386
201708,2017,장항선,배방,24855,8205,33060
201708,2017,중앙선,구리,330741,83194,413935
201708,2017,중앙선,회기,684776,128296,813072
201708,2017,중앙선,덕소,147194,52960,200154
201708,2017,중앙선,도농,214196,57499,271695
201708,2017,중앙선,도심,63151,22357,85508
201708,2017,중앙선,망우,191876,71597,263473
201708,2017,중앙선,상봉(시외버스터미널),148787,38906,187693
201708,2017,중앙선,신원,4644,3221,7865
201708,2017,중앙선,아신,17657,7112,24769
201708,2017,중앙선,양수,49193,21489,70682
201708,2017,중앙선,양원,37939,17004,54943
201708,2017,중앙선,양정,17792,8751,26543
201708,2017,중앙선,양평,87310,35846,123156
201708,2017,중앙선,오빈,7268,4228,11496
201708,2017,중앙선,용문,61061,61425,122486
201708,2017,중앙선,운길산,20517,8670,29187
201708,2017,중앙선,원덕,8082,6015,14097
201708,2017,중앙선,중랑,132071,53416,185487
201707,2017,중앙선,양원,40303,16856,57159
201707,2017,5호선,길동,170326,59608,229934
201707,2017,5호선,김포공항,214382,31146,245528
201707,2017,5호선,까치산,748256,152427,900683
201707,2017,5호선,답십리,402313,82901,485214
201707,2017,5호선,동대문역사문화공원,74510,10980,85490
201707,2017,5호선,둔촌동,294503,76244,370747
201707,2017,5호선,마곡,157431,23348,180779
201707,2017,5호선,마장,136700,42765,179465
201707,2017,5호선,마천,106707,46967,153674
201707,2017,5호선,마포,351527,62419,413946
201707,2017,5호선,명일,183094,60306,243400
201707,2017,5호선,목동,466651,82255,548906
201707,2017,5호선,발산,347527,63051,410578
201707,2017,5호선,방이,169531,41645,211176
201707,2017,5호선,방화,179489,47551,227040
201707,2017,5호선,상일동,283824,60094,343918
201707,2017,5호선,서대문,425976,67819,493795
201707,2017,5호선,송정,215593,61065,276658
201707,2017,5호선,신금호,142610,35256,177866
201707,2017,5호선,신길,80892,12487,93379
201707,2017,5호선,신정(은행정),375930,58607,434537
201707,2017,5호선,아차산(어린이대공원후문),349555,87569,437124
201707,2017,5호선,애오개,177906,39468,217374
201707,2017,5호선,양평,159812,27303,187115
201707,2017,5호선,여의나루,260048,29185,289233
201707,2017,5호선,여의도,614220,50911,665131
201707,2017,5호선,영등포구청,83451,19255,102706
201707,2017,5호선,영등포시장,181057,73110,254167
201707,2017,5호선,오금,90317,16533,106850
201707,2017,5호선,오목교(목동운동장앞),663981,84456,748437
201707,2017,5호선,올림픽공원(한국체대),144713,33231,177944
201707,2017,5호선,왕십리(성동구청),129001,25004,154005
201707,2017,5호선,우장산,388609,78957,467566
201707,2017,5호선,을지로4가,103432,40652,144084
201707,2017,5호선,장한평,456465,95921,552386
201707,2017,5호선,종로3가,319986,122234,442220
201707,2017,5호선,천호(풍납토성),476740,147452,624192
201707,2017,5호선,청구,95789,26822,122611
201707,2017,5호선,충정로(경기대입구),111901,18107,130008
201707,2017,5호선,행당,204288,46766,251054
201707,2017,5호선,개롱,161800,44135,205935
201707,2017,6호선,고려대(종암),235125,32548,267673
201707,2017,6호선,효창공원앞,172191,39999,212190
201707,2017,6호선,광흥창(서강),232056,55577,287633
201707,2017,6호선,구산,193922,56157,250079
201707,2017,6호선,녹사평(용산구청),199411,20127,219538
201707,2017,6호선,대흥(서강대앞),197932,44236,242168
201707,2017,6호선,독바위,68668,20639,89307
201707,2017,6호선,돌곶이,219690,62083,281773
201707,2017,6호선,동묘앞,200699,62677,263376
201707,2017,6호선,디지털미디어시티,355208,56083,411291
201707,2017,6호선,마포구청,327656,78193,405849
201707,2017,6호선,망원,327465,81076,408541
201707,2017,6호선,버티고개,57217,14108,71325
201707,2017,6호선,보문,216298,36678,252976
201707,2017,6호선,봉화산(서울의료원),226576,51391,277967
201707,2017,6호선,불광,133354,43239,176593
201707,2017,6호선,삼각지,194790,19888,214678
201707,2017,6호선,상수,305152,22838,327990
201707,2017,6호선,상월곡(한국과학기술연구원),133669,37589,171258
201707,2017,6호선,새절(신사),306259,84920,391179
201707,2017,6호선,석계,310049,73573,383622
201707,2017,6호선,신당,209050,39282,248332
201707,2017,6호선,안암(고대병원앞),339093,30835,369928
201707,2017,6호선,약수,85392,23417,108809
201707,2017,6호선,역촌,84116,35802,119918
201707,2017,6호선,연신내,18,1,19
201707,2017,6호선,월곡(동덕여대),295676,69590,365266
201707,2017,6호선,월드컵경기장(성산),167633,50502,218135
201707,2017,6호선,응암,424975,108384,533359
201707,2017,6호선,이태원,472828,33687,506515
201707,2017,6호선,증산(명지대앞),247388,68660,316048
201707,2017,6호선,창신,87788,17433,105221
201707,2017,6호선,청구,96124,18716,114840
201707,2017,6호선,태릉입구,127270,26003,153273
201707,2017,6호선,한강진,188725,13703,202428
201707,2017,6호선,합정,415274,39116,454390
201707,2017,6호선,화랑대(서울여대입구),330234,45068,375302
201707,2017,6호선,공덕,461483,69467,530950
201707,2017,7호선,가산디지털단지,1109127,71809,1180936
201707,2017,7호선,학동,563573,57283,620856
201707,2017,7호선,건대입구,433628,52073,485701
201707,2017,7호선,고속터미널,555361,77110,632471
201707,2017,7호선,공릉(서울과학기술대),307855,65775,373630
201707,2017,7호선,광명사거리,658830,147027,805857
201707,2017,7호선,군자(능동),363270,76231,439501
201707,2017,7호선,굴포천,240026,32269,272295
201707,2017,7호선,까치울,178455,24843,203298
201707,2017,7호선,남구로,425540,57949,483489
201707,2017,7호선,남성,280967,68786,349753
201707,2017,7호선,내방,362153,62537,424690
201707,2017,7호선,노원,527351,114058,641409
201707,2017,7호선,논현,533276,51125,584401
201707,2017,7호선,대림(구로구청),289807,35132,324939
201707,2017,7호선,도봉산,224536,39564,264100
201707,2017,7호선,뚝섬유원지,227169,44012,271181
201707,2017,7호선,마들,284898,74340,359238
201707,2017,7호선,먹골,263107,58625,321732
201707,2017,7호선,면목,374369,84112,458481
201707,2017,7호선,반포,159472,30727,190199
201707,2017,7호선,보라매,235918,41284,277202
201707,2017,7호선,부천시청,343915,47347,391262
201707,2017,7호선,부천종합운동장,135967,17258,153225
201707,2017,7호선,부평구청,320829,29949,350778
201707,2017,7호선,사가정,382278,91463,473741
201707,2017,7호선,삼산체육관,144650,24897,169547
201707,2017,7호선,상도,266706,59645,326351
201707,2017,7호선,상동,380048,44450,424498
201707,2017,7호선,상봉(시외버스터미널),440717,69046,509763
201707,2017,7호선,수락산,333647,88760,422407
201707,2017,7호선,숭실대입구(살피재),336988,56306,393294
201707,2017,7호선,신대방삼거리,394263,92557,486820
201707,2017,7호선,신중동,381280,47822,429102
201707,2017,7호선,신풍,281118,68659,349777
201707,2017,7호선,어린이대공원(세종대),353294,43753,397047
201707,2017,7호선,온수(성공회대입구),272482,34523,307005
201707,2017,7호선,용마산,157357,34932,192289
201707,2017,7호선,이수,430588,76433,507021
201707,2017,7호선,장승배기,260424,78805,339229
201707,2017,7호선,장암,70180,10540,80720
201707,2017,7호선,중계,377533,91170,468703
201707,2017,7호선,중곡,244702,59313,304015
201707,2017,7호선,중화,274723,58787,333510
201707,2017,7호선,천왕,209664,44746,254410
201707,2017,7호선,철산,630461,99359,729820
201707,2017,7호선,청담,538044,72469,610513
201707,2017,7호선,춘의,229686,27358,257044
201707,2017,7호선,태릉입구,218695,39063,257758
201707,2017,7호선,하계,493929,105044,598973
201707,2017,7호선,강남구청,387323,45460,432783
201707,2017,8호선,가락시장,158251,47400,205651
201707,2017,8호선,천호(풍납토성),467404,90626,558030
201707,2017,8호선,남한산성입구(성남법원.검찰청),336667,71378,408045
201707,2017,8호선,단대오거리,271464,65170,336634
201707,2017,8호선,모란,88784,49281,138065
201707,2017,8호선,몽촌토성(평화의문),152476,38749,191225
201707,2017,8호선,문정,365074,44481,409555
201707,2017,8호선,복정,255129,41133,296262
201707,2017,8호선,산성,150868,34088,184956
201707,2017,8호선,석촌,202474,56827,259301
201707,2017,8호선,송파,132743,34929,167672
201707,2017,8호선,수진,119367,44648,164015
201707,2017,8호선,신흥,103425,43893,147318
201707,2017,8호선,암사,456221,89326,545547
201707,2017,8호선,잠실(송파구청),351266,64005,415271
201707,2017,8호선,장지,459853,64447,524300
201707,2017,8호선,강동구청,256867,60177,317044
201707,2017,9호선,가양,512655,118817,631472
201707,2017,9호선,개화,161732,34039,195771
201707,2017,9호선,고속터미널,363928,49179,413107
201707,2017,9호선,공항시장,67618,20932,88550
201707,2017,9호선,구반포,73157,23237,96394
201707,2017,9호선,국회의사당,420476,53310,473786
201707,2017,9호선,김포공항,277144,20362,297506
201707,2017,9호선,노들,114358,29744,144102
201707,2017,9호선,노량진,780728,79061,859789
201707,2017,9호선,당산,474876,60529,535405
201707,2017,9호선,동작(현충원),43818,11577,55395
201707,2017,9호선,등촌,236211,77731,313942
201707,2017,9호선,마곡나루,133523,11340,144863
201707,2017,9호선,사평,68341,14181,82522
201707,2017,9호선,샛강,132131,25032,157163
201707,2017,9호선,선유도,176794,25873,202667
201707,2017,9호선,신논현,867015,50352,917367
201707,2017,9호선,신목동,103751,17134,120885
201707,2017,9호선,신반포,85220,23099,108319
201707,2017,9호선,신방화,205778,43989,249767
201707,2017,9호선,양천향교,197705,38281,235986
201707,2017,9호선,여의도,540647,40886,581533
201707,2017,9호선,염창,421641,58710,480351
201707,2017,9호선,증미,171986,42212,214198
201707,2017,9호선,흑석(중앙대입구),213423,50448,263871
201707,2017,9호선2단계,봉은사,384585,37289,421874
201707,2017,9호선2단계,삼성중앙,129806,18921,148727
201707,2017,9호선2단계,종합운동장,175347,14746,190093
201707,2017,9호선2단계,언주,221975,23650,245625
201707,2017,9호선2단계,선정릉,186899,18469,205368
201707,2017,경강선,초월,58387,9479,67866
201707,2017,경강선,판교,79928,9881,89809
201707,2017,경강선,부발,41367,5855,47222
201707,2017,경강선,삼동,35874,6279,42153
201707,2017,경강선,세종대왕릉,5210,2664,7874
201707,2017,경강선,곤지암,44887,10651,55538
201707,2017,경강선,여주,42753,14790,57543
201707,2017,경강선,이매,35737,8435,44172
201707,2017,경강선,이천,60677,10440,71117
201707,2017,경강선,경기광주,141305,19510,160815
201707,2017,경강선,신둔도예촌,24175,5307,29482
201707,2017,경부선,지제,46820,5852,52672
201707,2017,경부선,명학,243900,41795,285695
201707,2017,경부선,진위,42047,7861,49908
201707,2017,경부선,천안,150826,59554,210380
201707,2017,경부선,평택,344770,67413,412183
201707,2017,경부선,화서,202383,39447,241830
201707,2017,경부선,병점,366073,56521,422594
201707,2017,경부선,서동탄,38834,9000,47834
201707,2017,경부선,서울역,166933,11066,177999
201707,2017,경부선,서정리,116746,27396,144142
201707,2017,경부선,석수,288985,46594,335579
201707,2017,경부선,성균관대,382844,46750,429594
201707,2017,경부선,성환,87293,20626,107919
201707,2017,경부선,세류,106749,19496,126245
201707,2017,경부선,세마,65347,12891,78238
201707,2017,경부선,송탄,124380,23725,148105
201707,2017,경부선,수원,1131904,142475,1274379
201707,2017,경부선,신길,262216,46078,308294
201707,2017,경부선,신도림,96954,21813,118767
201707,2017,경부선,안양,642475,112693,755168
201707,2017,경부선,영등포,1224018,284301,1508319
201707,2017,경부선,오산,259895,41504,301399
201707,2017,경부선,오산대,62969,13950,76919
201707,2017,경부선,용산,1071126,130491,1201617
201707,2017,경부선,의왕,215635,37714,253349
201707,2017,경부선,가산디지털단지,435321,28914,464235
201707,2017,경부선,관악,199515,52698,252213
201707,2017,경부선,광명,45438,3715,49153
201707,2017,경부선,구로,535679,90652,626331
201707,2017,경부선,군포,186927,33498,220425
201707,2017,경부선,금정,715991,103021,819012
201707,2017,경부선,금천구청,266641,72131,338772
201707,2017,경부선,남영,276628,38830,315458
201707,2017,경부선,노량진,409567,42451,452018
201707,2017,경부선,당정,176428,30208,206636
201707,2017,경부선,대방,385502,71965,457467
201707,2017,경부선,독산,415509,63485,478994
201707,2017,경부선,두정,137315,22992,160307
201707,2017,경부선,직산,22800,5492,28292
201707,2017,경원선,지행,173234,45972,219206
201707,2017,경원선,방학,204219,102192,306411
201707,2017,경원선,청량리(서울시립대입구),318297,137232,455529
201707,2017,경원선,한남,104639,33106,137745
201707,2017,경원선,회룡,250959,137132,388091
201707,2017,경원선,보산,41025,15390,56415
201707,2017,경원선,서빙고,50477,15940,66417
201707,2017,경원선,석계,252112,64027,316139
201707,2017,경원선,소요산,59951,87647,147598
201707,2017,경원선,신이문,226456,65832,292288
201707,2017,경원선,양주,219577,53447,273024
201707,2017,경원선,옥수,1425,107,1532
201707,2017,경원선,왕십리(성동구청),456474,61755,518229
201707,2017,경원선,외대앞,284619,56013,340632
201707,2017,경원선,월계,104199,54267,158466
201707,2017,경원선,응봉,41127,18844,59971
201707,2017,경원선,의정부,534675,120954,655629
201707,2017,경원선,이촌(국립중앙박물관),109627,29205,138832
201707,2017,경원선,가능,165952,61938,227890
201707,2017,경원선,광운대,214799,54521,269320
201707,2017,경원선,녹양,114485,33681,148166
201707,2017,경원선,녹천,119792,40163,159955
201707,2017,경원선,덕계,49003,18071,67074
201707,2017,경원선,덕정,158725,35261,193986
201707,2017,경원선,도봉,129689,69675,199364
201707,2017,경원선,도봉산,157699,85487,243186
201707,2017,경원선,동두천,46101,19743,65844
201707,2017,경원선,동두천중앙,81515,38339,119854
201707,2017,경원선,망월사,166581,69851,236432
201707,2017,경원선,창동,3,0,3
201707,2017,경의선,일산,223544,56063,279607
201707,2017,경의선,백마,167673,32050,199723
201707,2017,경의선,파주,32217,7687,39904
201707,2017,경의선,풍산,114024,28980,143004
201707,2017,경의선,행신,194041,35288,229329
201707,2017,경의선,홍대입구,45810,5212,51022
201707,2017,경의선,화전,45929,10579,56508
201707,2017,경의선,효창공원앞,53549,12062,65611
201707,2017,경의선,서강대,58787,9448,68235
201707,2017,경의선,서울역,75950,11295,87245
201707,2017,경의선,수색,56109,17501,73610
201707,2017,경의선,신촌,20145,3395,23540
201707,2017,경의선,야당,91722,22499,114221
201707,2017,경의선,운정,123992,30719,154711
201707,2017,경의선,월롱,57820,8783,66603
201707,2017,경의선,가좌,100677,44167,144844
201707,2017,경의선,강매,61721,16321,78042
201707,2017,경의선,곡산,12986,5880,18866
201707,2017,경의선,공덕,73363,10946,84309
201707,2017,경의선,금릉,122528,25825,148353
201707,2017,경의선,금촌,175887,47080,222967
201707,2017,경의선,능곡,84926,29827,114753
201707,2017,경의선,디지털미디어시티,59078,10183,69261
201707,2017,경의선,문산,147947,48366,196313
201707,2017,경의선,탄현,191242,36658,227900
201707,2017,경인선,인천,94443,42866,137309
201707,2017,경인선,제물포,255687,55512,311199
201707,2017,경인선,주안,638222,98753,736975
201707,2017,경인선,중동,238566,65467,304033
201707,2017,경인선,백운,208726,66758,275484
201707,2017,경인선,부개,240836,64460,305296
201707,2017,경인선,부천,1028212,212341,1240553
201707,2017,경인선,부평,1011573,139879,1151452
201707,2017,경인선,소사,293836,82449,376285
201707,2017,경인선,송내,846418,115996,962414
201707,2017,경인선,역곡,743934,142134,886068
201707,2017,경인선,오류동,275044,85766,360810
201707,2017,경인선,온수(성공회대입구),164971,44335,209306
201707,2017,경인선,간석,158275,46654,204929
201707,2017,경인선,개봉,563599,153955,717554
201707,2017,경인선,구일,197376,35632,233008
201707,2017,경인선,도원,88121,36213,124334
201707,2017,경인선,도화,85635,38422,124057
201707,2017,경인선,동암,494659,107423,602082
201707,2017,경인선,동인천,421472,126542,548014
201707,2017,경춘선,평내호평,139071,41103,180174
201707,2017,경춘선,천마산,27993,15000,42993
201707,2017,경춘선,춘천,40333,22013,62346
201707,2017,경춘선,굴봉산,5765,2323,8088
201707,2017,경춘선,청평,68670,16866,85536
201707,2017,경춘선,강촌,16214,5010,21224
201707,2017,경춘선,갈매,42442,12218,54660
201707,2017,경춘선,가평,75634,14096,89730
201707,2017,경춘선,마석,83297,30863,114160
201707,2017,경춘선,남춘천,64047,23865,87912
201707,2017,경춘선,백양리,4148,1324,5472
201707,2017,경춘선,김유정,11720,3031,14751
201707,2017,경춘선,별내,57391,16119,73510
201707,2017,경춘선,사릉,87265,18598,105863
201707,2017,경춘선,상천,7315,4822,12137
201707,2017,경춘선,대성리,26944,5711,32655
201707,2017,경춘선,금곡,30428,15104,45532
201707,2017,경춘선,신내,15408,7696,23104
201707,2017,경춘선,퇴계원,81060,24338,105398
201707,2017,공항철도 1호선,공항화물청사,68064,8178,76242
201707,2017,공항철도 1호선,공덕,46805,5768,52573
201707,2017,공항철도 1호선,계양,291637,29853,321490
201707,2017,공항철도 1호선,검암,246811,23659,270470
201707,2017,공항철도 1호선,운서,147023,23485,170508
201707,2017,공항철도 1호선,영종,44121,12202,56323
201707,2017,공항철도 1호선,서울역,306767,28258,335025
201707,2017,공항철도 1호선,홍대입구,259577,17146,276723
201707,2017,공항철도 1호선,청라국제도시,150488,8429,158917
201707,2017,공항철도 1호선,인천국제공항,484888,51522,536410
201707,2017,공항철도 1호선,디지털미디어시티,320992,21342,342334
201707,2017,공항철도 1호선,김포공항,300340,18196,318536
201707,2017,과천선,범계,782913,105174,888087
201707,2017,과천선,인덕원,656890,97635,754525
201707,2017,과천선,평촌,433634,62462,496096
201707,2017,과천선,대공원,80358,33641,113999
201707,2017,과천선,정부과천청사,319112,65971,385083
201707,2017,과천선,선바위,232118,31918,264036
201707,2017,과천선,경마공원,178387,66653,245040
201707,2017,과천선,과천,106940,32042,138982
201707,2017,분당선,가천대,179743,23804,203547
201707,2017,분당선,한티,386983,66959,453942
201707,2017,분당선,개포동,87650,22038,109688
201707,2017,분당선,구룡,43168,17503,60671
201707,2017,분당선,구성,110598,36757,147355
201707,2017,분당선,기흥,190518,31738,222256
201707,2017,분당선,대모산입구,68528,28682,97210
201707,2017,분당선,도곡,160921,38131,199052
201707,2017,분당선,망포,346515,28999,375514
201707,2017,분당선,매교,70727,17812,88539
201707,2017,분당선,매탄권선,118008,14526,132534
201707,2017,분당선,모란,519089,148326,667415
201707,2017,분당선,미금,472264,118574,590838
201707,2017,분당선,보정,58737,23641,82378
201707,2017,분당선,복정,7,0,7
201707,2017,분당선,상갈,126266,30222,156488
201707,2017,분당선,서울숲,178738,21901,200639
201707,2017,분당선,서현,721331,127710,849041
201707,2017,분당선,선릉,233347,26433,259780
201707,2017,분당선,선정릉,193657,35212,228869
201707,2017,분당선,수내,349799,80619,430418
201707,2017,분당선,수서,356589,58116,414705
201707,2017,분당선,수원,263577,27154,290731
201707,2017,분당선,수원시청,297592,33287,330879
201707,2017,분당선,신갈,107654,30192,137846
201707,2017,분당선,압구정로데오,407619,37175,444794
201707,2017,분당선,야탑,696733,155045,851778
201707,2017,분당선,영통,234207,26209,260416
201707,2017,분당선,오리,345108,89710,434818
201707,2017,분당선,이매,139301,37260,176561
201707,2017,분당선,정자,434987,76377,511364
201707,2017,분당선,죽전,380427,78372,458799
201707,2017,분당선,청명,108489,16820,125309
201707,2017,분당선,태평,357384,88677,446061
201707,2017,분당선,강남구청,214788,37239,252027
201707,2017,수인선,남동인더스파크,58655,6095,64750
201707,2017,수인선,달월,2462,1413,3875
201707,2017,수인선,소래포구,96411,41741,138152
201707,2017,수인선,송도,69130,21819,90949
201707,2017,수인선,숭의,73748,24714,98462
201707,2017,수인선,신포,43870,12003,55873
201707,2017,수인선,호구포,90431,18034,108465
201707,2017,수인선,원인재,116498,27629,144127
201707,2017,수인선,월곶,68488,13770,82258
201707,2017,수인선,인천,22418,11182,33600
201707,2017,수인선,인천논현,160079,34193,194272
201707,2017,수인선,인하대,133109,22343,155452
201707,2017,수인선,연수,128456,29092,157548
201707,2017,안산선,고잔,231030,32698,263728
201707,2017,안산선,대야미,99501,23786,123287
201707,2017,안산선,반월,120076,29836,149912
201707,2017,안산선,산본,448492,100141,548633
201707,2017,안산선,상록수,524262,83118,607380
201707,2017,안산선,수리산,103953,33164,137117
201707,2017,안산선,한대앞,228950,39093,268043
201707,2017,안산선,안산,475640,44179,519819
201707,2017,안산선,오이도,231112,35247,266359
201707,2017,안산선,정왕,225611,23851,249462
201707,2017,안산선,중앙,446080,55034,501114
201707,2017,안산선,초지,97198,14353,111551
201707,2017,안산선,신길온천,43747,10868,54615
201707,2017,일산선,대곡,36845,11694,48539
201707,2017,일산선,화정,463190,130690,593880
201707,2017,일산선,마두,175411,75555,250966
201707,2017,일산선,대화,338128,93100,431228
201707,2017,일산선,지축,1,0,1
201707,2017,일산선,주엽,200923,99668,300591
201707,2017,일산선,정발산,216736,59134,275870
201707,2017,일산선,원흥,188570,42030,230600
201707,2017,일산선,원당,271858,84082,355940
201707,2017,일산선,백석,274814,78158,352972
201707,2017,일산선,삼송,344887,80248,425135
201707,2017,장항선,쌍용(나사렛대),50347,15237,65584
201707,2017,장항선,신창(순천향대),30217,8682,38899
201707,2017,장항선,온양온천,85695,51955,137650
201707,2017,장항선,봉명,27808,15203,43011
201707,2017,장항선,아산,67941,8599,76540
201707,2017,장항선,배방,24595,7820,32415
201707,2017,중앙선,구리,331896,81500,413396
201707,2017,중앙선,회기,695936,126110,822046
201707,2017,중앙선,덕소,147684,50998,198682
201707,2017,중앙선,도농,215748,55669,271417
201707,2017,중앙선,도심,63521,21549,85070
201707,2017,중앙선,망우,191310,69781,261091
201707,2017,중앙선,상봉(시외버스터미널),141838,37545,179383
201707,2017,중앙선,신원,4891,3619,8510
201707,2017,중앙선,아신,15993,5973,21966
201707,2017,중앙선,양수,53172,27218,80390
201707,2017,중앙선,양정,17588,8662,26250
201707,2017,중앙선,양평,83266,33258,116524
201707,2017,중앙선,오빈,6816,4050,10866
201707,2017,중앙선,용문,54033,51081,105114
201707,2017,중앙선,운길산,20122,8934,29056
201707,2017,중앙선,원덕,7798,5610,13408
201707,2017,중앙선,중랑,133828,52797,186625
201707,2017,중앙선,지평,913,704,1617
201707,2017,중앙선,팔당,22323,9076,31399
201707,2017,중앙선,국수,18720,8917,27637
201707,2017,1호선,동대문,322260,132485,454745
201707,2017,1호선,동묘앞,156934,130134,287068
201707,2017,1호선,서울역,1343644,197668,1541312
201707,2017,1호선,시청,610956,89441,700397
201707,2017,1호선,청량리(서울시립대입구),476943,327285,804228
201707,2017,1호선,제기동,278268,292021,570289
201707,2017,1호선,종각,1213479,149545,1363024
201707,2017,1호선,종로3가,711168,346276,1057444
201707,2017,1호선,종로5가,490397,261821,752218
201707,2017,1호선,신설동,339715,118029,457744
201707,2017,2호선,강남,3132653,163695,3296348
201707,2017,2호선,홍대입구,2240520,111382,2351902
201707,2017,2호선,건대입구,1219058,91808,1310866
201707,2017,2호선,교대(법원.검찰청),950848,157706,1108554
201707,2017,2호선,구로디지털단지,1726826,166332,1893158
201707,2017,2호선,구의(광진구청),597620,102852,700472
201707,2017,2호선,낙성대,809521,109164,918685
201707,2017,2호선,당산,555439,65071,620510
201707,2017,2호선,대림(구로구청),799453,112448,911901
201707,2017,2호선,도림천,27750,6313,34063
201707,2017,2호선,동대문역사문화공원,509108,59033,568141
201707,2017,2호선,뚝섬,414424,62803,477227
201707,2017,2호선,문래,486950,82336,569286
201707,2017,2호선,방배,486203,78865,565068
201707,2017,2호선,봉천,567814,149090,716904
201707,2017,2호선,사당,1036285,187164,1223449
201707,2017,2호선,삼성(무역센터),1688977,123549,1812526
201707,2017,2호선,상왕십리,332129,65874,398003
201707,2017,2호선,서울대입구(관악구청),1398282,209899,1608181
201707,2017,2호선,서초,594889,79630,674519
201707,2017,2호선,선릉,1446396,197817,1644213
201707,2017,2호선,성수,690943,97188,788131
201707,2017,2호선,시청,654466,56065,710531
201707,2017,2호선,신답,30558,9989,40547
201707,2017,2호선,신당,343757,104543,448300
201707,2017,2호선,신대방,731586,130249,861835
201707,2017,2호선,신도림,1627372,203130,1830502
201707,2017,2호선,신림,1889520,234868,2124388
201707,2017,2호선,신설동,83882,32718,116600
201707,2017,2호선,신정네거리,225657,64218,289875
201707,2017,2호선,신촌,1399536,139962,1539498
201707,2017,2호선,아현,242025,63781,305806
201707,2017,2호선,양천구청,158041,43455,201496
201707,2017,2호선,역삼,1239582,151077,1390659
201707,2017,2호선,영등포구청,539566,107831,647397
201707,2017,2호선,왕십리(성동구청),530383,56932,587315
201707,2017,2호선,용답,61712,16378,78090
201707,2017,2호선,용두(동대문구청),47210,22296,69506
201707,2017,2호선,을지로3가,516019,85704,601723
201707,2017,2호선,을지로4가,273762,90274,364036
201707,2017,2호선,을지로입구,1299176,112377,1411553
201707,2017,2호선,이대,483767,71729,555496
201707,2017,2호선,잠실(송파구청),2451032,220941,2671973
201707,2017,2호선,잠실나루,434740,85642,520382
201707,2017,2호선,잠실새내,688795,115336,804131
201707,2017,2호선,종합운동장,442483,55761,498244
201707,2017,2호선,충정로(경기대입구),290257,50762,341019
201707,2017,2호선,한양대,252192,14443,266635
201707,2017,2호선,합정,924008,70080,994088
201707,2017,2호선,강변(동서울터미널),1290894,136962,1427856
201707,2017,3호선,가락시장,230213,68115,298328
201707,2017,3호선,홍제,429598,146130,575728
201707,2017,3호선,경찰병원,185690,38177,223867
201707,2017,3호선,고속터미널,1679332,186739,1866071
201707,2017,3호선,교대(법원.검찰청),369843,66194,436037
201707,2017,3호선,구파발,514512,99967,614479
201707,2017,3호선,금호,204478,54957,259435
201707,2017,3호선,남부터미널(예술의전당),919112,121753,1040865
201707,2017,3호선,녹번,318556,64542,383098
201707,2017,3호선,대청,254913,54535,309448
201707,2017,3호선,대치,319541,59720,379261
201707,2017,3호선,도곡,172156,28468,200624
201707,2017,3호선,독립문,163499,69717,233216
201707,2017,3호선,동대입구,268561,35422,303983
201707,2017,3호선,매봉,283119,54505,337624
201707,2017,3호선,무악재,92394,32840,125234
201707,2017,3호선,불광,427816,150886,578702
201707,2017,3호선,수서,427990,93970,521960
201707,2017,3호선,신사,863023,67532,930555
201707,2017,3호선,안국,621266,125658,746924
201707,2017,3호선,압구정,896485,140258,1036743
201707,2017,3호선,약수,344190,83225,427415
201707,2017,3호선,양재(서초구청),1025021,160384,1185405
201707,2017,3호선,연신내,1019676,258753,1278429
201707,2017,3호선,오금,178535,26425,204960
201707,2017,3호선,옥수,245082,59058,304140
201707,2017,3호선,을지로3가,226023,59260,285283
201707,2017,3호선,일원,204452,54188,258640
201707,2017,3호선,잠원,147876,33990,181866
201707,2017,3호선,종로3가,221830,54541,276371
201707,2017,3호선,지축,22342,10118,32460
201707,2017,3호선,충무로,29,2,31
201707,2017,3호선,학여울,65418,13463,78881
201707,2017,3호선,경복궁(정부서울청사),604861,85558,690419
201707,2017,4호선,길음,624130,141187,765317
201707,2017,4호선,회현(남대문시장),690312,213628,903940
201707,2017,4호선,노원,596448,91240,687688
201707,2017,4호선,당고개,308032,95667,403699
201707,2017,4호선,동대문,604927,157276,762203
201707,2017,4호선,동대문역사문화공원,644998,63167,708165
201707,2017,4호선,동작(현충원),53230,19364,72594
201707,2017,4호선,명동,1037573,67931,1105504
201707,2017,4호선,미아(서울사이버대학),431138,129230,560368
201707,2017,4호선,미아사거리,800367,190279,990646
201707,2017,4호선,사당,780479,89817,870296
201707,2017,4호선,삼각지,120697,32484,153181
201707,2017,4호선,상계,535316,117144,652460
201707,2017,4호선,서울역,324137,38286,362423
201707,2017,4호선,성신여대입구(돈암),666891,104242,771133
201707,2017,4호선,수유(강북구청),1087638,252449,1340087
201707,2017,4호선,숙대입구(갈월),410248,57881,468129
201707,2017,4호선,신용산,349639,46956,396595
201707,2017,4호선,쌍문,849207,168036,1017243
201707,2017,4호선,이촌(국립중앙박물관),246725,45302,292027
201707,2017,4호선,창동,706116,184923,891039
201707,2017,4호선,총신대입구(이수),512135,137694,649829
201707,2017,4호선,충무로,786282,124140,910422
201707,2017,4호선,한성대입구(삼선교),383343,76541,459884
201707,2017,4호선,혜화,1104006,129033,1233039
201707,2017,4호선,남태령,64529,9159,73688
201707,2017,5호선,강동,463135,92392,555527
201707,2017,5호선,화곡,747353,137768,885121
201707,2017,5호선,개화산,142819,35016,177835
201707,2017,5호선,거여,152794,49708,202502
201707,2017,5호선,고덕,229921,61083,291004
201707,2017,5호선,공덕,349728,44258,393986
201707,2017,5호선,광나루(장신대),348770,60847,409617
201707,2017,5호선,광화문(세종문화회관),985589,76556,1062145
201707,2017,5호선,군자(능동),292554,37382,329936
201707,2017,5호선,굽은다리(강동구민회관앞),238399,62368,300767
201706,2017,2호선,서초,595157,85879,681036
201706,2017,2호선,선릉,1427616,205843,1633459
201706,2017,2호선,성수,697205,101447,798652
201706,2017,2호선,시청,642845,59661,702506
201706,2017,2호선,신답,31848,11124,42972
201706,2017,2호선,신당,352620,108443,461063
201706,2017,2호선,신대방,736745,136523,873268
201706,2017,2호선,신도림,1643079,207708,1850787
201706,2017,2호선,신림,1897878,247362,2145240
201706,2017,2호선,신설동,83075,33824,116899
201706,2017,2호선,신정네거리,231244,66408,297652
201706,2017,2호선,신촌,1307798,145039,1452837
201706,2017,2호선,아현,249675,64452,314127
201706,2017,2호선,양천구청,164361,46855,211216
201706,2017,2호선,역삼,1207795,161145,1368940
201706,2017,2호선,영등포구청,553552,111863,665415
201706,2017,2호선,왕십리(성동구청),548452,59546,607998
201706,2017,2호선,용답,63341,17036,80377
201706,2017,2호선,용두(동대문구청),46227,22697,68924
201706,2017,2호선,을지로3가,505688,89824,595512
201706,2017,2호선,을지로4가,282222,94044,376266
201706,2017,2호선,을지로입구,1317436,114500,1431936
201706,2017,2호선,이대,536203,73586,609789
201706,2017,2호선,잠실(송파구청),2351004,229515,2580519
201706,2017,2호선,잠실나루,444349,90907,535256
201706,2017,2호선,잠실새내,681874,120718,802592
201706,2017,2호선,종합운동장,509904,60092,569996
201706,2017,2호선,충정로(경기대입구),302138,54213,356351
201706,2017,2호선,한양대,329283,16618,345901
201706,2017,2호선,합정,935978,74411,1010389
201706,2017,2호선,강변(동서울터미널),1290807,148284,1439091
201706,2017,3호선,가락시장,234119,71979,306098
201706,2017,3호선,홍제,453491,153332,606823
201706,2017,3호선,경찰병원,191921,39746,231667
201706,2017,3호선,고속터미널,1597859,186731,1784590
201706,2017,3호선,교대(법원.검찰청),380748,72094,452842
201706,2017,3호선,구파발,516218,101856,618074
201706,2017,3호선,금호,210426,57385,267811
201706,2017,3호선,남부터미널(예술의전당),914141,132836,1046977
201706,2017,3호선,녹번,327524,68708,396232
201706,2017,3호선,대청,260976,53555,314531
201706,2017,3호선,대치,313618,62463,376081
201706,2017,3호선,도곡,180538,30620,211158
201706,2017,3호선,독립문,172443,75272,247715
201706,2017,3호선,동대입구,315634,43466,359100
201706,2017,3호선,매봉,292973,58018,350991
201706,2017,3호선,무악재,95239,34292,129531
201706,2017,3호선,불광,444781,153980,598761
201706,2017,3호선,수서,422446,99999,522445
201706,2017,3호선,신사,853356,72476,925832
201706,2017,3호선,안국,639408,130383,769791
201706,2017,3호선,압구정,882983,151101,1034084
201706,2017,3호선,약수,350889,87437,438326
201706,2017,3호선,양재(서초구청),1065393,168783,1234176
201706,2017,3호선,연신내,1039557,268939,1308496
201706,2017,3호선,오금,185871,28117,213988
201706,2017,과천선,인덕원,687303,107497,794800
201706,2017,과천선,평촌,440514,65197,505711
201706,2017,과천선,대공원,143518,55196,198714
201706,2017,과천선,정부과천청사,312455,64999,377454
201706,2017,과천선,선바위,244812,35137,279949
201706,2017,과천선,경마공원,159604,63857,223461
201706,2017,과천선,과천,112914,33675,146589
201706,2017,분당선,가천대,273504,25257,298761
201706,2017,분당선,한티,357631,70177,427808
201706,2017,분당선,개포동,88963,22838,111801
201706,2017,분당선,구룡,49292,18786,68078
201706,2017,분당선,구성,111781,41255,153036
201706,2017,분당선,기흥,211767,33397,245164
201706,2017,분당선,대모산입구,72965,29333,102298
201706,2017,분당선,도곡,163309,41061,204370
201706,2017,분당선,망포,353173,30930,384103
201706,2017,분당선,매교,71818,18574,90392
201706,2017,분당선,매탄권선,122056,15678,137734
201706,2017,분당선,모란,532859,159348,692207
201706,2017,분당선,미금,471117,127050,598167
201706,2017,분당선,보정,60274,26049,86323
201706,2017,분당선,복정,3,0,3
201706,2017,분당선,상갈,129767,32315,162082
201706,2017,분당선,서울숲,200458,24792,225250
201706,2017,분당선,서현,683052,134074,817126
201706,2017,분당선,선릉,229343,27302,256645
201706,2017,분당선,선정릉,193866,37279,231145
201706,2017,분당선,수내,338706,84432,423138
201706,2017,분당선,수서,344330,61726,406056
201706,2017,분당선,수원,295799,29280,325079
201706,2017,분당선,수원시청,298694,36002,334696
201706,2017,분당선,신갈,106924,33141,140065
201706,2017,분당선,압구정로데오,400783,39496,440279
201706,2017,분당선,야탑,702719,163989,866708
201706,2017,분당선,영통,246920,27736,274656
201706,2017,분당선,오리,349176,97791,446967
201706,2017,분당선,이매,140968,40276,181244
201706,2017,분당선,정자,431407,84106,515513
201706,2017,분당선,죽전,411997,83630,495627
201706,2017,분당선,청명,111666,17618,129284
201706,2017,분당선,태평,360081,92387,452468
201706,2017,분당선,강남구청,216334,39493,255827
201706,2017,수인선,남동인더스파크,60187,6595,66782
201706,2017,수인선,달월,2412,1504,3916
201706,2017,수인선,소래포구,111337,67840,179177
201706,2017,수인선,송도,74902,24475,99377
201706,2017,수인선,숭의,77443,26794,104237
201706,2017,수인선,신포,47938,13171,61109
201706,2017,수인선,호구포,90876,18328,109204
201706,2017,수인선,원인재,129039,30530,159569
201706,2017,수인선,월곶,73423,14071,87494
201706,2017,수인선,인천,26338,11035,37373
201706,2017,수인선,인천논현,163216,34355,197571
201706,2017,수인선,인하대,156788,24132,180920
201706,2017,수인선,연수,133464,30688,164152
201706,2017,안산선,고잔,243369,37018,280387
201706,2017,안산선,대야미,105031,26214,131245
201706,2017,안산선,반월,125989,30718,156707
201706,2017,안산선,산본,461073,105844,566917
201706,2017,안산선,상록수,572826,89270,662096
201706,2017,안산선,수리산,110353,35423,145776
201706,2017,안산선,한대앞,255601,43236,298837
201706,2017,안산선,안산,473532,46222,519754
201706,2017,안산선,오이도,247260,37791,285051
201706,2017,안산선,정왕,265722,25727,291449
201706,2017,안산선,중앙,470633,61179,531812
201706,2017,안산선,초지,126038,16692,142730
201706,2017,안산선,신길온천,46614,11991,58605
201706,2017,일산선,대곡,39812,12715,52527
201706,2017,일산선,화정,472748,137563,610311
201706,2017,일산선,마두,176412,78092,254504
201706,2017,일산선,대화,360380,99184,459564
201706,2017,일산선,주엽,199543,100709,300252
201706,2017,일산선,정발산,211761,62728,274489
201706,2017,일산선,원흥,198819,45148,243967
201706,2017,일산선,원당,283287,90300,373587
201706,2017,일산선,삼송,354360,83537,437897
201706,2017,7호선,논현,534891,51277,586168
201706,2017,일산선,백석,278126,81303,359429
201706,2017,장항선,쌍용(나사렛대),70192,17831,88023
201706,2017,장항선,신창(순천향대),56230,8953,65183
201706,2017,장항선,온양온천,93361,58344,151705
201706,2017,장항선,봉명,29649,16029,45678
201706,2017,장항선,아산,82986,9857,92843
201706,2017,장항선,배방,25469,8285,33754
201706,2017,중앙선,국수,20401,10055,30456
201706,2017,중앙선,팔당,26086,9562,35648
201706,2017,중앙선,지평,1351,766,2117
201706,2017,중앙선,중랑,135267,54546,189813
201706,2017,중앙선,원덕,8289,6402,14691
201706,2017,중앙선,운길산,24603,11888,36491
201706,2017,중앙선,용문,55571,53350,108921
201706,2017,중앙선,오빈,7103,4389,11492
201706,2017,중앙선,양평,86700,37105,123805
201706,2017,중앙선,양정,18042,10133,28175
201706,2017,중앙선,양원,44193,19247,63440
201706,2017,중앙선,양수,49175,24343,73518
201706,2017,중앙선,아신,19481,6680,26161
201706,2017,중앙선,신원,5772,4704,10476
201706,2017,중앙선,상봉(시외버스터미널),143015,39474,182489
201706,2017,중앙선,망우,196245,73079,269324
201706,2017,중앙선,도심,65983,22704,88687
201706,2017,중앙선,도농,220756,60122,280878
201706,2017,중앙선,덕소,150084,51958,202042
201706,2017,중앙선,회기,763777,132779,896556
201706,2017,중앙선,구리,337096,86347,423443
201706,2017,4호선,신용산,336953,48873,385826
201706,2017,4호선,숙대입구(갈월),471596,60453,532049
201706,2017,4호선,수유(강북구청),1133367,262539,1395906
201706,2017,4호선,성신여대입구(돈암),716041,108587,824628
201706,2017,4호선,서울역,335516,40537,376053
201706,2017,4호선,상계,551685,123081,674766
201706,2017,7호선,대림(구로구청),286230,35464,321694
201706,2017,4호선,삼각지,124895,34158,159053
201706,2017,4호선,사당,810591,96856,907447
201706,2017,4호선,미아사거리,809315,194550,1003865
201706,2017,4호선,미아(서울사이버대학),455273,135200,590473
201706,2017,4호선,명동,1072206,73927,1146133
201706,2017,4호선,동작(현충원),74199,28945,103144
201706,2017,4호선,동대문역사문화공원,638869,66327,705196
201706,2017,4호선,충무로,848558,129460,978018
201706,2017,4호선,총신대입구(이수),528771,145101,673872
201706,2017,4호선,창동,725377,192584,917961
201706,2017,4호선,이촌(국립중앙박물관),244267,48291,292558
201706,2017,4호선,쌍문,872085,175652,1047737
201706,2017,4호선,동대문,612190,166195,778385
201706,2017,4호선,당고개,315760,97015,412775
201706,2017,4호선,노원,601967,93839,695806
201706,2017,4호선,회현(남대문시장),722156,236183,958339
201706,2017,4호선,길음,690295,149863,840158
201706,2017,7호선,노원,518384,115330,633714
201706,2017,7호선,내방,370376,64201,434577
201706,2017,7호선,남성,290173,70776,360949
201706,2017,7호선,남구로,427889,59751,487640
201706,2017,7호선,까치울,188821,28995,217816
201706,2017,7호선,굴포천,242622,33720,276342
201706,2017,7호선,군자(능동),366769,77305,444074
201706,2017,7호선,광명사거리,673112,149782,822894
201706,2017,7호선,공릉(서울과학기술대),328177,68226,396403
201706,2017,7호선,고속터미널,562966,81096,644062
201706,2017,7호선,건대입구,444376,52688,497064
201706,2017,7호선,학동,576081,62386,638467
201706,2017,7호선,가산디지털단지,1109111,73098,1182209
201706,2017,6호선,공덕,470427,73257,543684
201706,2017,6호선,화랑대(서울여대입구),359427,47241,406668
201706,2017,6호선,합정,422986,40636,463622
201706,2017,6호선,한강진,192306,14421,206727
201706,2017,6호선,태릉입구,134869,28161,163030
201706,2017,6호선,청구,97770,18984,116754
201706,2017,6호선,창신,92891,17777,110668
201706,2017,6호선,증산(명지대앞),255663,71271,326934
201706,2017,6호선,이태원,480781,36755,517536
201706,2017,6호선,응암,436430,112196,548626
201706,2017,6호선,월드컵경기장(성산),186209,56028,242237
201706,2017,6호선,월곡(동덕여대),324149,72780,396929
201706,2017,6호선,연신내,16,1,17
201706,2017,6호선,역촌,82853,35458,118311
201706,2017,6호선,약수,87563,23649,111212
201706,2017,6호선,안암(고대병원앞),391832,32073,423905
201706,2017,6호선,신당,218736,39432,258168
201706,2017,6호선,석계,328080,76206,404286
201706,2017,6호선,새절(신사),341097,88769,429866
201706,2017,6호선,상월곡(한국과학기술연구원),154075,39528,193603
201706,2017,6호선,상수,304281,24053,328334
201706,2017,6호선,삼각지,215876,23586,239462
201706,2017,6호선,불광,129363,42018,171381
201706,2017,6호선,봉화산(서울의료원),236714,53812,290526
201706,2017,6호선,보문,224644,38611,263255
201706,2017,6호선,버티고개,61294,14863,76157
201706,2017,6호선,망원,328524,85004,413528
201706,2017,6호선,마포구청,339493,82749,422242
201706,2017,6호선,디지털미디어시티,372209,59542,431751
201706,2017,6호선,동묘앞,206778,66019,272797
201706,2017,6호선,돌곶이,229431,63617,293048
201706,2017,6호선,독바위,69632,21411,91043
201706,2017,6호선,대흥(서강대앞),213342,45459,258801
201706,2017,6호선,녹사평(용산구청),214898,22106,237004
201706,2017,6호선,구산,198894,57600,256494
201706,2017,6호선,광흥창(서강),236371,59813,296184
201706,2017,6호선,효창공원앞,183623,42775,226398
201706,2017,6호선,고려대(종암),263782,34912,298694
201706,2017,5호선,개롱,164369,44091,208460
201706,2017,5호선,행당,209288,48915,258203
201706,2017,5호선,충정로(경기대입구),122635,18014,140649
201706,2017,5호선,청구,98709,27884,126593
201706,2017,5호선,천호(풍납토성),479018,152532,631550
201706,2017,5호선,종로3가,301609,121531,423140
201706,2017,5호선,장한평,460675,99021,559696
201706,2017,5호선,을지로4가,107815,43363,151178
201706,2017,5호선,우장산,400739,81961,482700
201706,2017,5호선,왕십리(성동구청),129178,26271,155449
201706,2017,5호선,올림픽공원(한국체대),155689,36705,192394
201706,2017,5호선,오목교(목동운동장앞),664642,86832,751474
201706,2017,5호선,오금,97715,17601,115316
201706,2017,5호선,영등포시장,183831,75796,259627
201706,2017,5호선,영등포구청,86211,20525,106736
201706,2017,5호선,여의도,619411,53191,672602
201706,2017,5호선,여의나루,324950,31775,356725
201706,2017,5호선,양평,161187,28288,189475
201706,2017,5호선,애오개,183621,41189,224810
201706,2017,5호선,아차산(어린이대공원후문),373834,96291,470125
201706,2017,5호선,신정(은행정),384768,60166,444934
201706,2017,5호선,신길,80629,12745,93374
201706,2017,5호선,신금호,147810,36636,184446
201706,2017,5호선,송정,221750,64831,286581
201706,2017,5호선,서대문,456537,70019,526556
201706,2017,5호선,상일동,294104,64117,358221
201706,2017,5호선,방화,182416,49533,231949
201706,2017,5호선,방이,176754,43037,219791
201706,2017,5호선,발산,360839,67005,427844
201706,2017,5호선,목동,480023,85029,565052
201706,2017,5호선,명일,188460,63513,251973
201706,2017,5호선,마포,357336,66163,423499
201706,2017,5호선,마천,114096,49310,163406
201706,2017,5호선,마장,145808,42300,188108
201706,2017,5호선,마곡,157911,24487,182398
201706,2017,5호선,둔촌동,312577,79816,392393
201706,2017,5호선,동대문역사문화공원,75593,10193,85786
201706,2017,5호선,답십리,411166,85648,496814
201706,2017,5호선,까치산,760836,157124,917960
201706,2017,5호선,김포공항,202071,28116,230187
201706,2017,5호선,길동,173935,60248,234183
201706,2017,5호선,굽은다리(강동구민회관앞),235767,65317,301084
201706,2017,5호선,군자(능동),299064,38996,338060
201706,2017,5호선,광화문(세종문화회관),983881,84224,1068105
201706,2017,5호선,광나루(장신대),377254,68758,446012
201706,2017,5호선,공덕,356845,46398,403243
201706,2017,5호선,고덕,236909,66181,303090
201706,2017,5호선,거여,157226,51122,208348
201706,2017,5호선,개화산,143334,36730,180064
201706,2017,7호선,뚝섬유원지,263159,46621,309780
201706,2017,7호선,마들,297509,77746,375255
201706,2017,7호선,먹골,267486,59539,327025
201706,2017,7호선,면목,411254,86502,497756
201706,2017,7호선,반포,166154,32467,198621
201706,2017,7호선,보라매,248355,43356,291711
201706,2017,7호선,부천시청,334278,48045,382323
201706,2017,7호선,부천종합운동장,145258,19582,164840
201706,2017,7호선,부평구청,332783,31157,363940
201706,2017,7호선,사가정,393773,94173,487946
201706,2017,7호선,삼산체육관,144562,25625,170187
201706,2017,7호선,상도,294382,62522,356904
201706,2017,7호선,상동,381703,47261,428964
201706,2017,7호선,상봉(시외버스터미널),455999,73835,529834
201706,2017,7호선,수락산,345851,92790,438641
201706,2017,7호선,숭실대입구(살피재),421452,59402,480854
201706,2017,7호선,신대방삼거리,402949,93694,496643
201706,2017,7호선,신중동,386620,49107,435727
201706,2017,7호선,신풍,284548,69628,354176
201706,2017,7호선,어린이대공원(세종대),450948,48052,499000
201706,2017,7호선,온수(성공회대입구),299400,35731,335131
201706,2017,7호선,용마산,160857,35963,196820
201706,2017,7호선,이수,433038,80237,513275
201706,2017,7호선,장승배기,265173,80802,345975
201706,2017,7호선,장암,69336,8954,78290
201706,2017,7호선,중계,396110,96104,492214
201706,2017,7호선,중곡,254210,62254,316464
201706,2017,7호선,중화,284548,60875,345423
201706,2017,7호선,천왕,212751,45873,258624
201706,2017,7호선,철산,643709,102297,746006
201706,2017,7호선,청담,549619,76611,626230
201706,2017,7호선,춘의,235823,29706,265529
201706,2017,7호선,태릉입구,247312,41893,289205
201706,2017,7호선,하계,515401,108350,623751
201706,2017,7호선,강남구청,396400,48879,445279
201706,2017,8호선,가락시장,165661,51228,216889
201706,2017,8호선,천호(풍납토성),472272,93371,565643
201706,2017,8호선,남한산성입구(성남법원.검찰청),368236,76042,444278
201706,2017,8호선,단대오거리,293545,69101,362646
201706,2017,8호선,모란,90649,52829,143478
201706,2017,8호선,몽촌토성(평화의문),157575,41721,199296
201706,2017,8호선,문정,351690,44536,396226
201706,2017,8호선,복정,284991,44895,329886
201706,2017,8호선,산성,165002,37126,202128
201706,2017,8호선,석촌,203264,58652,261916
201706,2017,8호선,송파,136158,36664,172822
201706,2017,8호선,수진,117553,45059,162612
201706,2017,8호선,신흥,103481,45335,148816
201706,2017,8호선,암사,462569,92563,555132
201706,2017,8호선,잠실(송파구청),331583,62562,394145
201706,2017,8호선,장지,462632,66829,529461
201706,2017,8호선,강동구청,261882,63153,325035
201706,2017,9호선,가양,518698,122991,641689
201706,2017,9호선,개화,161494,37286,198780
201706,2017,9호선,고속터미널,371423,50733,422156
201706,2017,9호선,공항시장,67645,21555,89200
201706,2017,9호선,구반포,75870,24685,100555
201706,2017,9호선,국회의사당,409847,54353,464200
201706,2017,9호선,김포공항,260158,19335,279493
201706,2017,9호선,노들,114790,30594,145384
201706,2017,9호선,노량진,769139,84957,854096
201706,2017,9호선,당산,487129,63411,550540
201706,2017,9호선,동작(현충원),66554,24120,90674
201706,2017,9호선,등촌,235375,79447,314822
201706,2017,9호선,마곡나루,129263,11499,140762
201706,2017,9호선,사평,67030,14756,81786
201706,2017,9호선,샛강,130163,26400,156563
201706,2017,9호선,선유도,179521,26301,205822
201706,2017,9호선,신논현,820717,50038,870755
201706,2017,9호선,신목동,105874,18426,124300
201706,2017,9호선,신반포,86953,25057,112010
201706,2017,9호선,신방화,209558,44282,253840
201706,2017,9호선,양천향교,201359,39467,240826
201706,2017,9호선,여의도,544303,42368,586671
201706,2017,9호선,염창,430655,61859,492514
201706,2017,9호선,증미,171435,42345,213780
201706,2017,9호선,흑석(중앙대입구),260237,52933,313170
201706,2017,9호선2단계,봉은사,346027,36408,382435
201706,2017,9호선2단계,삼성중앙,126161,18838,144999
201706,2017,9호선2단계,종합운동장,179160,15366,194526
201706,2017,9호선2단계,언주,216539,24011,240550
201706,2017,9호선2단계,선정릉,188131,19775,207906
201706,2017,경강선,초월,59181,10522,69703
201706,2017,경강선,판교,76628,9847,86475
201706,2017,경강선,부발,43542,6125,49667
201706,2017,경강선,삼동,37076,6805,43881
201706,2017,경강선,세종대왕릉,5660,3131,8791
201706,2017,경강선,곤지암,53575,13256,66831
201706,2017,경강선,여주,54812,17505,72317
201706,2017,경강선,이매,37847,9219,47066
201706,2017,경강선,이천,60748,11992,72740
201706,2017,경강선,경기광주,142317,20588,162905
201706,2017,경강선,신둔도예촌,30147,5806,35953
201706,2017,경부선,지제,47184,6430,53614
201706,2017,경부선,명학,277139,44745,321884
201706,2017,경부선,진위,44998,8663,53661
201706,2017,경부선,천안,200947,62926,263873
201706,2017,경부선,평택,380295,71007,451302
201706,2017,경부선,화서,219042,43922,262964
201706,2017,경부선,병점,428084,60740,488824
201706,2017,경부선,서동탄,40296,9337,49633
201706,2017,경부선,서울역,165989,12616,178605
201706,2017,경부선,서정리,142789,27780,170569
201706,2017,경부선,석수,312775,51111,363886
201706,2017,경부선,성균관대,431633,50996,482629
201706,2017,경부선,성환,131330,21599,152929
201706,2017,경부선,세류,112318,20024,132342
201706,2017,경부선,세마,68465,14122,82587
201706,2017,경부선,송탄,129763,25463,155226
201706,2017,경부선,수원,1164895,147568,1312463
201706,2017,경부선,신길,275590,49084,324674
201706,2017,경부선,신도림,105375,23734,129109
201706,2017,경부선,안양,755429,117946,873375
201706,2017,경부선,영등포,1192732,287429,1480161
201706,2017,경부선,오산,278811,44701,323512
201706,2017,경부선,오산대,84326,16377,100703
201706,2017,경부선,용산,995584,135082,1130666
201706,2017,경부선,의왕,232435,40929,273364
201706,2017,경부선,가산디지털단지,445795,30466,476261
201706,2017,7호선,도봉산,250160,44348,294508
201706,2017,경부선,관악,212686,56881,269567
201706,2017,경부선,광명,43708,3621,47329
201706,2017,경부선,구로,554337,95835,650172
201706,2017,경부선,군포,195902,35011,230913
201706,2017,경부선,금정,747514,109859,857373
201706,2017,경부선,금천구청,283897,78842,362739
201706,2017,경부선,남영,310486,41853,352339
201706,2017,경부선,노량진,424713,49277,473990
201706,2017,경부선,당정,202604,32338,234942
201706,2017,경부선,대방,397824,76659,474483
201706,2017,경부선,독산,425719,66985,492704
201706,2017,경부선,두정,173785,24301,198086
201706,2017,경부선,직산,23169,6054,29223
201706,2017,경원선,지행,186251,48221,234472
201706,2017,경원선,방학,212206,107687,319893
201706,2017,경원선,청량리(서울시립대입구),315818,143892,459710
201706,2017,경원선,한남,104201,34676,138877
201706,2017,경원선,회룡,262815,144422,407237
201706,2017,경원선,보산,41782,16553,58335
201706,2017,경원선,서빙고,53013,16776,69789
201706,2017,경원선,석계,264724,68274,332998
201706,2017,경원선,소요산,62369,93470,155839
201706,2017,경원선,신이문,233503,68433,301936
201706,2017,경원선,양주,232160,56634,288794
201706,2017,경원선,옥수,1550,136,1686
201706,2017,경원선,왕십리(성동구청),453242,62972,516214
201706,2017,경원선,외대앞,317783,57946,375729
201706,2017,경원선,월계,140030,56144,196174
201706,2017,경원선,응봉,43883,19573,63456
201706,2017,경원선,의정부,542751,124793,667544
201706,2017,경원선,이촌(국립중앙박물관),115681,31066,146747
201706,2017,경원선,가능,174390,65437,239827
201706,2017,경원선,광운대,251440,56287,307727
201706,2017,경원선,녹양,124503,36049,160552
201706,2017,경원선,녹천,123612,41570,165182
201706,2017,경원선,덕계,52026,18033,70059
201706,2017,경원선,덕정,187822,37664,225486
201706,2017,경원선,도봉,133028,72983,206011
201706,2017,경원선,도봉산,170242,100502,270744
201706,2017,경원선,동두천,51812,20700,72512
201706,2017,경원선,동두천중앙,83245,41561,124806
201706,2017,경원선,망월사,207871,72363,280234
201706,2017,경원선,창동,2,0,2
201706,2017,경의선,일산,237343,60807,298150
201706,2017,경의선,백마,177592,35374,212966
201706,2017,경의선,파주,45021,8372,53393
201706,2017,경의선,풍산,119067,30358,149425
201706,2017,경의선,행신,201396,37003,238399
201706,2017,경의선,홍대입구,46645,5178,51823
201706,2017,경의선,화전,75225,10967,86192
201706,2017,경의선,효창공원앞,59950,12104,72054
201706,2017,경의선,서강대,61522,9837,71359
201706,2017,경의선,서울역,79027,12356,91383
201706,2017,경의선,수색,59273,18338,77611
201706,2017,경의선,신촌,21647,3687,25334
201706,2017,경의선,야당,94731,23807,118538
201706,2017,경의선,운정,125414,32323,157737
201706,2017,경의선,월롱,70288,9298,79586
201706,2017,경의선,가좌,106396,45912,152308
201706,2017,경의선,강매,65093,17354,82447
201706,2017,경의선,곡산,13274,6337,19611
201706,2017,경의선,공덕,69891,10857,80748
201706,2017,경의선,금릉,127917,26719,154636
201706,2017,경의선,금촌,184352,49828,234180
201706,2017,경의선,능곡,89255,32190,121445
201706,2017,경의선,디지털미디어시티,65603,11721,77324
201706,2017,경의선,문산,151669,50061,201730
201706,2017,경의선,탄현,198802,39786,238588
201706,2017,경인선,인천,106321,48660,154981
201706,2017,경인선,제물포,293552,60078,353630
201706,2017,경인선,주안,681324,104647,785971
201706,2017,경인선,중동,247681,69102,316783
201706,2017,경인선,백운,221423,70286,291709
201706,2017,경인선,부개,253436,67955,321391
201706,2017,경인선,부천,1071502,217671,1289173
201706,2017,경인선,부평,1003221,145128,1148349
201706,2017,경인선,소사,314076,89030,403106
201706,2017,경인선,송내,889897,121064,1010961
201706,2017,경인선,역곡,818856,150146,969002
201706,2017,경인선,오류동,283152,89288,372440
201706,2017,경인선,온수(성공회대입구),181444,46823,228267
201706,2017,경인선,간석,164317,48500,212817
201706,2017,경인선,개봉,585345,161394,746739
201706,2017,경인선,구일,203989,37855,241844
201706,2017,경인선,도원,98898,38032,136930
201706,2017,경인선,도화,90680,40072,130752
201706,2017,경인선,동암,516205,114064,630269
201706,2017,경인선,동인천,437664,132726,570390
201706,2017,경춘선,평내호평,145357,43930,189287
201706,2017,경춘선,천마산,29880,15902,45782
201706,2017,경춘선,춘천,50888,22735,73623
201706,2017,경춘선,굴봉산,5383,2705,8088
201706,2017,경춘선,청평,63407,18889,82296
201706,2017,경춘선,강촌,21864,5597,27461
201706,2017,경춘선,갈매,42830,13207,56037
201706,2017,경춘선,가평,67593,17102,84695
201706,2017,경춘선,마석,89435,33761,123196
201706,2017,경춘선,남춘천,75210,25490,100700
201706,2017,경춘선,백양리,3477,1450,4927
201706,2017,경춘선,김유정,13216,4178,17394
201706,2017,경춘선,별내,60509,17155,77664
201706,2017,경춘선,사릉,94478,19927,114405
201706,2017,5호선,화곡,762777,142824,905601
201706,2017,5호선,강동,485124,97532,582656
201706,2017,4호선,남태령,73259,9878,83137
201706,2017,4호선,혜화,1115328,133516,1248844
201706,2017,4호선,한성대입구(삼선교),435196,81403,516599
201706,2017,3호선,경복궁(정부서울청사),659106,91797,750903
201706,2017,3호선,학여울,67105,14942,82047
201706,2017,3호선,충무로,27,2,29
201706,2017,3호선,지축,23374,10425,33799
201706,2017,3호선,종로3가,214367,54981,269348
201706,2017,3호선,잠원,152479,36763,189242
201706,2017,3호선,일원,216339,57414,273753
201706,2017,3호선,을지로3가,221311,60686,281997
201706,2017,3호선,옥수,251666,60773,312439
201706,2017,경춘선,상천,9939,6790,16729
201706,2017,경춘선,대성리,25558,6810,32368
201706,2017,경춘선,금곡,32641,15636,48277
201706,2017,경춘선,신내,16512,7924,24436
201706,2017,경춘선,퇴계원,86453,25789,112242
201706,2017,공항철도 1호선,공항화물청사,67356,8417,75773
201706,2017,공항철도 1호선,공덕,47471,6176,53647
201706,2017,공항철도 1호선,계양,300857,31899,332756
201706,2017,공항철도 1호선,검암,249376,24256,273632
201706,2017,공항철도 1호선,운서,146331,25463,171794
201706,2017,공항철도 1호선,영종,44037,12735,56772
201706,2017,공항철도 1호선,서울역,303666,31033,334699
201706,2017,공항철도 1호선,홍대입구,263867,17561,281428
201706,2017,공항철도 1호선,청라국제도시,146764,9345,156109
201706,2017,공항철도 1호선,인천국제공항,450747,46674,497421
201706,2017,공항철도 1호선,디지털미디어시티,335214,22370,357584
201706,2017,공항철도 1호선,김포공항,302088,19664,321752
201706,2017,과천선,범계,804519,111897,916416
201706,2017,1호선,동대문,329557,140568,470125
201706,2017,1호선,동묘앞,167372,143419,310791
201706,2017,1호선,서울역,1388873,221355,1610228
201706,2017,1호선,시청,617145,96810,713955
201706,2017,1호선,청량리(서울시립대입구),496353,339068,835421
201706,2017,1호선,제기동,288794,313571,602365
201706,2017,1호선,종각,1159728,155924,1315652
201706,2017,1호선,종로3가,667215,365977,1033192
201706,2017,1호선,종로5가,505400,277874,783274
201706,2017,1호선,신설동,351500,121351,472851
201706,2017,2호선,강남,2823935,171412,2995347
201706,2017,2호선,홍대입구,2160613,115874,2276487
201706,2017,2호선,건대입구,1241285,97686,1338971
201706,2017,2호선,교대(법원.검찰청),956121,168479,1124600
201706,2017,2호선,구로디지털단지,1741373,171821,1913194
201706,2017,2호선,구의(광진구청),604617,107888,712505
201706,2017,2호선,낙성대,822450,114131,936581
201706,2017,2호선,당산,597599,70023,667622
201706,2017,2호선,대림(구로구청),817135,118228,935363
201706,2017,2호선,도림천,25619,6534,32153
201706,2017,2호선,동대문역사문화공원,513512,61612,575124
201706,2017,2호선,뚝섬,429703,66105,495808
201706,2017,2호선,문래,492241,85830,578071
201706,2017,2호선,방배,554276,84523,638799
201706,2017,2호선,봉천,571820,151816,723636
201706,2017,2호선,사당,1072667,207326,1279993
201706,2017,2호선,삼성(무역센터),1544001,128893,1672894
201706,2017,2호선,상왕십리,331095,66709,397804
201706,2017,2호선,서울대입구(관악구청),1390277,218713,1608990
201705,2017,7호선,노원,542371,116893,659264
201705,2017,경원선,도봉산,179870,106397,286267
201705,2017,경원선,도봉,135086,73748,208834
201705,2017,경원선,덕정,204465,38157,242622
201705,2017,경원선,덕계,54820,18455,73275
201705,2017,경원선,녹천,124386,42271,166657
201705,2017,경원선,녹양,132781,37659,170440
201705,2017,경원선,광운대,290410,57018,347428
201705,2017,경원선,가능,180617,65970,246587
201705,2017,경원선,이촌(국립중앙박물관),120508,31352,151860
201705,2017,경원선,의정부,582413,128960,711373
201705,2017,경원선,응봉,44770,19421,64191
201705,2017,경원선,월계,156620,56720,213340
201705,2017,경원선,외대앞,355660,59661,415321
201705,2017,경원선,왕십리(성동구청),484358,62435,546793
201705,2017,경원선,옥수,1614,137,1751
201705,2017,경원선,양주,246885,58874,305759
201705,2017,경원선,신이문,238150,70000,308150
201705,2017,경원선,소요산,69586,96698,166284
201705,2017,5호선,군자(능동),302723,39484,342207
201705,2017,5호선,광화문(세종문화회관),984779,84284,1069063
201705,2017,5호선,광나루(장신대),386091,69165,455256
201705,2017,5호선,공덕,341762,46086,387848
201705,2017,5호선,고덕,237559,65006,302565
201705,2017,5호선,거여,159950,51786,211736
201705,2017,5호선,개화산,144221,36213,180434
201705,2017,5호선,화곡,776446,143636,920082
201705,2017,5호선,강동,494414,97947,592361
201705,2017,4호선,남태령,66752,9853,76605
201705,2017,4호선,혜화,1229246,134994,1364240
201705,2017,4호선,한성대입구(삼선교),472844,85909,558753
201705,2017,4호선,충무로,861408,128415,989823
201705,2017,4호선,총신대입구(이수),539416,147513,686929
201705,2017,4호선,창동,746565,197129,943694
201705,2017,4호선,이촌(국립중앙박물관),251182,48953,300135
201705,2017,4호선,쌍문,888215,177048,1065263
201705,2017,4호선,신용산,329212,48789,378001
201705,2017,4호선,숙대입구(갈월),491607,60741,552348
201705,2017,4호선,수유(강북구청),1182129,269637,1451766
201705,2017,4호선,성신여대입구(돈암),765443,111747,877190
201705,2017,4호선,서울역,328718,42074,370792
201705,2017,4호선,상계,563858,124181,688039
201705,2017,4호선,삼각지,121680,33317,154997
201705,2017,4호선,사당,835784,96527,932311
201705,2017,4호선,미아사거리,827018,197825,1024843
201705,2017,4호선,미아(서울사이버대학),467593,138294,605887
201705,2017,4호선,명동,1124477,76888,1201365
201705,2017,4호선,동작(현충원),73474,23225,96699
201705,2017,4호선,동대문역사문화공원,659941,68185,728126
201705,2017,4호선,동대문,650394,172411,822805
201705,2017,4호선,당고개,327363,100093,427456
201705,2017,4호선,노원,632882,95085,727967
201705,2017,4호선,회현(남대문시장),744166,245295,989461
201705,2017,4호선,길음,737141,152159,889300
201705,2017,3호선,경복궁(정부서울청사),701850,92269,794119
201705,2017,3호선,학여울,102019,15262,117281
201705,2017,3호선,충무로,55,1,56
201705,2017,3호선,지축,24237,10928,35165
201705,2017,3호선,종로3가,211072,54555,265627
201705,2017,3호선,잠원,153028,36346,189374
201705,2017,3호선,일원,212312,56414,268726
201705,2017,3호선,을지로3가,214356,59024,273380
201705,2017,3호선,옥수,257745,61038,318783
201705,2017,3호선,오금,184711,28260,212971
201705,2017,3호선,연신내,1064458,275562,1340020
201705,2017,3호선,양재(서초구청),1046353,164126,1210479
201705,2017,3호선,약수,352394,88546,440940
201705,2017,3호선,압구정,854364,151575,1005939
201705,2017,3호선,안국,676835,129810,806645
201705,2017,3호선,신사,832846,72056,904902
201705,2017,3호선,수서,419249,100941,520190
201705,2017,3호선,불광,456308,157992,614300
201705,2017,3호선,무악재,96504,34901,131405
201705,2017,3호선,매봉,284710,56139,340849
201705,2017,3호선,동대입구,336839,41087,377926
201705,2017,3호선,독립문,181638,79314,260952
201705,2017,3호선,도곡,178380,30553,208933
201705,2017,3호선,대치,315634,61875,377509
201705,2017,3호선,대청,257565,52868,310433
201705,2017,3호선,녹번,334131,70575,404706
201705,2017,3호선,남부터미널(예술의전당),932990,135626,1068616
201705,2017,3호선,금호,212882,57883,270765
201705,2017,3호선,구파발,534012,105732,639744
201705,2017,3호선,교대(법원.검찰청),376563,68986,445549
201705,2017,3호선,고속터미널,1728410,188453,1916863
201705,2017,3호선,경찰병원,186848,39398,226246
201705,2017,3호선,홍제,482433,160110,642543
201705,2017,3호선,가락시장,233138,71268,304406
201705,2017,2호선,강변(동서울터미널),1374717,152493,1527210
201705,2017,2호선,합정,936705,74541,1011246
201705,2017,2호선,한양대,393616,17053,410669
201705,2017,2호선,충정로(경기대입구),296085,53781,349866
201705,2017,2호선,종합운동장,592470,62679,655149
201705,2017,2호선,잠실새내,703323,120231,823554
201705,2017,2호선,잠실나루,438259,89173,527432
201705,2017,2호선,잠실(송파구청),2502445,231511,2733956
201705,2017,2호선,이대,608424,71801,680225
201705,2017,2호선,을지로입구,1301260,113577,1414837
201705,2017,2호선,을지로4가,281069,95232,376301
201705,2017,2호선,을지로3가,487352,86803,574155
201705,2017,2호선,용두(동대문구청),46111,23017,69128
201705,2017,2호선,용답,65894,17481,83375
201705,2017,2호선,왕십리(성동구청),575547,59883,635430
201705,2017,2호선,영등포구청,544472,108796,653268
201705,2017,2호선,역삼,1133458,151881,1285339
201705,2017,2호선,양천구청,170292,46999,217291
201705,2017,2호선,아현,255664,65352,321016
201705,2017,2호선,신촌,1412171,146434,1558605
201705,2017,2호선,신정네거리,238871,67151,306022
201705,2017,2호선,신설동,85332,34456,119788
201705,2017,2호선,신림,1937629,249418,2187047
201705,2017,2호선,신도림,1674285,206734,1881019
201705,2017,2호선,신대방,753368,138082,891450
201705,2017,2호선,신당,359712,110306,470018
201705,2017,2호선,신답,31058,11388,42446
201705,2017,2호선,시청,611464,61104,672568
201705,2017,2호선,성수,679278,102018,781296
201705,2017,2호선,선릉,1357316,195939,1553255
201705,2017,2호선,서초,578495,82697,661192
201705,2017,2호선,서울대입구(관악구청),1426784,220044,1646828
201705,2017,2호선,상왕십리,330396,66092,396488
201705,2017,2호선,삼성(무역센터),1574728,124096,1698824
201705,2017,2호선,사당,1078801,201145,1279946
201705,2017,2호선,봉천,568110,150435,718545
201705,2017,2호선,방배,574423,84836,659259
201705,2017,2호선,문래,481507,83574,565081
201705,2017,2호선,뚝섬,435658,67124,502782
201705,2017,2호선,동대문역사문화공원,534431,62994,597425
201705,2017,2호선,도림천,25226,6197,31423
201705,2017,2호선,대림(구로구청),833276,121394,954670
201705,2017,2호선,당산,600597,71229,671826
201705,2017,2호선,낙성대,829630,115818,945448
201705,2017,2호선,구의(광진구청),606545,106571,713116
201705,2017,2호선,구로디지털단지,1716149,172783,1888932
201705,2017,2호선,교대(법원.검찰청),934834,160223,1095057
201705,2017,2호선,건대입구,1353013,98621,1451634
201705,2017,2호선,홍대입구,2362902,117816,2480718
201705,2017,2호선,강남,2787209,167107,2954316
201705,2017,1호선,신설동,352123,122437,474560
201705,2017,1호선,종로5가,525495,286406,811901
201705,2017,1호선,종로3가,691031,375653,1066684
201705,2017,1호선,종각,1162362,158460,1320822
201705,2017,1호선,제기동,293929,322677,616606
201705,2017,1호선,청량리(서울시립대입구),528782,348821,877603
201705,2017,1호선,시청,610126,101702,711828
201705,2017,1호선,서울역,1421897,238890,1660787
201705,2017,1호선,동묘앞,179240,154439,333679
201705,2017,1호선,동대문,348942,145823,494765
201705,2017,8호선,몽촌토성(평화의문),197399,44014,241413
201705,2017,8호선,문정,321331,42334,363665
201705,2017,8호선,복정,294313,45144,339457
201705,2017,8호선,산성,170357,37177,207534
201705,2017,8호선,석촌,204976,59298,264274
201705,2017,8호선,송파,136905,36750,173655
201705,2017,8호선,수진,121956,44685,166641
201705,2017,8호선,신흥,108717,45581,154298
201705,2017,8호선,암사,463845,92438,556283
201705,2017,8호선,잠실(송파구청),348863,62557,411420
201705,2017,8호선,장지,456452,67290,523742
201705,2017,8호선,강동구청,260324,63175,323499
201705,2017,9호선,가양,519667,123429,643096
201705,2017,9호선,개화,161508,37184,198692
201705,2017,9호선,고속터미널,399172,50374,449546
201705,2017,9호선,공항시장,69767,22662,92429
201705,2017,9호선,구반포,77079,23817,100896
201705,2017,9호선,국회의사당,394177,60244,454421
201705,2017,9호선,김포공항,267770,19544,287314
201705,2017,9호선,노들,115065,30701,145766
201705,2017,9호선,노량진,793436,87157,880593
201705,2017,9호선,당산,489356,64711,554067
201705,2017,9호선,동작(현충원),56211,16972,73183
201705,2017,9호선,등촌,234853,80117,314970
201705,2017,9호선,마곡나루,121332,11612,132944
201705,2017,9호선,사평,67183,14483,81666
201705,2017,9호선,샛강,126389,26538,152927
201705,2017,9호선,선유도,176019,26430,202449
201705,2017,9호선,신논현,806869,49798,856667
201705,2017,9호선,신목동,107322,18839,126161
201705,2017,9호선,신반포,89398,25045,114443
201705,2017,9호선,신방화,210171,45267,255438
201705,2017,9호선,양천향교,201086,40030,241116
201705,2017,9호선,여의도,512634,41035,553669
201705,2017,9호선,염창,432064,61533,493597
201705,2017,9호선,증미,166687,42001,208688
201705,2017,9호선,흑석(중앙대입구),297161,54253,351414
201705,2017,9호선2단계,봉은사,350885,37966,388851
201705,2017,9호선2단계,삼성중앙,119849,18248,138097
201705,2017,9호선2단계,종합운동장,177447,15166,192613
201705,2017,9호선2단계,언주,202373,23215,225588
201705,2017,9호선2단계,선정릉,182172,19008,201180
201705,2017,경강선,초월,61889,10398,72287
201705,2017,경강선,판교,76372,10559,86931
201705,2017,경강선,부발,45878,6238,52116
201705,2017,경강선,삼동,36257,6867,43124
201705,2017,경강선,세종대왕릉,6224,3929,10153
201705,2017,경강선,곤지암,61333,15861,77194
201705,2017,경강선,여주,62976,21314,84290
201705,2017,경강선,이매,39763,9944,49707
201705,2017,경강선,이천,65125,13311,78436
201705,2017,경강선,경기광주,147855,21222,169077
201705,2017,경강선,신둔도예촌,32424,5948,38372
201705,2017,경부선,지제,48006,6373,54379
201705,2017,경부선,명학,285551,45626,331177
201705,2017,경부선,진위,46191,8808,54999
201705,2017,경부선,천안,239698,65934,305632
201705,2017,경부선,평택,418395,73471,491866
201705,2017,경부선,화서,229023,44811,273834
201705,2017,경부선,병점,471249,61322,532571
201705,2017,경부선,서동탄,40902,9584,50486
201705,2017,경부선,서울역,177661,13847,191508
201705,2017,경부선,서정리,160538,28031,188569
201705,2017,경부선,석수,325328,51937,377265
201705,2017,경부선,성균관대,474203,52083,526286
201705,2017,경부선,성환,164237,22663,186900
201705,2017,경부선,세류,118149,20054,138203
201705,2017,경부선,세마,72274,14462,86736
201705,2017,경부선,송탄,141191,26510,167701
201705,2017,경부선,수원,1318477,151896,1470373
201705,2017,경부선,신길,278893,50165,329058
201705,2017,경부선,신도림,107682,23679,131361
201705,2017,경부선,안양,816381,121053,937434
201705,2017,경부선,영등포,1250775,292510,1543285
201705,2017,경부선,오산,302637,44762,347399
201705,2017,경부선,오산대,94345,17010,111355
201705,2017,경부선,용산,1063264,143754,1207018
201705,2017,경부선,의왕,240525,42354,282879
201705,2017,경부선,가산디지털단지,427529,30278,457807
201705,2017,경부선,관악,223636,59480,283116
201705,2017,경부선,광명,44502,3513,48015
201705,2017,경부선,구로,564453,96311,660764
201705,2017,경부선,군포,198620,35270,233890
201705,2017,경부선,금정,767430,112753,880183
201705,2017,경부선,금천구청,295161,81660,376821
201705,2017,경부선,남영,315260,41648,356908
201705,2017,경부선,노량진,460034,55243,515277
201705,2017,경부선,당정,214123,32715,246838
201705,2017,경부선,대방,399523,76031,475554
201705,2017,경부선,독산,422128,66903,489031
201705,2017,경부선,두정,197846,24097,221943
201705,2017,경부선,직산,24431,6311,30742
201705,2017,경원선,지행,197477,48590,246067
201705,2017,경원선,방학,218336,110204,328540
201705,2017,경원선,청량리(서울시립대입구),344411,150381,494792
201705,2017,경원선,한남,106346,34548,140894
201705,2017,경원선,회룡,276325,147904,424229
201705,2017,경원선,보산,43072,16712,59784
201705,2017,경원선,서빙고,52223,17053,69276
201705,2017,경원선,석계,282674,70095,352769
201705,2017,5호선,굽은다리(강동구민회관앞),241680,64542,306222
201705,2017,5호선,길동,176613,61365,237978
201705,2017,5호선,김포공항,210500,28448,238948
201705,2017,5호선,까치산,774490,159652,934142
201705,2017,5호선,답십리,412037,85663,497700
201705,2017,5호선,동대문역사문화공원,73512,9726,83238
201705,2017,5호선,둔촌동,318026,79466,397492
201705,2017,5호선,마곡,152709,26095,178804
201705,2017,5호선,마장,149711,44826,194537
201705,2017,5호선,마천,116821,50403,167224
201705,2017,5호선,마포,351086,64619,415705
201705,2017,5호선,명일,194796,63802,258598
201705,2017,5호선,목동,491511,85747,577258
201705,2017,5호선,발산,364208,66386,430594
201705,2017,5호선,방이,178734,42636,221370
201705,2017,5호선,방화,188613,49677,238290
201705,2017,5호선,상일동,292082,64693,356775
201705,2017,5호선,서대문,443783,70100,513883
201705,2017,5호선,송정,230336,66542,296878
201705,2017,5호선,신금호,149388,38536,187924
201705,2017,5호선,신길,80357,12987,93344
201705,2017,5호선,신정(은행정),390586,60525,451111
201705,2017,5호선,아차산(어린이대공원후문),405996,100199,506195
201705,2017,중앙선,국수,21539,10855,32394
201705,2017,중앙선,팔당,31945,9504,41449
201705,2017,중앙선,지평,1328,669,1997
201705,2017,중앙선,중랑,139379,57814,197193
201705,2017,중앙선,원덕,9209,7141,16350
201705,2017,중앙선,운길산,27091,12094,39185
201705,2017,중앙선,용문,63620,62141,125761
201705,2017,중앙선,오빈,7719,4709,12428
201705,2017,중앙선,양평,94305,39507,133812
201705,2017,중앙선,양정,18602,10699,29301
201705,2017,중앙선,양원,43490,20054,63544
201705,2017,중앙선,양수,54257,25618,79875
201705,2017,중앙선,아신,22324,7265,29589
201705,2017,중앙선,신원,6472,5440,11912
201705,2017,중앙선,상봉(시외버스터미널),149032,40698,189730
201705,2017,중앙선,망우,202628,72469,275097
201705,2017,중앙선,도심,66401,22849,89250
201705,2017,중앙선,도농,228193,61579,289772
201705,2017,중앙선,덕소,156494,53589,210083
201705,2017,중앙선,회기,838563,135426,973989
201705,2017,중앙선,구리,355465,89134,444599
201705,2017,장항선,배방,27467,8728,36195
201705,2017,장항선,아산,98704,10604,109308
201705,2017,장항선,봉명,31553,15859,47412
201705,2017,장항선,온양온천,105990,62166,168156
201705,2017,장항선,신창(순천향대),85526,9042,94568
201705,2017,장항선,쌍용(나사렛대),82377,18478,100855
201705,2017,일산선,백석,286155,82281,368436
201705,2017,일산선,삼송,364065,85923,449988
201705,2017,일산선,원당,294465,92637,387102
201705,2017,일산선,원흥,194144,42828,236972
201705,2017,일산선,정발산,267396,87675,355071
201705,2017,일산선,주엽,205313,100617,305930
201705,2017,일산선,대화,367982,96276,464258
201705,2017,일산선,마두,183781,80855,264636
201705,2017,일산선,화정,490644,141492,632136
201705,2017,일산선,대곡,41096,13079,54175
201705,2017,안산선,신길온천,49230,12509,61739
201705,2017,안산선,초지,135663,16944,152607
201705,2017,안산선,중앙,514690,61797,576487
201705,2017,안산선,정왕,293858,26104,319962
201705,2017,안산선,오이도,267251,40679,307930
201705,2017,안산선,안산,503981,47534,551515
201705,2017,안산선,한대앞,274435,42795,317230
201705,2017,안산선,수리산,120643,39485,160128
201705,2017,안산선,상록수,603838,90791,694629
201705,2017,안산선,산본,476224,108176,584400
201705,2017,안산선,반월,129968,31854,161822
201705,2017,안산선,대야미,105543,27277,132820
201705,2017,안산선,고잔,259702,37429,297131
201705,2017,수인선,연수,142523,31098,173621
201705,2017,수인선,인하대,179615,24307,203922
201705,2017,수인선,인천논현,168770,34468,203238
201705,2017,수인선,인천,35104,11043,46147
201705,2017,수인선,월곶,78464,14568,93032
201705,2017,수인선,원인재,137324,30893,168217
201705,2017,수인선,호구포,90886,17187,108073
201705,2017,수인선,신포,48936,13016,61952
201705,2017,수인선,숭의,78481,26505,104986
201705,2017,수인선,송도,80442,25617,106059
201705,2017,수인선,소래포구,122541,78799,201340
201705,2017,수인선,달월,2203,1451,3654
201705,2017,수인선,남동인더스파크,59966,6149,66115
201705,2017,분당선,강남구청,211688,38153,249841
201705,2017,분당선,태평,371483,93477,464960
201705,2017,분당선,청명,115112,17433,132545
201705,2017,분당선,죽전,446363,85519,531882
201705,2017,분당선,정자,427213,84226,511439
201705,2017,분당선,이매,145589,41826,187415
201705,2017,분당선,오리,345127,95128,440255
201705,2017,분당선,영통,264800,28280,293080
201705,2017,분당선,야탑,715892,165992,881884
201705,2017,분당선,압구정로데오,392754,38739,431493
201705,2017,분당선,신갈,106816,32816,139632
201705,2017,분당선,수원시청,300418,35405,335823
201705,2017,분당선,수원,317842,29917,347759
201705,2017,분당선,수서,341800,61794,403594
201705,2017,분당선,수내,339788,87277,427065
201705,2017,분당선,선정릉,189934,35290,225224
201705,2017,분당선,선릉,216724,26204,242928
201705,2017,분당선,서현,698210,133491,831701
201705,2017,분당선,서울숲,211527,25078,236605
201705,2017,분당선,상갈,137434,32715,170149
201705,2017,분당선,복정,4,0,4
201705,2017,분당선,보정,59277,26330,85607
201705,2017,분당선,미금,476448,126741,603189
201705,2017,분당선,모란,553567,166439,720006
201705,2017,분당선,매탄권선,125804,15789,141593
201705,2017,분당선,매교,70558,18500,89058
201705,2017,분당선,망포,356781,31192,387973
201705,2017,분당선,도곡,159337,39618,198955
201705,2017,분당선,대모산입구,74643,29318,103961
201705,2017,분당선,기흥,231478,33779,265257
201705,2017,분당선,구성,115110,41453,156563
201705,2017,분당선,구룡,50757,19546,70303
201705,2017,분당선,개포동,91514,23470,114984
201705,2017,분당선,한티,360536,69053,429589
201705,2017,분당선,가천대,311375,24974,336349
201705,2017,과천선,과천,117235,33523,150758
201705,2017,과천선,경마공원,159851,62032,221883
201705,2017,과천선,선바위,247116,35602,282718
201705,2017,과천선,정부과천청사,319332,67910,387242
201705,2017,과천선,대공원,257916,64223,322139
201705,2017,과천선,평촌,436158,65486,501644
201705,2017,과천선,인덕원,696845,107891,804736
201705,2017,과천선,범계,847555,116081,963636
201705,2017,공항철도 1호선,김포공항,305571,19697,325268
201705,2017,공항철도 1호선,디지털미디어시티,326101,22334,348435
201705,2017,공항철도 1호선,인천국제공항,450192,46042,496234
201705,2017,공항철도 1호선,청라국제도시,142328,9304,151632
201705,2017,공항철도 1호선,홍대입구,278705,18112,296817
201705,2017,공항철도 1호선,서울역,310530,32860,343390
201705,2017,공항철도 1호선,영종,44930,12868,57798
201705,2017,공항철도 1호선,운서,148806,26351,175157
201705,2017,공항철도 1호선,검암,252809,25377,278186
201705,2017,공항철도 1호선,계양,309457,32084,341541
201705,2017,공항철도 1호선,공덕,45964,6416,52380
201705,2017,공항철도 1호선,공항화물청사,67237,8111,75348
201705,2017,경춘선,퇴계원,90104,26106,116210
201705,2017,경춘선,신내,17277,7557,24834
201705,2017,경춘선,금곡,34612,16079,50691
201705,2017,경춘선,대성리,36277,7208,43485
201705,2017,경춘선,상천,11557,7879,19436
201705,2017,경춘선,사릉,99824,20868,120692
201705,2017,경춘선,별내,62572,17819,80391
201705,2017,경춘선,김유정,18500,4774,23274
201705,2017,경춘선,백양리,4090,1638,5728
201705,2017,경춘선,남춘천,89116,26883,115999
201705,2017,경춘선,마석,95871,35249,131120
201705,2017,5호선,애오개,178493,40649,219142
201705,2017,5호선,양평,156805,28707,185512
201705,2017,5호선,여의나루,439844,33143,472987
201705,2017,5호선,여의도,593886,52094,645980
201705,2017,5호선,영등포구청,83120,20184,103304
201705,2017,5호선,영등포시장,185123,76936,262059
201705,2017,5호선,오금,97182,17836,115018
201705,2017,5호선,오목교(목동운동장앞),680770,86936,767706
201705,2017,5호선,올림픽공원(한국체대),198598,38835,237433
201705,2017,5호선,왕십리(성동구청),131052,26112,157164
201705,2017,5호선,우장산,407506,81149,488655
201705,2017,5호선,을지로4가,108033,43139,151172
201705,2017,5호선,장한평,458840,98867,557707
201705,2017,5호선,종로3가,304946,123158,428104
201705,2017,5호선,천호(풍납토성),501852,151988,653840
201705,2017,5호선,청구,99642,28077,127719
201705,2017,5호선,충정로(경기대입구),120839,16706,137545
201705,2017,5호선,행당,209974,49606,259580
201705,2017,5호선,개롱,165074,43183,208257
201705,2017,6호선,고려대(종암),281432,36003,317435
201705,2017,6호선,효창공원앞,186391,42543,228934
201705,2017,6호선,광흥창(서강),233054,59531,292585
201705,2017,6호선,구산,201452,57631,259083
201705,2017,6호선,녹사평(용산구청),219650,21949,241599
201705,2017,6호선,대흥(서강대앞),221367,46976,268343
201705,2017,6호선,독바위,70761,21370,92131
201705,2017,6호선,돌곶이,237415,62922,300337
201705,2017,6호선,동묘앞,216734,69706,286440
201705,2017,6호선,디지털미디어시티,373863,60867,434730
201705,2017,6호선,마포구청,341392,84020,425412
201705,2017,6호선,망원,331239,86835,418074
201705,2017,6호선,버티고개,63452,14799,78251
201705,2017,6호선,보문,230508,39746,270254
201705,2017,6호선,봉화산(서울의료원),239851,54026,293877
201705,2017,6호선,불광,135326,42330,177656
201705,2017,6호선,삼각지,218017,22648,240665
201705,2017,6호선,상수,325047,23654,348701
201705,2017,6호선,상월곡(한국과학기술연구원),162217,38874,201091
201705,2017,6호선,새절(신사),356603,88808,445411
201705,2017,6호선,석계,342525,77175,419700
201705,2017,6호선,신당,217037,39743,256780
201705,2017,6호선,안암(고대병원앞),448485,31412,479897
201705,2017,6호선,약수,88060,23425,111485
201705,2017,6호선,역촌,82954,35672,118626
201705,2017,6호선,연신내,25,0,25
201705,2017,6호선,월곡(동덕여대),343847,75307,419154
201705,2017,6호선,월드컵경기장(성산),181317,60114,241431
201705,2017,6호선,응암,446380,113436,559816
201705,2017,6호선,이태원,508315,38087,546402
201705,2017,6호선,증산(명지대앞),261954,71834,333788
201705,2017,6호선,창신,93838,18078,111916
201705,2017,6호선,청구,99126,19485,118611
201705,2017,6호선,태릉입구,150675,33391,184066
201705,2017,6호선,한강진,196358,14142,210500
201705,2017,6호선,합정,427158,41473,468631
201705,2017,6호선,화랑대(서울여대입구),374091,47513,421604
201705,2017,6호선,공덕,456933,73604,530537
201705,2017,7호선,가산디지털단지,1066094,73104,1139198
201705,2017,7호선,학동,558127,60945,619072
201705,2017,7호선,건대입구,485927,52081,538008
201705,2017,7호선,고속터미널,594451,81624,676075
201705,2017,7호선,공릉(서울과학기술대),357367,69602,426969
201705,2017,7호선,광명사거리,691117,153257,844374
201705,2017,7호선,군자(능동),373036,78665,451701
201705,2017,7호선,굴포천,247075,34165,281240
201705,2017,7호선,까치울,194778,29321,224099
201705,2017,7호선,남구로,426790,60884,487674
201705,2017,7호선,남성,295425,71161,366586
201705,2017,7호선,내방,361168,64612,425780
201705,2017,경원선,동두천,55223,21196,76419
201705,2017,7호선,논현,519008,50143,569151
201705,2017,7호선,대림(구로구청),305976,36098,342074
201705,2017,7호선,도봉산,259380,46674,306054
201705,2017,7호선,뚝섬유원지,312430,47965,360395
201705,2017,7호선,마들,306277,78146,384423
201705,2017,7호선,먹골,282609,62691,345300
201705,2017,7호선,면목,431810,88574,520384
201705,2017,7호선,반포,169292,32685,201977
201705,2017,7호선,보라매,257674,46888,304562
201705,2017,7호선,부천시청,340221,47666,387887
201705,2017,7호선,부천종합운동장,153396,21563,174959
201705,2017,7호선,부평구청,337400,31610,369010
201705,2017,7호선,사가정,406634,96483,503117
201705,2017,7호선,삼산체육관,155201,26474,181675
201705,2017,7호선,상도,311462,61823,373285
201705,2017,7호선,상동,395062,47818,442880
201705,2017,7호선,상봉(시외버스터미널),470854,75695,546549
201705,2017,7호선,수락산,360680,94199,454879
201705,2017,7호선,숭실대입구(살피재),468397,60374,528771
201705,2017,7호선,신대방삼거리,406230,94674,500904
201705,2017,7호선,신중동,394021,50084,444105
201705,2017,7호선,신풍,285049,69157,354206
201705,2017,7호선,어린이대공원(세종대),560012,53459,613471
201705,2017,7호선,온수(성공회대입구),301082,36099,337181
201705,2017,7호선,용마산,166356,37151,203507
201705,2017,7호선,이수,435212,78752,513964
201705,2017,7호선,장승배기,265497,80250,345747
201705,2017,7호선,장암,70794,9216,80010
201705,2017,7호선,중계,406819,97388,504207
201705,2017,7호선,중곡,257168,61914,319082
201705,2017,7호선,중화,303662,65734,369396
201705,2017,7호선,천왕,214330,46388,260718
201705,2017,7호선,철산,657322,104780,762102
201705,2017,7호선,청담,544188,76293,620481
201705,2017,7호선,춘의,241926,30969,272895
201705,2017,7호선,태릉입구,286287,50413,336700
201705,2017,7호선,하계,541967,110686,652653
201705,2017,7호선,강남구청,391755,48005,439760
201705,2017,8호선,가락시장,168313,52970,221283
201705,2017,8호선,천호(풍납토성),483337,95418,578755
201705,2017,8호선,남한산성입구(성남법원.검찰청),394829,77832,472661
201705,2017,8호선,단대오거리,315686,71204,386890
201705,2017,8호선,모란,95480,55781,151261
201705,2017,경춘선,가평,77319,18844,96163
201705,2017,경춘선,갈매,42516,13021,55537
201705,2017,경춘선,강촌,28415,6477,34892
201705,2017,경춘선,청평,67908,20518,88426
201705,2017,경춘선,굴봉산,8253,3261,11514
201705,2017,경춘선,춘천,71243,26248,97491
201705,2017,경춘선,천마산,31976,16323,48299
201705,2017,경춘선,평내호평,153271,45156,198427
201705,2017,경인선,동인천,458105,137545,595650
201705,2017,경인선,동암,537971,116331,654302
201705,2017,경인선,도화,90474,41128,131602
201705,2017,경인선,도원,99605,41076,140681
201705,2017,경인선,구일,230225,38659,268884
201705,2017,경인선,개봉,609089,163990,773079
201705,2017,경인선,간석,166263,46340,212603
201705,2017,경인선,온수(성공회대입구),189637,48424,238061
201705,2017,경인선,오류동,290598,90627,381225
201705,2017,경인선,역곡,862496,155537,1018033
201705,2017,경인선,송내,916150,122905,1039055
201705,2017,경인선,소사,337347,91803,429150
201705,2017,경인선,부평,1052624,148244,1200868
201705,2017,경인선,부천,1129989,221025,1351014
201705,2017,경인선,부개,258588,69136,327724
201705,2017,경인선,백운,226034,71407,297441
201705,2017,경인선,중동,252978,68679,321657
201705,2017,경인선,주안,732987,110046,843033
201705,2017,경인선,제물포,308519,59759,368278
201705,2017,경인선,인천,138194,53966,192160
201705,2017,경의선,탄현,205665,39553,245218
201705,2017,경의선,문산,160930,50299,211229
201705,2017,경의선,디지털미디어시티,63310,10538,73848
201705,2017,경의선,능곡,92597,33127,125724
201705,2017,경의선,금촌,194008,49143,243151
201705,2017,경의선,금릉,134372,27289,161661
201705,2017,경의선,공덕,66013,11094,77107
201705,2017,경의선,곡산,13358,6473,19831
201705,2017,경의선,강매,65586,16716,82302
201705,2017,경의선,가좌,108242,46493,154735
201705,2017,경의선,월롱,72238,9316,81554
201705,2017,경의선,운정,130584,31997,162581
201705,2017,경의선,야당,96077,23567,119644
201705,2017,경의선,신촌,22428,3743,26171
201705,2017,경의선,수색,54575,18331,72906
201705,2017,경의선,서울역,78024,12653,90677
201705,2017,경의선,서강대,63762,10122,73884
201705,2017,경의선,효창공원앞,59965,12396,72361
201705,2017,경의선,화전,90193,10812,101005
201705,2017,경의선,홍대입구,52281,5159,57440
201705,2017,경의선,행신,207917,38067,245984
201705,2017,경의선,풍산,122529,31059,153588
201705,2017,경의선,파주,55375,8780,64155
201705,2017,경의선,백마,182848,35651,218499
201705,2017,경의선,일산,245994,62195,308189
201705,2017,경원선,창동,3,0,3
201705,2017,경원선,망월사,234384,74568,308952
201705,2017,경원선,동두천중앙,86690,43579,130269
201704,2017,6호선,봉화산(서울의료원),239744,52680,292424
201704,2017,6호선,불광,132966,41969,174935
201704,2017,6호선,삼각지,216310,22951,239261
201704,2017,6호선,상수,319830,23452,343282
201704,2017,6호선,상월곡(한국과학기술연구원),160122,38603,198725
201704,2017,6호선,새절(신사),359879,87771,447650
201704,2017,6호선,석계,341378,75795,417173
201704,2017,6호선,신당,220161,39004,259165
201704,2017,6호선,안암(고대병원앞),423605,31362,454967
201704,2017,6호선,약수,91349,23970,115319
201704,2017,6호선,역촌,83042,34873,117915
201704,2017,6호선,연신내,23,1,24
201704,2017,6호선,월곡(동덕여대),346065,74720,420785
201704,2017,6호선,월드컵경기장(성산),158476,59247,217723
201704,2017,6호선,응암,446720,114524,561244
201704,2017,6호선,이태원,490261,37618,527879
201704,2017,6호선,증산(명지대앞),262972,71411,334383
201704,2017,6호선,창신,95086,17833,112919
201704,2017,6호선,청구,99873,18899,118772
201704,2017,6호선,태릉입구,137920,27623,165543
201704,2017,6호선,한강진,194726,14405,209131
201704,2017,6호선,합정,411293,40794,452087
201704,2017,6호선,화랑대(서울여대입구),374331,46669,421000
201704,2017,6호선,공덕,475989,73686,549675
201704,2017,7호선,가산디지털단지,1115654,74537,1190191
201704,2017,7호선,학동,591472,62391,653863
201704,2017,7호선,건대입구,474466,52570,527036
201704,2017,7호선,고속터미널,571000,84196,655196
201704,2017,7호선,공릉(서울과학기술대),350193,68785,418978
201704,2017,7호선,광명사거리,690539,149826,840365
201704,2017,7호선,군자(능동),372032,76728,448760
201704,2017,7호선,굴포천,246523,33843,280366
201704,2017,7호선,까치울,195173,29783,224956
201704,2017,7호선,남구로,435408,60553,495961
201704,2017,7호선,남성,297927,71037,368964
201704,2017,7호선,내방,368800,64213,433013
201704,2017,7호선,노원,522453,112317,634770
201704,2017,7호선,논현,533721,50064,583785
201704,2017,7호선,대림(구로구청),301950,34880,336830
201704,2017,7호선,도봉산,260957,45270,306227
201704,2017,7호선,뚝섬유원지,309404,43091,352495
201704,2017,7호선,마들,303762,76528,380290
201704,2017,7호선,먹골,274632,60080,334712
201704,2017,7호선,면목,436877,86650,523527
201704,2017,7호선,반포,167083,31756,198839
201704,2017,7호선,보라매,254274,41626,295900
201704,2017,7호선,부천시청,341622,47073,388695
201704,2017,7호선,부천종합운동장,199442,37457,236899
201704,2017,7호선,부평구청,341854,31883,373737
201704,2017,7호선,사가정,405832,95119,500951
201704,2017,7호선,삼산체육관,150058,25580,175638
201704,2017,7호선,상도,306231,60698,366929
201704,2017,7호선,상동,400114,47526,447640
201704,2017,7호선,상봉(시외버스터미널),466462,73052,539514
201704,2017,7호선,수락산,360628,92062,452690
201704,2017,7호선,숭실대입구(살피재),472013,59918,531931
201704,2017,7호선,신대방삼거리,408435,92881,501316
201704,2017,7호선,신중동,400343,49719,450062
201704,2017,7호선,신풍,276126,66253,342379
201704,2017,7호선,어린이대공원(세종대),557660,53256,610916
201704,2017,7호선,온수(성공회대입구),308007,35375,343382
201704,2017,7호선,용마산,165919,35989,201908
201704,2017,7호선,이수,435649,78200,513849
201704,2017,7호선,장승배기,266948,78310,345258
201704,2017,7호선,장암,70484,8817,79301
201704,2017,7호선,중계,406375,95937,502312
201704,2017,7호선,중곡,256885,61479,318364
201704,2017,7호선,중화,295413,60848,356261
201704,2017,7호선,천왕,215559,45668,261227
201704,2017,7호선,철산,659236,101698,760934
201704,2017,7호선,청담,556440,75119,631559
201704,2017,7호선,춘의,246665,29842,276507
201704,2017,7호선,태릉입구,261775,41206,302981
201704,2017,7호선,하계,529405,108714,638119
201704,2017,7호선,강남구청,403130,48562,451692
201704,2017,8호선,가락시장,173457,52301,225758
201704,2017,8호선,천호(풍납토성),487949,93671,581620
201704,2017,8호선,남한산성입구(성남법원.검찰청),397629,75951,473580
201704,2017,8호선,단대오거리,317225,69310,386535
201704,2017,8호선,모란,97344,55053,152397
201704,2017,8호선,몽촌토성(평화의문),186497,43414,229911
201704,2017,8호선,문정,318555,41811,360366
201704,2017,8호선,복정,305538,45762,351300
201704,2017,8호선,산성,172631,36577,209208
201704,2017,8호선,석촌,225834,62417,288251
201704,2017,8호선,송파,140056,36627,176683
201704,2017,8호선,수진,120062,43871,163933
201704,2017,8호선,신흥,108321,44050,152371
201704,2017,8호선,암사,465568,90864,556432
201704,2017,8호선,잠실(송파구청),386756,69225,455981
201704,2017,8호선,장지,434245,63938,498183
201704,2017,8호선,강동구청,264803,62725,327528
201704,2017,9호선,가양,531214,122253,653467
201704,2017,9호선,개화,165605,36116,201721
201704,2017,9호선,고속터미널,379195,48802,427997
201704,2017,9호선,공항시장,69909,21606,91515
201704,2017,9호선,구반포,76954,23715,100669
201704,2017,9호선,국회의사당,565941,77777,643718
201704,2017,5호선,방화,187713,49478,237191
201704,2017,5호선,방이,182380,41952,224332
201704,2017,5호선,발산,369141,64891,434032
201704,2017,5호선,목동,494528,85702,580230
201704,2017,5호선,명일,194750,63909,258659
201704,2017,5호선,마포,372455,64956,437411
201704,2017,5호선,마천,115984,49549,165533
201704,2017,5호선,마장,154806,43934,198740
201704,2017,5호선,마곡,142832,22567,165399
201704,2017,5호선,둔촌동,321520,79055,400575
201704,2017,5호선,동대문역사문화공원,77877,10115,87992
201704,2017,5호선,답십리,417843,84982,502825
201704,2017,5호선,까치산,778924,156601,935525
201704,2017,5호선,김포공항,198833,28884,227717
201704,2017,5호선,길동,176684,59658,236342
201704,2017,5호선,굽은다리(강동구민회관앞),239582,64057,303639
201704,2017,5호선,군자(능동),301477,38944,340421
201704,2017,5호선,광화문(세종문화회관),1019643,88304,1107947
201704,2017,5호선,광나루(장신대),394751,68986,463737
201704,2017,5호선,공덕,366790,46892,413682
201704,2017,5호선,고덕,234546,65060,299606
201704,2017,5호선,거여,162384,50774,213158
201704,2017,5호선,개화산,146095,35936,182031
201704,2017,5호선,화곡,779470,142496,921966
201704,2017,5호선,강동,495540,95662,591202
201704,2017,4호선,남태령,73527,9806,83333
201704,2017,4호선,혜화,1154557,132645,1287202
201704,2017,4호선,한성대입구(삼선교),463286,81371,544657
201704,2017,4호선,충무로,903858,131747,1035605
201704,2017,4호선,총신대입구(이수),539437,146504,685941
201704,2017,4호선,창동,732698,191279,923977
201704,2017,4호선,이촌(국립중앙박물관),246533,48296,294829
201704,2017,4호선,쌍문,876222,174142,1050364
201704,2017,4호선,신용산,331687,48876,380563
201704,2017,4호선,숙대입구(갈월),498454,60233,558687
201704,2017,4호선,수유(강북구청),1161261,263751,1425012
201704,2017,4호선,성신여대입구(돈암),745839,108577,854416
201704,2017,4호선,서울역,336597,40885,377482
201704,2017,4호선,상계,554269,121778,676047
201704,2017,4호선,삼각지,124116,33379,157495
201704,2017,4호선,사당,847022,97766,944788
201704,2017,4호선,미아사거리,816683,192775,1009458
201704,2017,4호선,미아(서울사이버대학),468836,135483,604319
201704,2017,4호선,명동,1179810,78724,1258534
201704,2017,4호선,동작(현충원),70326,24019,94345
201704,2017,4호선,동대문역사문화공원,655356,66541,721897
201704,2017,4호선,동대문,626750,165298,792048
201704,2017,1호선,동대문,346782,140627,487409
201704,2017,1호선,동묘앞,181102,152763,333865
201704,2017,1호선,서울역,1394790,218846,1613636
201704,2017,1호선,시청,638520,116976,755496
201704,2017,1호선,청량리(서울시립대입구),524757,337596,862353
201704,2017,1호선,제기동,297398,311151,608549
201704,2017,1호선,종각,1217997,156277,1374274
201704,2017,1호선,종로3가,702206,363866,1066072
201704,2017,1호선,종로5가,536907,272772,809679
201704,2017,1호선,신설동,367669,124262,491931
201704,2017,2호선,강남,2816606,167083,2983689
201704,2017,2호선,홍대입구,2207791,116088,2323879
201704,2017,2호선,건대입구,1315088,97885,1412973
201704,2017,2호선,교대(법원.검찰청),957815,162037,1119852
201704,2017,2호선,구로디지털단지,1751021,171034,1922055
201704,2017,2호선,구의(광진구청),613493,106423,719916
201704,2017,2호선,낙성대,842672,113718,956390
201704,2017,9호선,김포공항,248241,19317,267558
201704,2017,9호선,노들,117885,31021,148906
201704,2017,9호선,노량진,800542,88795,889337
201704,2017,9호선,당산,506167,62594,568761
201704,2017,9호선,동작(현충원),71000,21915,92915
201704,2017,9호선,등촌,240775,79291,320066
201704,2017,9호선,마곡나루,113809,10674,124483
201704,2017,9호선,사평,68046,14868,82914
201704,2017,9호선,샛강,138177,27335,165512
201704,2017,9호선,선유도,187980,26301,214281
201704,2017,9호선,신논현,822984,49453,872437
201704,2017,9호선,신목동,109420,18998,128418
201704,2017,9호선,신반포,89341,25371,114712
201704,2017,9호선,신방화,212608,44903,257511
201704,2017,9호선,양천향교,208763,39463,248226
201704,2017,9호선,여의도,586706,44610,631316
201704,2017,9호선,염창,437190,61515,498705
201704,2017,9호선,증미,172905,41108,214013
201704,2017,9호선,흑석(중앙대입구),289166,54155,343321
201704,2017,9호선2단계,봉은사,333986,36350,370336
201704,2017,9호선2단계,삼성중앙,124128,18770,142898
201704,2017,9호선2단계,종합운동장,184370,15152,199522
201704,2017,9호선2단계,언주,212087,23648,235735
201704,2017,9호선2단계,선정릉,188290,18995,207285
201704,2017,경강선,초월,58928,10355,69283
201704,2017,경강선,판교,73517,10032,83549
201704,2017,경강선,부발,44070,5939,50009
201704,2017,경강선,삼동,35965,6668,42633
201704,2017,경강선,세종대왕릉,5830,4185,10015
201704,2017,경강선,곤지암,57083,14538,71621
201704,2017,경강선,여주,59718,19562,79280
201704,2017,경강선,이매,39632,9818,49450
201704,2017,경강선,이천,61720,12508,74228
201704,2017,경강선,경기광주,141802,20666,162468
201704,2017,경강선,신둔도예촌,31002,5821,36823
201704,2017,경부선,지제,46973,6494,53467
201704,2017,경부선,명학,292442,44691,337133
201704,2017,경부선,진위,45846,8729,54575
201704,2017,경부선,천안,231240,66369,297609
201704,2017,경부선,평택,406149,72585,478734
201704,2017,경부선,화서,228566,44134,272700
201704,2017,경부선,병점,461298,60684,521982
201704,2017,경부선,서동탄,41668,9444,51112
201704,2017,경부선,서울역,168446,13795,182241
201704,2017,경부선,서정리,161348,27088,188436
201704,2017,경부선,석수,321638,50608,372246
201704,2017,경부선,성균관대,458269,51983,510252
201704,2017,경부선,성환,160056,23307,183363
201704,2017,경부선,세류,115447,19908,135355
201704,2017,경부선,세마,69095,13979,83074
201704,2017,경부선,송탄,136086,26135,162221
201704,2017,경부선,수원,1276429,149944,1426373
201704,2017,경부선,신길,284157,51571,335728
201704,2017,경부선,신도림,103288,22342,125630
201704,2017,경부선,안양,813558,119377,932935
201704,2017,경부선,영등포,1234623,292055,1526678
201704,2017,경부선,오산,293251,44320,337571
201704,2017,경부선,오산대,99683,15045,114728
201704,2017,경부선,용산,1016483,138138,1154621
201704,2017,경부선,의왕,236597,42068,278665
201704,2017,경부선,가산디지털단지,444976,30367,475343
201704,2017,경부선,관악,221133,57645,278778
201704,2017,경부선,광명,42340,3507,45847
201704,2017,경부선,구로,564504,96740,661244
201704,2017,경부선,군포,197128,35091,232219
201704,2017,경부선,금정,779751,112427,892178
201704,2017,경부선,금천구청,295624,81159,376783
201704,2017,경부선,남영,326083,42163,368246
201704,2017,경부선,노량진,452320,56742,509062
201704,2017,경부선,당정,214340,31714,246054
201704,2017,경부선,대방,407810,77632,485442
201704,2017,경부선,독산,430489,66980,497469
201704,2017,경부선,두정,194136,23553,217689
201704,2017,경부선,직산,23724,6471,30195
201704,2017,경원선,지행,192116,46844,238960
201704,2017,경원선,방학,214264,106648,320912
201704,2017,경원선,청량리(서울시립대입구),321437,143882,465319
201704,2017,경원선,한남,105294,34456,139750
201704,2017,경원선,회룡,271015,142977,413992
201704,2017,경원선,보산,42949,16041,58990
201704,2017,경원선,서빙고,52973,17372,70345
201704,2017,경원선,석계,276657,68496,345153
201704,2017,경원선,소요산,66071,95317,161388
201704,2017,경원선,신이문,236481,68112,304593
201704,2017,경원선,양주,240960,57536,298496
201704,2017,경원선,옥수,1558,108,1666
201704,2017,경원선,왕십리(성동구청),465374,60891,526265
201704,2017,경원선,외대앞,341116,57688,398804
201704,2017,경원선,월계,157440,55920,213360
201704,2017,경원선,응봉,49585,20687,70272
201704,2017,경원선,의정부,567045,127025,694070
201704,2017,경원선,이촌(국립중앙박물관),118147,31111,149258
201704,2017,경원선,가능,176134,63756,239890
201704,2017,경원선,광운대,279834,55660,335494
201704,2017,경원선,녹양,128321,36948,165269
201704,2017,경원선,녹천,122080,41307,163387
201704,2017,경원선,덕계,53206,18158,71364
201704,2017,경원선,덕정,206248,37369,243617
201704,2017,경원선,도봉,132074,70941,203015
201704,2017,경원선,도봉산,176540,102065,278605
201704,2017,경원선,동두천,54069,20348,74417
201704,2017,경원선,동두천중앙,85495,42779,128274
201704,2017,경원선,망월사,227700,71385,299085
201704,2017,경원선,창동,1,0,1
201704,2017,경의선,일산,243774,60956,304730
201704,2017,경의선,백마,179285,34175,213460
201704,2017,경의선,파주,55447,8703,64150
201704,2017,경의선,풍산,120683,30309,150992
201704,2017,경의선,행신,208050,37568,245618
201704,2017,경의선,홍대입구,47340,4895,52235
201704,2017,경의선,화전,85873,9748,95621
201704,2017,경의선,효창공원앞,58759,12148,70907
201704,2017,경의선,서강대,62706,9761,72467
201704,2017,경의선,서울역,76907,11165,88072
201704,2017,경의선,수색,54479,17775,72254
201704,2017,경의선,신촌,21922,3645,25567
201704,2017,경의선,야당,92261,23501,115762
201704,2017,경의선,운정,127959,30763,158722
201704,2017,경의선,월롱,75581,9461,85042
201704,2017,경의선,가좌,107869,45697,153566
201704,2017,경의선,강매,66693,16598,83291
201704,2017,경의선,곡산,13225,6526,19751
201704,2017,경의선,공덕,65441,10545,75986
201704,2017,경의선,금릉,129074,25469,154543
201704,2017,경의선,금촌,188050,47400,235450
201704,2017,경의선,능곡,91042,32796,123838
201704,2017,경의선,디지털미디어시티,63647,10372,74019
201704,2017,경의선,문산,154515,48138,202653
201704,2017,경의선,탄현,204694,39151,243845
201704,2017,경인선,인천,115553,49771,165324
201704,2017,경인선,제물포,308793,59204,367997
201704,2017,경인선,주안,718634,108156,826790
201704,2017,경인선,중동,252959,67116,320075
201704,2017,경인선,백운,224116,68386,292502
201704,2017,경인선,부개,256719,67802,324521
201704,2017,경인선,부천,1107819,215612,1323431
201704,2017,경인선,부평,1025553,145313,1170866
201704,2017,경인선,소사,338853,90704,429557
201704,2017,경인선,송내,921446,120056,1041502
201704,2017,경인선,역곡,854876,151565,1006441
201704,2017,경인선,오류동,288254,91098,379352
201704,2017,경인선,온수(성공회대입구),186489,47099,233588
201704,2017,경인선,간석,163876,45340,209216
201704,2017,경인선,개봉,598514,161746,760260
201704,2017,경인선,구일,216112,40264,256376
201704,2017,경인선,도원,101151,37544,138695
201704,2017,경인선,도화,90664,37861,128525
201704,2017,경인선,동암,536120,114289,650409
201704,2017,경인선,동인천,450737,131515,582252
201704,2017,경춘선,평내호평,148360,43127,191487
201704,2017,경춘선,천마산,30839,15759,46598
201704,2017,경춘선,춘천,58951,23302,82253
201704,2017,경춘선,굴봉산,5173,3203,8376
201704,2017,경춘선,청평,60384,18573,78957
201704,2017,경춘선,강촌,24959,6198,31157
201704,2017,경춘선,갈매,42145,12880,55025
201704,2017,경춘선,가평,63148,16834,79982
201704,2017,경춘선,마석,90322,33847,124169
201704,2017,경춘선,남춘천,79897,26276,106173
201704,2017,경춘선,백양리,4306,1728,6034
201704,2017,경춘선,김유정,15688,4299,19987
201704,2017,경춘선,별내,60702,17189,77891
201704,2017,경춘선,사릉,98697,20211,118908
201704,2017,경춘선,상천,11577,7767,19344
201704,2017,경춘선,대성리,44494,7117,51611
201704,2017,경춘선,금곡,34183,16114,50297
201704,2017,경춘선,신내,16822,7237,24059
201704,2017,경춘선,퇴계원,87567,25657,113224
201704,2017,공항철도 1호선,공항화물청사,66501,8148,74649
201704,2017,공항철도 1호선,공덕,45534,6340,51874
201704,2017,공항철도 1호선,계양,307268,31804,339072
201704,2017,공항철도 1호선,검암,253272,25119,278391
201704,2017,공항철도 1호선,운서,143129,25976,169105
201704,2017,공항철도 1호선,영종,42270,12496,54766
201704,2017,공항철도 1호선,서울역,305907,30543,336450
201704,2017,공항철도 1호선,홍대입구,263231,17564,280795
201704,2017,공항철도 1호선,청라국제도시,138645,9249,147894
201704,2017,공항철도 1호선,인천국제공항,424502,43324,467826
201704,2017,공항철도 1호선,디지털미디어시티,336639,23076,359715
201704,2017,공항철도 1호선,김포공항,296427,19958,316385
201704,2017,과천선,범계,844466,113142,957608
201704,2017,과천선,인덕원,711813,107490,819303
201704,2017,과천선,평촌,443064,63845,506909
201704,2017,과천선,대공원,224213,63071,287284
201704,2017,과천선,정부과천청사,334013,71154,405167
201704,2017,5호선,상일동,290625,63748,354373
201704,2017,과천선,선바위,255308,36273,291581
201704,2017,과천선,경마공원,201388,71327,272715
201704,2017,과천선,과천,118269,33830,152099
201704,2017,분당선,가천대,311379,24893,336272
201704,2017,분당선,한티,352708,68549,421257
201704,2017,분당선,개포동,92711,24107,116818
201704,2017,분당선,구룡,52429,18402,70831
201704,2017,분당선,구성,114327,41225,155552
201704,2017,분당선,기흥,225023,32832,257855
201704,2017,분당선,대모산입구,75955,28768,104723
201704,2017,분당선,도곡,161322,38903,200225
201704,2017,분당선,망포,356066,30816,386882
201704,2017,분당선,매교,71986,18641,90627
201704,2017,분당선,매탄권선,124094,15484,139578
201704,2017,분당선,모란,554660,167523,722183
201704,2017,분당선,미금,474068,125172,599240
201704,2017,분당선,보정,60354,26521,86875
201704,2017,분당선,상갈,131700,32479,164179
201704,2017,중앙선,도농,225006,60300,285306
201704,2017,중앙선,도심,64809,22353,87162
201704,2017,중앙선,망우,198706,70821,269527
201704,2017,중앙선,상봉(시외버스터미널),145295,39312,184607
201704,2017,중앙선,신원,6220,5662,11882
201704,2017,중앙선,아신,22078,7138,29216
201704,2017,중앙선,양수,52291,24476,76767
201704,2017,중앙선,양원,43678,19418,63096
201704,2017,중앙선,양정,18411,10780,29191
201704,2017,중앙선,양평,89467,40595,130062
201704,2017,중앙선,오빈,7088,4937,12025
201704,2017,중앙선,용문,58891,58128,117019
201704,2017,중앙선,운길산,27989,12301,40290
201704,2017,중앙선,원덕,10064,7399,17463
201704,2017,중앙선,중랑,135181,55281,190462
201704,2017,중앙선,지평,1248,543,1791
201704,2017,중앙선,팔당,30560,9353,39913
201704,2017,중앙선,국수,22151,11264,33415
201704,2017,2호선,당산,619287,72666,691953
201704,2017,2호선,대림(구로구청),838758,121003,959761
201704,2017,2호선,도림천,26974,6544,33518
201704,2017,2호선,동대문역사문화공원,521112,61868,582980
201704,2017,2호선,뚝섬,455489,67603,523092
201704,2017,2호선,문래,491308,83505,574813
201704,2017,2호선,방배,597876,84619,682495
201704,2017,2호선,봉천,573358,146623,719981
201704,2017,2호선,사당,1101995,203699,1305694
201704,2017,2호선,삼성(무역센터),1493167,124924,1618091
201704,2017,2호선,상왕십리,331739,65102,396841
201704,2017,2호선,서울대입구(관악구청),1425042,215339,1640381
201704,2017,2호선,서초,613996,85432,699428
201704,2017,2호선,선릉,1409924,195296,1605220
201704,2017,2호선,성수,697343,101634,798977
201704,2017,2호선,시청,648414,69926,718340
201704,2017,2호선,신답,30823,10427,41250
201704,2017,2호선,신당,361928,108353,470281
201704,2017,2호선,신대방,749953,136561,886514
201704,2017,2호선,신도림,1668726,208804,1877530
201704,2017,2호선,신림,1940705,244602,2185307
201704,2017,2호선,신설동,88661,35908,124569
201704,2017,2호선,신정네거리,237610,65782,303392
201704,2017,2호선,신촌,1370838,144623,1515461
201704,2017,2호선,아현,260505,64892,325397
201704,2017,2호선,양천구청,172262,47488,219750
201704,2017,2호선,역삼,1193590,152712,1346302
201704,2017,2호선,영등포구청,561090,105957,667047
201704,2017,2호선,왕십리(성동구청),569598,59098,628696
201704,2017,2호선,용답,65512,17295,82807
201704,2017,2호선,용두(동대문구청),47454,22247,69701
201704,2017,2호선,을지로3가,524465,88384,612849
201704,2017,2호선,을지로4가,288417,92569,380986
201704,2017,2호선,을지로입구,1359780,118360,1478140
201704,2017,2호선,이대,599054,73431,672485
201704,2017,2호선,잠실(송파구청),2726915,252038,2978953
201704,2017,2호선,잠실나루,454248,90679,544927
201704,2017,2호선,잠실새내,720523,119870,840393
201704,2017,2호선,종합운동장,521423,62952,584375
201704,2017,2호선,충정로(경기대입구),310132,53544,363676
201704,2017,2호선,한양대,391908,17775,409683
201704,2017,2호선,합정,933334,74163,1007497
201704,2017,2호선,강변(동서울터미널),1326027,150558,1476585
201704,2017,3호선,가락시장,235029,69652,304681
201704,2017,3호선,홍제,487385,154522,641907
201704,2017,3호선,경찰병원,193533,39160,232693
201704,2017,3호선,고속터미널,1636058,186737,1822795
201704,2017,3호선,교대(법원.검찰청),389916,71360,461276
201704,2017,3호선,구파발,523956,100502,624458
201704,2017,3호선,금호,213670,57049,270719
201704,2017,3호선,남부터미널(예술의전당),938112,136417,1074529
201704,2017,3호선,녹번,334777,68999,403776
201704,2017,3호선,대청,263911,52957,316868
201704,2017,3호선,대치,306054,61146,367200
201704,2017,3호선,도곡,183845,32047,215892
201704,2017,3호선,독립문,178034,77218,255252
201704,2017,3호선,동대입구,359891,52284,412175
201704,2017,3호선,매봉,296657,55934,352591
201704,2017,3호선,무악재,97182,33960,131142
201704,2017,3호선,불광,453218,152525,605743
201704,2017,3호선,수서,422281,100212,522493
201704,2017,3호선,신사,844895,72940,917835
201704,2017,3호선,안국,705867,128808,834675
201704,2017,3호선,압구정,872549,152414,1024963
201704,2017,3호선,약수,359903,87074,446977
201704,2017,3호선,양재(서초구청),1098513,166296,1264809
201704,2017,3호선,연신내,1050838,270209,1321047
201704,2017,3호선,오금,189411,28573,217984
201704,2017,3호선,옥수,256289,60964,317253
201704,2017,3호선,을지로3가,226568,59552,286120
201704,2017,3호선,일원,217783,57607,275390
201704,2017,3호선,잠원,155009,35568,190577
201704,2017,3호선,종로3가,210089,53568,263657
201704,2017,3호선,지축,23548,10740,34288
201704,2017,3호선,충무로,48,4,52
201704,2017,3호선,학여울,74402,16545,90947
201704,2017,3호선,경복궁(정부서울청사),701575,93179,794754
201704,2017,4호선,길음,733711,150811,884522
201704,2017,4호선,회현(남대문시장),746611,220024,966635
201704,2017,4호선,노원,607043,93243,700286
201704,2017,4호선,당고개,318214,96088,414302
201704,2017,분당선,서울숲,219731,24654,244385
201704,2017,분당선,서현,676263,130361,806624
201704,2017,분당선,선릉,225197,26222,251419
201704,2017,분당선,선정릉,200011,35876,235887
201704,2017,분당선,수내,340702,82047,422749
201704,2017,분당선,수서,339061,60960,400021
201704,2017,분당선,수원,294189,27867,322056
201704,2017,분당선,수원시청,293556,35328,328884
201704,2017,분당선,신갈,107230,32021,139251
201704,2017,분당선,압구정로데오,401928,38529,440457
201704,2017,분당선,야탑,711023,162801,873824
201704,2017,분당선,영통,255659,27923,283582
201704,2017,분당선,오리,347243,93859,441102
201704,2017,분당선,이매,144320,41712,186032
201704,2017,분당선,정자,430499,81977,512476
201704,2017,분당선,죽전,438819,84723,523542
201704,2017,분당선,청명,112759,17173,129932
201704,2017,분당선,태평,367516,92024,459540
201704,2017,분당선,강남구청,222132,37656,259788
201704,2017,수인선,남동인더스파크,59605,5043,64648
201704,2017,수인선,달월,2437,1568,4005
201704,2017,수인선,소래포구,114278,64826,179104
201704,2017,수인선,송도,76205,25211,101416
201704,2017,수인선,숭의,75880,25467,101347
201704,2017,수인선,신포,48645,12755,61400
201704,2017,수인선,호구포,93641,16953,110594
201704,2017,수인선,원인재,136829,29604,166433
201704,2017,수인선,월곶,78050,14069,92119
201704,2017,수인선,인천,28101,10627,38728
201704,2017,수인선,인천논현,162866,33281,196147
201704,2017,수인선,인하대,172483,24111,196594
201704,2017,수인선,연수,136676,30239,166915
201704,2017,안산선,고잔,255930,37316,293246
201704,2017,안산선,대야미,105706,26805,132511
201704,2017,안산선,반월,130402,31195,161597
201704,2017,안산선,산본,477060,108631,585691
201704,2017,안산선,상록수,597477,88383,685860
201704,2017,안산선,수리산,132329,43967,176296
201704,2017,안산선,한대앞,271109,42298,313407
201704,2017,안산선,안산,489121,46427,535548
201704,2017,안산선,오이도,253387,38478,291865
201704,2017,안산선,정왕,285161,25191,310352
201704,2017,안산선,중앙,488985,60943,549928
201704,2017,안산선,초지,141906,16664,158570
201704,2017,안산선,신길온천,48724,10390,59114
201704,2017,일산선,대곡,40896,12155,53051
201704,2017,일산선,화정,480690,137811,618501
201704,2017,일산선,마두,182392,78408,260800
201704,2017,일산선,대화,395221,98928,494149
201704,2017,일산선,주엽,201715,95965,297680
201704,2017,일산선,정발산,230978,68716,299694
201704,2017,일산선,원흥,192286,41344,233630
201704,2017,일산선,원당,291359,91034,382393
201704,2017,일산선,삼송,360230,84198,444428
201704,2017,일산선,백석,283052,80347,363399
201704,2017,장항선,쌍용(나사렛대),80275,17878,98153
201704,2017,장항선,신창(순천향대),79573,9344,88917
201704,2017,장항선,온양온천,104460,65516,169976
201704,2017,장항선,봉명,30222,16023,46245
201704,2017,장항선,아산,92729,10503,103232
201704,2017,장항선,배방,26179,8989,35168
201704,2017,중앙선,구리,339989,86215,426204
201704,2017,중앙선,회기,836443,133934,970377
201704,2017,중앙선,덕소,150815,52861,203676
201704,2017,5호선,서대문,473554,70092,543646
201704,2017,5호선,송정,233936,65566,299502
201704,2017,5호선,신금호,149623,38954,188577
201704,2017,5호선,신길,82995,13196,96191
201704,2017,5호선,신정(은행정),396263,60064,456327
201704,2017,5호선,아차산(어린이대공원후문),404759,99326,504085
201704,2017,5호선,애오개,186077,40715,226792
201704,2017,5호선,양평,161656,28482,190138
201704,2017,5호선,여의나루,605839,49487,655326
201704,2017,5호선,여의도,680934,57559,738493
201704,2017,5호선,영등포구청,85593,19667,105260
201704,2017,5호선,영등포시장,189417,76394,265811
201704,2017,5호선,오금,100862,17686,118548
201704,2017,5호선,오목교(목동운동장앞),680106,85751,765857
201704,2017,5호선,올림픽공원(한국체대),167565,36255,203820
201704,2017,5호선,왕십리(성동구청),132041,25745,157786
201704,2017,5호선,우장산,410283,80711,490994
201704,2017,5호선,을지로4가,110261,42140,152401
201704,2017,5호선,장한평,463716,97028,560744
201704,2017,5호선,종로3가,305227,118725,423952
201704,2017,5호선,천호(풍납토성),492430,149089,641519
201704,2017,5호선,청구,100164,27609,127773
201704,2017,5호선,충정로(경기대입구),130898,17853,148751
201704,2017,5호선,행당,212345,48824,261169
201704,2017,5호선,개롱,167135,43343,210478
201704,2017,6호선,고려대(종암),285168,36469,321637
201704,2017,6호선,효창공원앞,188822,42569,231391
201704,2017,6호선,광흥창(서강),239022,60532,299554
201704,2017,6호선,구산,202230,57346,259576
201704,2017,6호선,녹사평(용산구청),210078,22033,232111
201704,2017,6호선,대흥(서강대앞),219095,45259,264354
201704,2017,6호선,독바위,70971,20899,91870
201704,2017,6호선,돌곶이,237317,62400,299717
201704,2017,6호선,동묘앞,217825,68807,286632
201704,2017,6호선,디지털미디어시티,377406,61444,438850
201704,2017,6호선,마포구청,343455,82807,426262
201704,2017,6호선,망원,336651,86971,423622
201704,2017,6호선,버티고개,64442,14530,78972
201704,2017,6호선,보문,229295,38358,267653
201703,2017,경부선,신도림,104707,22215,126922
201703,2017,경부선,안양,862723,122539,985262
201703,2017,경부선,영등포,1289928,289393,1579321
201703,2017,경부선,오산,301525,44296,345821
201703,2017,경부선,오산대,104421,12954,117375
201703,2017,경부선,용산,1029738,134969,1164707
201703,2017,경부선,의왕,245335,41409,286744
201703,2017,경부선,가산디지털단지,470858,31369,502227
201703,2017,경부선,관악,232721,58013,290734
201703,2017,경부선,광명,41427,3209,44636
201703,2017,경부선,구로,588351,98252,686603
201703,2017,경부선,군포,208176,36159,244335
201703,2017,경부선,금정,809364,112869,922233
201703,2017,경부선,금천구청,305229,81982,387211
201703,2017,경부선,남영,353854,43802,397656
201703,2017,경부선,노량진,482227,56063,538290
201703,2017,경부선,당정,227351,31854,259205
201703,2017,경부선,대방,432848,78511,511359
201703,2017,경부선,독산,453897,69794,523691
201703,2017,경부선,두정,209560,23606,233166
201703,2017,경부선,직산,24180,6374,30554
201703,2017,경원선,지행,197725,46696,244421
201703,2017,경원선,방학,224306,109383,333689
201703,2017,경원선,청량리(서울시립대입구),332341,145396,477737
201703,2017,경원선,한남,108431,34911,143342
201703,2017,경원선,회룡,284659,145163,429822
201703,2017,9호선,등촌,256794,83460,340254
201703,2017,9호선,동작(현충원),46909,13419,60328
201703,2017,9호선,당산,517490,62958,580448
201703,2017,9호선,노량진,826799,88550,915349
201703,2017,9호선,노들,119962,31422,151384
201703,2017,9호선,김포공항,255252,18994,274246
201703,2017,9호선,국회의사당,444145,57029,501174
201703,2017,9호선,구반포,80132,24872,105004
201703,2017,9호선,공항시장,71419,22292,93711
201703,2017,9호선,고속터미널,371942,50012,421954
201703,2017,9호선,개화,171731,35486,207217
201703,2017,9호선,가양,554735,125517,680252
201703,2017,8호선,강동구청,278712,65758,344470
201703,2017,8호선,장지,452650,65823,518473
201703,2017,8호선,잠실(송파구청),349339,62511,411850
201703,2017,8호선,암사,479239,93221,572460
201703,2017,8호선,신흥,112784,46741,159525
201703,2017,8호선,수진,123293,45872,169165
201703,2017,8호선,송파,146421,37913,184334
201703,2017,8호선,석촌,221783,61952,283735
201703,2017,8호선,산성,176058,37161,213219
201703,2017,8호선,복정,321624,46012,367636
201703,2017,8호선,문정,328758,43474,372232
201703,2017,8호선,몽촌토성(평화의문),166089,42587,208676
201703,2017,8호선,모란,98473,57045,155518
201703,2017,8호선,단대오거리,331835,71524,403359
201703,2017,8호선,남한산성입구(성남법원.검찰청),416115,78089,494204
201703,2017,8호선,천호(풍납토성),507795,96417,604212
201703,2017,8호선,가락시장,184869,54690,239559
201703,2017,7호선,강남구청,428251,51443,479694
201703,2017,7호선,하계,551047,113383,664430
201703,2017,7호선,태릉입구,275144,41892,317036
201703,2017,7호선,춘의,253061,28750,281811
201703,2017,7호선,청담,598471,79543,678014
201703,2017,7호선,철산,690508,103392,793900
201703,2017,7호선,천왕,225358,46852,272210
201703,2017,7호선,중화,307827,62945,370772
201703,2017,7호선,중곡,268509,63364,331873
201703,2017,7호선,중계,420622,98102,518724
201703,2017,7호선,장암,70938,8214,79152
201703,2017,7호선,장승배기,280635,82056,362691
201703,2017,7호선,이수,462791,82040,544831
201703,2017,7호선,용마산,171427,37358,208785
201703,2017,7호선,온수(성공회대입구),327371,35398,362769
201703,2017,7호선,어린이대공원(세종대),529994,47766,577760
201703,2017,7호선,신풍,284771,68123,352894
201703,2017,7호선,신중동,417772,50257,468029
201703,2017,7호선,신대방삼거리,427841,96744,524585
201703,2017,7호선,숭실대입구(살피재),505455,61429,566884
201703,2017,7호선,수락산,373813,95300,469113
201703,2017,7호선,상봉(시외버스터미널),491308,75628,566936
201703,2017,7호선,상동,415560,48147,463707
201703,2017,7호선,상도,324692,63679,388371
201703,2017,7호선,삼산체육관,147605,25664,173269
201703,2017,7호선,사가정,419831,97203,517034
201703,2017,7호선,부평구청,357721,31458,389179
201703,2017,7호선,부천종합운동장,160561,18945,179506
201703,2017,7호선,부천시청,358971,47923,406894
201703,2017,7호선,보라매,265388,44543,309931
201703,2017,7호선,반포,177059,33218,210277
201703,2017,7호선,면목,457199,89120,546319
201703,2017,7호선,먹골,285468,60987,346455
201703,2017,7호선,마들,319182,79106,398288
201703,2017,7호선,뚝섬유원지,247797,40590,288387
201703,2017,7호선,도봉산,264824,43762,308586
201703,2017,7호선,대림(구로구청),316807,36784,353591
201703,2017,7호선,논현,571073,54256,625329
201703,2017,7호선,노원,554214,118803,673017
201703,2017,7호선,내방,394901,67586,462487
201703,2017,7호선,남성,315064,73575,388639
201703,2017,7호선,남구로,460516,62443,522959
201703,2017,7호선,까치울,194692,25258,219950
201703,2017,7호선,굴포천,256025,34709,290734
201703,2017,7호선,군자(능동),391847,79740,471587
201703,2017,7호선,광명사거리,728618,154923,883541
201703,2017,7호선,공릉(서울과학기술대),373392,70966,444358
201703,2017,7호선,고속터미널,581954,83134,665088
201703,2017,7호선,건대입구,512701,55663,568364
201703,2017,7호선,학동,631701,66180,697881
201703,2017,7호선,가산디지털단지,1207922,78686,1286608
201703,2017,6호선,공덕,499904,76519,576423
201703,2017,6호선,화랑대(서울여대입구),394522,48027,442549
201703,2017,6호선,합정,420137,40987,461124
201703,2017,6호선,한강진,207637,14521,222158
201703,2017,6호선,태릉입구,146346,28337,174683
201703,2017,6호선,청구,105864,19578,125442
201703,2017,6호선,창신,100465,18046,118511
201703,2017,6호선,증산(명지대앞),273574,72542,346116
201703,2017,6호선,이태원,507122,38715,545837
201703,2017,6호선,응암,465786,116207,581993
201703,2017,6호선,월드컵경기장(성산),162191,54427,216618
201703,2017,6호선,월곡(동덕여대),372659,78132,450791
201703,2017,6호선,연신내,21,0,21
201703,2017,6호선,역촌,87514,36013,123527
201703,2017,6호선,약수,94779,24455,119234
201703,2017,6호선,안암(고대병원앞),484537,33715,518252
201703,2017,6호선,신당,236448,41624,278072
201703,2017,경원선,보산,43454,15590,59044
201703,2017,경원선,서빙고,52815,17548,70363
201703,2017,경원선,석계,294889,68593,363482
201703,2017,경원선,소요산,60058,79889,139947
201703,2017,경원선,신이문,247408,69451,316859
201703,2017,경원선,양주,246093,55223,301316
201703,2017,경원선,옥수,1704,127,1831
201703,2017,경원선,왕십리(성동구청),504829,63205,568034
201703,2017,경원선,외대앞,375278,59012,434290
201703,2017,경원선,월계,167153,56664,223817
201703,2017,경원선,응봉,45555,19367,64922
201703,2017,경원선,의정부,589276,131379,720655
201703,2017,경원선,이촌(국립중앙박물관),117228,31496,148724
201703,2017,경원선,가능,182147,64262,246409
201703,2017,경원선,광운대,304584,56801,361385
201703,2017,경원선,녹양,130504,36259,166763
201703,2017,경원선,녹천,126004,41520,167524
201703,2017,경원선,덕계,55269,17953,73222
201703,2017,경원선,덕정,215191,36876,252067
201703,2017,경원선,도봉,138981,71645,210626
201703,2017,경원선,도봉산,178177,100344,278521
201703,2017,경원선,동두천,57231,20161,77392
201703,2017,경원선,동두천중앙,87999,43546,131545
201703,2017,경원선,망월사,239104,71587,310691
201703,2017,경원선,창동,5,0,5
201703,2017,경의선,일산,257203,59955,317158
201703,2017,경의선,백마,191119,33663,224782
201703,2017,경의선,파주,59258,7796,67054
201703,2017,경의선,풍산,126872,30378,157250
201703,2017,경의선,행신,217478,37408,254886
201703,2017,경의선,홍대입구,47804,4939,52743
201703,2017,경의선,화전,96609,8825,105434
201703,2017,경의선,효창공원앞,60916,11962,72878
201703,2017,경의선,서강대,68158,9700,77858
201703,2017,경의선,서울역,81022,11104,92126
201703,2017,경의선,수색,56948,17759,74707
201703,2017,경의선,신촌,23319,3663,26982
201703,2017,경의선,야당,95452,23315,118767
201703,2017,경의선,운정,133551,31084,164635
201703,2017,경의선,월롱,77397,8960,86357
201703,2017,경의선,가좌,110211,45952,156163
201703,2017,경의선,강매,68927,16980,85907
201703,2017,경의선,곡산,13860,5627,19487
201703,2017,경의선,공덕,66414,10632,77046
201703,2017,중앙선,양평,86403,36940,123343
201703,2017,중앙선,양정,18917,9484,28401
201703,2017,중앙선,양원,44881,19222,64103
201703,2017,중앙선,양수,47340,20519,67859
201703,2017,중앙선,아신,21335,6184,27519
201703,2017,중앙선,신원,5383,4104,9487
201703,2017,중앙선,상봉(시외버스터미널),147143,39067,186210
201703,2017,중앙선,망우,202821,71597,274418
201703,2017,중앙선,도심,66750,22465,89215
201703,2017,중앙선,도농,235381,61326,296707
201703,2017,중앙선,덕소,156720,53354,210074
201703,2017,중앙선,회기,885164,136245,1021409
201703,2017,경춘선,김유정,10825,3763,14588
201703,2017,경춘선,별내,62627,17568,80195
201703,2017,경춘선,사릉,101299,19929,121228
201703,2017,경춘선,상천,8901,4936,13837
201703,2017,경춘선,대성리,42460,5246,47706
201703,2017,경춘선,금곡,34573,16031,50604
201703,2017,경춘선,신내,16510,7248,23758
201703,2017,경춘선,퇴계원,88765,25955,114720
201703,2017,공항철도 1호선,공항화물청사,71796,8240,80036
201703,2017,공항철도 1호선,공덕,45640,6306,51946
201703,2017,공항철도 1호선,계양,320413,31767,352180
201703,2017,공항철도 1호선,검암,263221,25222,288443
201703,2017,공항철도 1호선,운서,143460,24892,168352
201703,2017,공항철도 1호선,영종,43050,12145,55195
201703,2017,공항철도 1호선,서울역,267936,30365,298301
201703,2017,공항철도 1호선,홍대입구,262962,17953,280915
201703,2017,공항철도 1호선,청라국제도시,144797,9228,154025
201703,2017,공항철도 1호선,인천국제공항,404375,43513,447888
201703,2017,2호선,신림,2038909,258824,2297733
201703,2017,2호선,신도림,1767219,216488,1983707
201703,2017,2호선,신대방,774950,138373,913323
201703,2017,2호선,신당,382580,114116,496696
201703,2017,2호선,신답,31783,10744,42527
201703,2017,2호선,시청,723996,98588,822584
201703,2017,2호선,성수,745188,106956,852144
201703,2017,2호선,선릉,1525182,214443,1739625
201703,2017,2호선,서초,636781,89523,726304
201703,2017,2호선,서울대입구(관악구청),1519787,227742,1747529
201703,2017,2호선,상왕십리,343533,67642,411175
201703,2017,2호선,삼성(무역센터),1654837,130579,1785416
201703,2017,2호선,사당,1168269,215098,1383367
201703,2017,2호선,봉천,600296,153300,753596
201703,2017,2호선,방배,644866,88674,733540
201703,2017,2호선,문래,524536,89439,613975
201703,2017,2호선,뚝섬,463928,70135,534063
201703,2017,2호선,동대문역사문화공원,537960,64467,602427
201703,2017,2호선,도림천,27466,6480,33946
201703,2017,2호선,대림(구로구청),875833,125482,1001315
201703,2017,2호선,당산,631791,71731,703522
201703,2017,2호선,낙성대,890180,120439,1010619
201703,2017,2호선,구의(광진구청),647116,112927,760043
201703,2017,2호선,구로디지털단지,1856871,177327,2034198
201703,2017,2호선,교대(법원.검찰청),1030377,177801,1208178
201703,2017,2호선,건대입구,1384481,102298,1486779
201703,2017,2호선,홍대입구,2370975,122784,2493759
201703,2017,2호선,강남,3023978,177915,3201893
201703,2017,1호선,신설동,395191,130458,525649
201703,2017,1호선,종로5가,602326,291340,893666
201703,2017,1호선,종로3가,765409,400767,1166176
201703,2017,1호선,종각,1337953,177866,1515819
201703,2017,1호선,제기동,316497,325773,642270
201703,2017,1호선,청량리(서울시립대입구),565535,357368,922903
201703,2017,1호선,시청,712299,162668,874967
201703,2017,1호선,서울역,1561293,228799,1790092
201703,2017,1호선,동묘앞,188527,156359,344886
201703,2017,1호선,동대문,368263,146295,514558
201703,2017,분당선,구성,121108,42519,163627
201703,2017,분당선,기흥,237389,33844,271233
201703,2017,분당선,대모산입구,80563,30283,110846
201703,2017,분당선,도곡,171879,41588,213467
201703,2017,분당선,망포,375771,31886,407657
201703,2017,분당선,매교,75110,19429,94539
201703,2017,분당선,매탄권선,129948,15840,145788
201703,2017,분당선,모란,583133,172565,755698
201703,2017,분당선,미금,501789,129233,631022
201703,2017,분당선,보정,65215,27175,92390
201703,2017,분당선,복정,1,0,1
201703,2017,분당선,상갈,138319,33482,171801
201703,2017,분당선,서울숲,195422,23557,218979
201703,2017,분당선,서현,719626,138618,858244
201703,2017,분당선,선릉,244522,28495,273017
201703,2017,분당선,선정릉,219340,41642,260982
201703,2017,분당선,수내,359685,85920,445605
201703,2017,분당선,수서,347942,61714,409656
201703,2017,분당선,수원,308281,28554,336835
201703,2017,분당선,수원시청,303216,36739,339955
201703,2017,분당선,신갈,113513,33074,146587
201703,2017,분당선,압구정로데오,428493,41287,469780
201703,2017,분당선,야탑,745515,169962,915477
201703,2017,분당선,영통,276174,29437,305611
201703,2017,분당선,오리,369653,97773,467426
201703,2017,분당선,이매,149360,42037,191397
201703,2017,분당선,정자,455960,87674,543634
201703,2017,분당선,죽전,465298,84630,549928
201703,2017,분당선,청명,120269,17767,138036
201703,2017,분당선,태평,381877,95172,477049
201703,2017,분당선,강남구청,237526,41024,278550
201703,2017,수인선,남동인더스파크,64930,5169,70099
201703,2017,수인선,달월,2372,1433,3805
201703,2017,수인선,소래포구,115695,53369,169064
201703,2017,수인선,송도,79265,23681,102946
201703,2017,수인선,숭의,76611,25613,102224
201703,2017,수인선,신포,50161,12560,62721
201703,2017,수인선,호구포,100585,17318,117903
201703,2017,수인선,원인재,139037,29727,168764
201703,2017,수인선,월곶,75576,14540,90116
201703,2017,수인선,인천,27612,10265,37877
201703,2017,수인선,인천논현,170888,33665,204553
201703,2017,수인선,인하대,188880,23629,212509
201703,2017,수인선,연수,142374,30138,172512
201703,2017,안산선,고잔,260708,36894,297602
201703,2017,안산선,대야미,106404,25436,131840
201703,2017,안산선,반월,133538,30709,164247
201703,2017,안산선,산본,486105,108154,594259
201703,2017,안산선,상록수,620113,88795,708908
201703,2017,안산선,수리산,115645,33283,148928
201703,2017,안산선,한대앞,288092,42539,330631
201703,2017,안산선,안산,501076,47082,548158
201703,2017,안산선,오이도,259333,36274,295607
201703,2017,경의선,금릉,133294,25793,159087
201703,2017,경의선,금촌,191634,46817,238451
201703,2017,경의선,능곡,93525,31439,124964
201703,2017,경의선,디지털미디어시티,67277,10452,77729
201703,2017,경의선,문산,158174,47276,205450
201703,2017,경의선,탄현,215851,39970,255821
201703,2017,경인선,인천,108251,41071,149322
201703,2017,경인선,제물포,323401,59230,382631
201703,2017,경인선,주안,766606,109969,876575
201703,2017,경인선,중동,263882,69025,332907
201703,2017,경인선,백운,232204,69062,301266
201703,2017,경인선,부개,268020,69168,337188
201703,2017,경인선,부천,1161346,221896,1383242
201703,2017,경인선,부평,1107944,150944,1258888
201703,2017,경인선,소사,343882,92727,436609
201703,2017,경인선,송내,963235,122910,1086145
201703,2017,경인선,역곡,903858,153030,1056888
201703,2017,경인선,오류동,301343,93591,394934
201703,2017,경인선,온수(성공회대입구),198294,47616,245910
201703,2017,경인선,간석,172631,46093,218724
201703,2017,경인선,개봉,622839,163685,786524
201703,2017,경인선,구일,224692,38476,263168
201703,2017,경인선,도원,106001,38092,144093
201703,2017,경인선,도화,95006,37673,132679
201703,2017,경인선,동암,559061,117604,676665
201703,2017,경인선,동인천,476624,132488,609112
201703,2017,경춘선,평내호평,152444,44987,197431
201703,2017,경춘선,천마산,31209,15567,46776
201703,2017,경춘선,춘천,56518,18964,75482
201703,2017,경춘선,굴봉산,3245,1782,5027
201703,2017,경춘선,청평,54748,16131,70879
201703,2017,경춘선,강촌,19248,4340,23588
201703,2017,경춘선,갈매,42492,12843,55335
201703,2017,경춘선,가평,50989,13524,64513
201703,2017,경춘선,마석,90617,33536,124153
201703,2017,경춘선,남춘천,83853,25675,109528
201703,2017,경춘선,백양리,4192,865,5057
201703,2017,2호선,신정네거리,254307,68873,323180
201703,2017,2호선,신촌,1535423,152279,1687702
201703,2017,2호선,아현,274580,67822,342402
201703,2017,2호선,양천구청,184953,48969,233922
201703,2017,2호선,역삼,1303586,166558,1470144
201703,2017,2호선,영등포구청,592541,111102,703643
201703,2017,2호선,왕십리(성동구청),612097,61317,673414
201703,2017,2호선,용답,68406,17974,86380
201703,2017,2호선,용두(동대문구청),49492,23868,73360
201703,2017,2호선,을지로3가,576795,99338,676133
201703,2017,2호선,을지로4가,316793,101807,418600
201703,2017,2호선,을지로입구,1479274,136015,1615289
201703,2017,2호선,이대,641581,80397,721978
201703,2017,2호선,잠실(송파구청),2400361,223785,2624146
201703,2017,2호선,잠실나루,470501,94890,565391
201703,2017,2호선,잠실새내,732223,125128,857351
201703,2017,2호선,종합운동장,369096,55044,424140
201703,2017,2호선,충정로(경기대입구),325635,56284,381919
201703,2017,2호선,한양대,416708,17165,433873
201703,2017,2호선,합정,974155,77881,1052036
201703,2017,2호선,강변(동서울터미널),1358505,147939,1506444
201703,2017,3호선,가락시장,244865,72379,317244
201703,2017,3호선,홍제,521617,161152,682769
201703,2017,3호선,경찰병원,206228,41673,247901
201703,2017,3호선,고속터미널,1676784,193033,1869817
201703,2017,3호선,교대(법원.검찰청),416290,77556,493846
201703,2017,3호선,구파발,550556,103655,654211
201703,2017,3호선,금호,223535,58447,281982
201703,2017,3호선,남부터미널(예술의전당),999363,141753,1141116
201703,2017,3호선,녹번,354942,72899,427841
201703,2017,3호선,대청,281196,54403,335599
201703,2017,3호선,대치,336791,65108,401899
201703,2017,3호선,도곡,193208,32409,225617
201703,2017,3호선,독립문,194958,79960,274918
201703,2017,3호선,동대입구,366787,40777,407564
201703,2017,3호선,매봉,315968,58736,374704
201703,2017,3호선,무악재,103381,35106,138487
201703,2017,3호선,불광,484474,160118,644592
201703,2017,3호선,수서,432511,102519,535030
201703,2017,3호선,신사,919431,76661,996092
201703,2017,3호선,안국,730880,140885,871765
201703,2017,3호선,압구정,935429,161064,1096493
201703,2017,3호선,약수,383413,90436,473849
201703,2017,3호선,양재(서초구청),1166192,172688,1338880
201703,2017,3호선,연신내,1106132,276594,1382726
201703,2017,3호선,오금,196923,28743,225666
201703,2017,3호선,옥수,267791,61192,328983
201703,2017,3호선,을지로3가,240269,66018,306287
201703,2017,3호선,일원,230481,60188,290669
201703,2017,3호선,잠원,162203,37682,199885
201703,2017,3호선,종로3가,232741,59385,292126
201703,2017,3호선,지축,23131,10299,33430
201703,2017,3호선,충무로,44,2,46
201703,2017,3호선,학여울,76301,19690,95991
201703,2017,3호선,경복궁(정부서울청사),751147,100729,851876
201703,2017,4호선,길음,786050,155113,941163
201703,2017,4호선,회현(남대문시장),802494,236279,1038773
201703,2017,4호선,노원,646058,96470,742528
201703,2017,4호선,총신대입구(이수),567579,152676,720255
201703,2017,4호선,창동,767978,195813,963791
201703,2017,4호선,이촌(국립중앙박물관),252839,50634,303473
201703,2017,공항철도 1호선,디지털미디어시티,353183,23726,376909
201703,2017,공항철도 1호선,김포공항,298420,18879,317299
201703,2017,과천선,범계,881252,114608,995860
201703,2017,과천선,인덕원,740413,106960,847373
201703,2017,과천선,평촌,463637,64905,528542
201703,2017,과천선,대공원,76559,33558,110117
201703,2017,과천선,정부과천청사,347520,68982,416502
201703,2017,과천선,선바위,262146,34314,296460
201703,2017,과천선,경마공원,163254,63068,226322
201703,2017,과천선,과천,123806,35530,159336
201703,2017,분당선,가천대,340907,24825,365732
201703,2017,분당선,한티,378398,71175,449573
201703,2017,분당선,개포동,96209,23249,119458
201703,2017,분당선,구룡,55384,19022,74406
201703,2017,6호선,석계,364481,78461,442942
201703,2017,6호선,새절(신사),376297,90188,466485
201703,2017,6호선,상월곡(한국과학기술연구원),169406,39832,209238
201703,2017,6호선,상수,343382,24221,367603
201703,2017,6호선,삼각지,222261,23748,246009
201703,2017,6호선,불광,140089,43020,183109
201703,2017,6호선,봉화산(서울의료원),252797,54263,307060
201703,2017,6호선,보문,244979,40369,285348
201703,2017,6호선,버티고개,68767,14842,83609
201703,2017,6호선,망원,354966,90823,445789
201703,2017,6호선,마포구청,363076,86541,449617
201703,2017,6호선,디지털미디어시티,400700,63264,463964
201703,2017,6호선,동묘앞,230971,72064,303035
201703,2017,6호선,돌곶이,249795,65261,315056
201703,2017,6호선,독바위,74193,21599,95792
201703,2017,6호선,대흥(서강대앞),235747,47661,283408
201703,2017,6호선,녹사평(용산구청),216838,22167,239005
201703,2017,6호선,구산,211623,58201,269824
201703,2017,6호선,광흥창(서강),248967,62981,311948
201703,2017,6호선,효창공원앞,198328,45319,243647
201703,2017,6호선,고려대(종암),296792,37307,334099
201703,2017,5호선,개롱,177170,45912,223082
201703,2017,5호선,행당,223000,50788,273788
201703,2017,5호선,충정로(경기대입구),141085,18971,160056
201703,2017,5호선,청구,104721,28030,132751
201703,2017,5호선,천호(풍납토성),512849,154892,667741
201703,2017,5호선,종로3가,328019,133681,461700
201703,2017,5호선,장한평,495175,103927,599102
201703,2017,5호선,을지로4가,120203,45716,165919
201703,2017,5호선,우장산,436624,83402,520026
201703,2017,5호선,왕십리(성동구청),137910,26837,164747
201703,2017,5호선,올림픽공원(한국체대),153271,35226,188497
201703,2017,5호선,오목교(목동운동장앞),719042,88849,807891
201703,2017,5호선,오금,104035,18275,122310
201703,2017,5호선,영등포시장,194469,78196,272665
201703,2017,5호선,영등포구청,88292,20131,108423
201703,2017,5호선,여의도,674185,56327,730512
201703,2017,5호선,여의나루,318096,29953,348049
201703,2017,5호선,양평,169928,29263,199191
201703,2017,5호선,애오개,192691,41897,234588
201703,2017,5호선,아차산(어린이대공원후문),395718,99122,494840
201703,2017,5호선,신정(은행정),413486,61985,475471
201703,2017,5호선,신길,85524,13029,98553
201703,2017,5호선,신금호,158778,40493,199271
201703,2017,5호선,송정,244611,66633,311244
201703,2017,5호선,서대문,515970,76427,592397
201703,2017,5호선,상일동,299882,65496,365378
201703,2017,5호선,방화,194192,50120,244312
201703,2017,5호선,방이,189474,44593,234067
201703,2017,5호선,발산,381353,67057,448410
201703,2017,5호선,목동,516391,88471,604862
201703,2017,5호선,명일,204522,65955,270477
201703,2017,5호선,마포,391782,67961,459743
201703,2017,5호선,마천,122107,51344,173451
201703,2017,5호선,마장,158790,47505,206295
201703,2017,5호선,마곡,144988,22930,167918
201703,2017,5호선,둔촌동,340809,81240,422049
201703,2017,5호선,동대문역사문화공원,83586,10998,94584
201703,2017,5호선,답십리,441690,88202,529892
201703,2017,5호선,까치산,818926,161540,980466
201703,2017,5호선,김포공항,203155,28205,231360
201703,2017,5호선,길동,183215,62428,245643
201703,2017,5호선,굽은다리(강동구민회관앞),253189,68006,321195
201703,2017,5호선,군자(능동),320652,42251,362903
201703,2017,5호선,광화문(세종문화회관),1146211,105788,1251999
201703,2017,5호선,광나루(장신대),402013,71313,473326
201703,2017,5호선,공덕,383997,49188,433185
201703,2017,5호선,고덕,244902,66993,311895
201703,2017,5호선,거여,172989,52859,225848
201703,2017,5호선,개화산,153293,37312,190605
201703,2017,5호선,화곡,813131,147306,960437
201703,2017,5호선,강동,522566,98802,621368
201703,2017,4호선,남태령,69264,9909,79173
201703,2017,4호선,혜화,1251563,140099,1391662
201703,2017,4호선,한성대입구(삼선교),488525,83515,572040
201703,2017,4호선,충무로,966975,138350,1105325
201703,2017,중앙선,구리,353287,88841,442128
201703,2017,장항선,배방,26049,8279,34328
201703,2017,장항선,아산,94951,10052,105003
201703,2017,장항선,봉명,31703,15380,47083
201703,2017,장항선,온양온천,101877,69906,171783
201703,2017,장항선,신창(순천향대),88221,9047,97268
201703,2017,장항선,쌍용(나사렛대),85200,18066,103266
201703,2017,일산선,삼송,374885,85020,459905
201703,2017,일산선,백석,296517,83019,379536
201703,2017,일산선,원당,304084,92120,396204
201703,2017,일산선,원흥,200242,41294,241536
201703,2017,일산선,정발산,218231,59895,278126
201703,2017,일산선,주엽,208056,102983,311039
201703,2017,일산선,지축,1,0,1
201703,2017,일산선,대화,397260,96658,493918
201703,2017,일산선,마두,191063,81463,272526
201703,2017,일산선,화정,499911,141327,641238
201703,2017,4호선,쌍문,919184,179383,1098567
201703,2017,4호선,신용산,354229,51783,406012
201703,2017,4호선,숙대입구(갈월),537852,63648,601500
201703,2017,4호선,수유(강북구청),1228151,270572,1498723
201703,2017,4호선,성신여대입구(돈암),808312,113245,921557
201703,2017,4호선,서울역,357832,41402,399234
201703,2017,4호선,상계,584835,123639,708474
201703,2017,4호선,삼각지,131040,35747,166787
201703,2017,4호선,사당,890405,101014,991419
201703,2017,4호선,미아사거리,856346,199549,1055895
201703,2017,4호선,미아(서울사이버대학),492979,140988,633967
201703,2017,4호선,명동,1280555,82247,1362802
201703,2017,4호선,동작(현충원),58978,21468,80446
201703,2017,4호선,동대문역사문화공원,690897,69776,760673
201703,2017,4호선,동대문,673793,174086,847879
201703,2017,4호선,당고개,333005,97754,430759
201703,2017,중앙선,국수,21709,10148,31857
201703,2017,중앙선,팔당,25061,7686,32747
201703,2017,중앙선,지평,1362,611,1973
201703,2017,중앙선,중랑,140257,55214,195471
201703,2017,중앙선,원덕,8014,6300,14314
201703,2017,중앙선,운길산,23793,9087,32880
201703,2017,중앙선,용문,50712,45974,96686
201703,2017,중앙선,오빈,7131,4310,11441
201703,2017,2호선,신설동,95334,37248,132582
201703,2017,일산선,대곡,41039,11353,52392
201703,2017,안산선,신길온천,49058,9528,58586
201703,2017,안산선,초지,148702,17080,165782
201703,2017,안산선,중앙,513803,61194,574997
201703,2017,안산선,정왕,304045,26067,330112
201703,2017,9호선,마곡나루,109569,11346,120915
201703,2017,9호선,사평,72054,15346,87400
201703,2017,9호선,샛강,136071,27273,163344
201703,2017,9호선,선유도,194580,26945,221525
201703,2017,9호선,신논현,870841,51530,922371
201703,2017,9호선,신목동,112997,19346,132343
201703,2017,9호선,신반포,90126,25563,115689
201703,2017,9호선,신방화,223203,45809,269012
201703,2017,9호선,양천향교,218951,40471,259422
201703,2017,9호선,여의도,572442,43752,616194
201703,2017,9호선,염창,453690,62716,516406
201703,2017,9호선,증미,185608,43307,228915
201703,2017,9호선,흑석(중앙대입구),319686,55656,375342
201703,2017,9호선2단계,봉은사,361902,36954,398856
201703,2017,9호선2단계,삼성중앙,132746,20938,153684
201703,2017,9호선2단계,종합운동장,182593,15025,197618
201703,2017,9호선2단계,언주,223193,24220,247413
201703,2017,9호선2단계,선정릉,199698,21636,221334
201703,2017,경강선,초월,61262,10570,71832
201703,2017,경강선,판교,76899,9631,86530
201703,2017,경강선,부발,46178,5745,51923
201703,2017,경강선,삼동,36934,7088,44022
201703,2017,경강선,세종대왕릉,5768,3751,9519
201703,2017,경강선,곤지암,56429,11922,68351
201703,2017,경강선,여주,60510,17086,77596
201703,2017,경강선,이매,40089,9665,49754
201703,2017,경강선,이천,63084,12505,75589
201703,2017,경강선,경기광주,146731,21125,167856
201703,2017,경강선,신둔도예촌,31947,5606,37553
201703,2017,경부선,지제,47372,6531,53903
201703,2017,경부선,명학,308018,45685,353703
201703,2017,경부선,진위,48386,8702,57088
201703,2017,경부선,천안,246124,65591,311715
201703,2017,경부선,평택,421800,73465,495265
201703,2017,경부선,화서,236931,44793,281724
201703,2017,경부선,병점,488253,60500,548753
201703,2017,경부선,서동탄,43261,9290,52551
201703,2017,경부선,서울역,45521,3687,49208
201703,2017,경부선,서정리,167952,27886,195838
201703,2017,경부선,석수,336793,50764,387557
201703,2017,경부선,성균관대,493418,53941,547359
201703,2017,경부선,성환,171205,23143,194348
201703,2017,경부선,세류,119965,20090,140055
201703,2017,경부선,세마,72849,14251,87100
201703,2017,경부선,송탄,140248,26618,166866
201703,2017,경부선,수원,1342087,149412,1491499
201703,2017,경부선,신길,291495,51371,342866
201702,2017,6호선,봉화산(서울의료원),218859,46510,265369
201702,2017,경춘선,평내호평,126811,37315,164126
201702,2017,경춘선,천마산,24617,13050,37667
201702,2017,경춘선,춘천,37966,14740,52706
201702,2017,경춘선,굴봉산,4765,1132,5897
201702,2017,경춘선,청평,54353,13246,67599
201702,2017,경춘선,강촌,13857,3303,17160
201702,2017,경춘선,갈매,35881,10731,46612
201702,2017,경춘선,가평,50781,11013,61794
201702,2017,경춘선,마석,68192,28584,96776
201702,2017,경춘선,남춘천,61890,22284,84174
201702,2017,경춘선,백양리,9694,689,10383
201702,2017,경춘선,김유정,10637,2635,13272
201702,2017,경춘선,별내,49445,13834,63279
201702,2017,경춘선,사릉,78493,16738,95231
201702,2017,경춘선,상천,6411,3202,9613
201702,2017,경춘선,대성리,18096,4190,22286
201702,2017,경춘선,금곡,26592,12382,38974
201702,2017,경춘선,신내,12591,5743,18334
201702,2017,경춘선,퇴계원,72839,22116,94955
201702,2017,공항철도 1호선,공항화물청사,65505,7198,72703
201702,2017,공항철도 1호선,공덕,40561,5385,45946
201702,2017,공항철도 1호선,계양,280046,26996,307042
201702,2017,공항철도 1호선,검암,239098,21404,260502
201702,2017,공항철도 1호선,운서,132907,20620,153527
201702,2017,공항철도 1호선,영종,38971,9898,48869
201702,2017,공항철도 1호선,서울역,255584,26564,282148
201702,2017,공항철도 1호선,홍대입구,242637,15758,258395
201702,2017,공항철도 1호선,청라국제도시,127363,7840,135203
201702,2017,공항철도 1호선,인천국제공항,400685,35045,435730
201702,2017,공항철도 1호선,디지털미디어시티,325991,21047,347038
201702,2017,공항철도 1호선,김포공항,278768,15847,294615
201702,2017,과천선,범계,778647,98479,877126
201702,2017,과천선,인덕원,631898,91789,723687
201702,2017,과천선,평촌,405073,56491,461564
201702,2017,과천선,대공원,73261,23937,97198
201702,2017,과천선,정부과천청사,312468,62817,375285
201702,2017,과천선,선바위,222028,27277,249305
201702,2017,과천선,경마공원,149644,55445,205089
201702,2017,과천선,과천,110479,30367,140846
201702,2017,분당선,가천대,163760,21830,185590
201702,2017,분당선,한티,354198,60364,414562
201702,2017,분당선,개포동,83420,20246,103666
201702,2017,분당선,구룡,40622,16201,56823
201702,2017,분당선,구성,105601,36220,141821
201702,2017,분당선,기흥,179364,28466,207830
201702,2017,분당선,대모산입구,69916,25741,95657
201702,2017,분당선,도곡,146389,34717,181106
201702,2017,분당선,망포,322896,26879,349775
201702,2017,분당선,매교,58673,16148,74821
201702,2017,분당선,매탄권선,106717,13631,120348
201702,2017,분당선,모란,510781,141110,651891
201702,2017,분당선,미금,454234,110475,564709
201702,2017,분당선,보정,54163,22947,77110
201702,2017,분당선,복정,4,0,4
201702,2017,분당선,상갈,120260,27611,147871
201702,2017,분당선,서울숲,163623,19461,183084
201702,2017,분당선,서현,679725,121024,800749
201702,2017,분당선,선릉,222291,25001,247292
201702,2017,분당선,선정릉,193701,33820,227521
201702,2017,분당선,수내,337813,72974,410787
201702,2017,분당선,수서,313894,51655,365549
201702,2017,분당선,수원,254347,24550,278897
201702,2017,분당선,수원시청,275613,31453,307066
201702,2017,분당선,신갈,102801,28109,130910
201702,2017,분당선,압구정로데오,392092,36536,428628
201702,2017,분당선,야탑,674050,143788,817838
201702,2017,분당선,영통,222727,25873,248600
201702,2017,분당선,오리,331084,83598,414682
201702,2017,분당선,이매,124904,35875,160779
201702,2017,분당선,정자,418366,74820,493186
201702,2017,분당선,죽전,364196,72305,436501
201702,2017,분당선,청명,102894,15114,118008
201702,2017,분당선,태평,339015,81855,420870
201702,2017,분당선,강남구청,213732,35497,249229
201702,2017,수인선,남동인더스파크,57876,4685,62561
201702,2017,수인선,달월,2063,1146,3209
201702,2017,수인선,소래포구,96045,33331,129376
201702,2017,수인선,송도,65236,18876,84112
201702,2017,수인선,숭의,63459,20718,84177
201702,2017,수인선,신포,39404,10494,49898
201702,2017,수인선,호구포,88622,14432,103054
201702,2017,수인선,원인재,115775,24825,140600
201702,2017,수인선,월곶,61354,11473,72827
201702,2017,수인선,인천,25680,8152,33832
201702,2017,수인선,인천논현,148048,27839,175887
201702,2017,수인선,인하대,121482,18772,140254
201702,2017,수인선,연수,118423,24269,142692
201702,2017,안산선,고잔,222329,31302,253631
201702,2017,안산선,대야미,91982,20158,112140
201702,2017,안산선,반월,114000,25517,139517
201702,2017,안산선,산본,432275,92203,524478
201702,2017,안산선,상록수,498205,76901,575106
201702,2017,안산선,수리산,97612,27897,125509
201702,2017,안산선,한대앞,214359,35937,250296
201702,2017,안산선,안산,436325,40216,476541
201702,2017,안산선,오이도,209967,27340,237307
201702,2017,안산선,정왕,205465,21303,226768
201702,2017,안산선,중앙,437048,52311,489359
201702,2017,안산선,초지,93647,13399,107046
201702,2017,안산선,신길온천,40263,7616,47879
201702,2017,일산선,대곡,32321,8096,40417
201702,2017,일산선,화정,442049,121131,563180
201702,2017,일산선,마두,168370,69367,237737
201702,2017,일산선,대화,331428,82659,414087
201702,2017,일산선,주엽,182554,87813,270367
201702,2017,일산선,정발산,210065,50657,260722
201702,2017,일산선,원흥,156435,34108,190543
201702,2017,일산선,원당,258545,75592,334137
201702,2017,일산선,삼송,303995,71574,375569
201702,2017,일산선,백석,265389,69935,335324
201702,2017,장항선,쌍용(나사렛대),49358,13258,62616
201702,2017,장항선,신창(순천향대),33044,7200,40244
201702,2017,장항선,온양온천,86042,62440,148482
201702,2017,장항선,봉명,25597,12839,38436
201702,2017,장항선,아산,65478,7799,73277
201702,2017,장항선,배방,21452,6670,28122
201702,2017,중앙선,구리,313072,74933,388005
201702,2017,중앙선,회기,674576,119297,793873
201702,2017,중앙선,덕소,133140,45561,178701
201702,2017,중앙선,도농,197249,51932,249181
201702,2017,중앙선,도심,53093,18363,71456
201702,2017,중앙선,망우,173275,60204,233479
201702,2017,중앙선,상봉(시외버스터미널),125925,32751,158676
201702,2017,중앙선,신원,3892,2586,6478
201702,2017,중앙선,아신,14137,4752,18889
201702,2017,중앙선,양수,37676,14581,52257
201702,2017,중앙선,양원,31142,15293,46435
201702,2017,중앙선,양정,15843,6389,22232
201702,2017,중앙선,양평,73925,30032,103957
201702,2017,중앙선,오빈,6396,3366,9762
201702,2017,중앙선,용문,42746,33421,76167
201702,2017,중앙선,운길산,17257,5985,23242
201702,2017,중앙선,원덕,6487,4379,10866
201702,2017,중앙선,중랑,122476,47070,169546
201702,2017,중앙선,지평,631,434,1065
201702,2017,중앙선,팔당,17643,5431,23074
201702,2017,중앙선,국수,15034,7441,22475
201702,2017,1호선,동대문,313069,122054,435123
201702,2017,1호선,동묘앞,156161,127902,284063
201702,2017,1호선,서울역,1510626,203252,1713878
201702,2017,1호선,시청,652064,156857,808921
201702,2017,1호선,청량리(서울시립대입구),483131,312138,795269
201702,2017,1호선,제기동,274359,272875,547234
201702,2017,1호선,종각,1258356,153922,1412278
201702,2017,1호선,종로3가,716760,343472,1060232
201702,2017,1호선,종로5가,546602,241395,787997
201702,2017,1호선,신설동,334795,112413,447208
201702,2017,2호선,강남,2974352,160425,3134777
201702,2017,2호선,홍대입구,2336977,106288,2443265
201702,2017,2호선,건대입구,1215879,89480,1305359
201702,2017,2호선,교대(법원.검찰청),912388,152573,1064961
201702,2017,2호선,구로디지털단지,1669717,154930,1824647
201702,2017,2호선,구의(광진구청),593421,100932,694353
201702,2017,2호선,낙성대,768687,102789,871476
201702,2017,2호선,당산,534940,60936,595876
201702,2017,2호선,대림(구로구청),765840,106724,872564
201702,2017,2호선,도림천,22563,5502,28065
201702,2017,2호선,동대문역사문화공원,453693,54867,508560
201702,2017,2호선,뚝섬,400952,59285,460237
201702,2017,2호선,문래,472151,76830,548981
201702,2017,2호선,방배,479506,75495,555001
201702,2017,2호선,봉천,529120,132713,661833
201702,2017,2호선,사당,1024369,184680,1209049
201702,2017,2호선,삼성(무역센터),1485835,114032,1599867
201702,2017,2호선,상왕십리,287537,58052,345589
201702,2017,2호선,서울대입구(관악구청),1300792,197470,1498262
201702,2017,2호선,서초,567761,77254,645015
201702,2017,2호선,선릉,1408873,191766,1600639
201702,2017,2호선,성수,675920,92900,768820
201702,2017,2호선,시청,662614,95607,758221
201702,2017,2호선,신답,27517,8989,36506
201702,2017,2호선,신당,330474,99391,429865
201702,2017,2호선,신대방,690443,119951,810394
201702,2017,2호선,신도림,1583908,188559,1772467
201702,2017,2호선,신림,1834147,225538,2059685
201702,2017,2호선,신설동,84770,33007,117777
201702,2017,2호선,신정네거리,222831,58665,281496
201702,2017,2호선,신촌,1346018,132208,1478226
201702,2017,2호선,아현,213202,57560,270762
201702,2017,2호선,양천구청,158553,41049,199602
201702,2017,2호선,역삼,1215564,145339,1360903
201702,2017,2호선,영등포구청,521970,95872,617842
201702,2017,2호선,왕십리(성동구청),499468,54395,553863
201702,2017,2호선,용답,54658,14920,69578
201702,2017,2호선,용두(동대문구청),44276,19917,64193
201702,2017,2호선,을지로3가,525364,85441,610805
201702,2017,2호선,을지로4가,286575,87002,373577
201702,2017,2호선,을지로입구,1374391,122287,1496678
201702,2017,2호선,이대,472620,63981,536601
201702,2017,2호선,잠실(송파구청),2357355,196663,2554018
201702,2017,2호선,잠실나루,414505,80199,494704
201702,2017,2호선,잠실새내,656356,109659,766015
201702,2017,2호선,종합운동장,314167,44930,359097
201702,2017,2호선,충정로(경기대입구),287774,50531,338305
201702,2017,2호선,한양대,213952,14299,228251
201702,2017,2호선,합정,889662,67607,957269
201702,2017,2호선,강변(동서울터미널),1277992,129051,1407043
201702,2017,3호선,가락시장,217041,61976,279017
201702,2017,3호선,홍제,419743,138414,558157
201702,2017,3호선,경찰병원,183418,36255,219673
201702,2017,3호선,고속터미널,1639481,168315,1807796
201702,2017,3호선,교대(법원.검찰청),351042,66054,417096
201702,2017,3호선,구파발,477944,90659,568603
201702,2017,3호선,금호,191440,49836,241276
201702,2017,3호선,남부터미널(예술의전당),942645,121297,1063942
201702,2017,3호선,녹번,310248,63232,373480
201702,2017,3호선,대청,235749,46688,282437
201702,2017,3호선,대치,303025,55847,358872
201702,2017,3호선,도곡,164122,27858,191980
201702,2017,3호선,독립문,152356,66479,218835
201702,2017,3호선,동대입구,271156,32335,303491
201702,2017,3호선,매봉,282689,50945,333634
201702,2017,3호선,무악재,89869,30056,119925
201702,2017,3호선,불광,412779,137519,550298
201702,2017,3호선,수서,392176,87973,480149
201702,2017,3호선,신사,865918,67876,933794
201702,2017,3호선,안국,627051,122308,749359
201702,2017,3호선,압구정,870021,135693,1005714
201702,2017,3호선,약수,329183,78489,407672
201702,2017,3호선,양재(서초구청),1026587,150051,1176638
201702,2017,3호선,연신내,960764,238104,1198868
201702,2017,3호선,오금,174076,24304,198380
201702,2017,3호선,옥수,229253,52338,281591
201702,2017,3호선,을지로3가,210978,56676,267654
201702,2017,3호선,일원,199887,51393,251280
201702,2017,3호선,잠원,139428,31550,170978
201702,2017,3호선,종로3가,210202,52331,262533
201702,2017,3호선,지축,20067,8402,28469
201702,2017,3호선,충무로,30,2,32
201702,2017,3호선,학여울,98219,13907,112126
201702,2017,3호선,경복궁(정부서울청사),616681,84163,700844
201702,2017,4호선,길음,603673,133957,737630
201702,2017,4호선,회현(남대문시장),696904,187690,884594
201702,2017,4호선,노원,581404,83486,664890
201702,2017,4호선,당고개,289171,83248,372419
201702,2017,4호선,동대문,589159,138581,727740
201702,2017,4호선,동대문역사문화공원,602351,60869,663220
201702,2017,4호선,동작(현충원),48785,17412,66197
201702,2017,4호선,명동,1093051,69409,1162460
201702,2017,4호선,미아(서울사이버대학),409521,122013,531534
201702,2017,4호선,미아사거리,758166,172127,930293
201702,2017,4호선,사당,766247,88096,854343
201702,2017,4호선,삼각지,117200,29985,147185
201702,2017,4호선,상계,501184,105864,607048
201702,2017,4호선,서울역,308566,36773,345339
201702,2017,4호선,성신여대입구(돈암),637517,98075,735592
201702,2017,4호선,수유(강북구청),1036942,236172,1273114
201702,2017,4호선,숙대입구(갈월),391946,54815,446761
201702,2017,4호선,신용산,329667,45088,374755
201702,2017,4호선,쌍문,799828,154472,954300
201702,2017,4호선,이촌(국립중앙박물관),244411,41609,286020
201702,2017,4호선,창동,667060,166850,833910
201702,2017,4호선,총신대입구(이수),497025,128761,625786
201702,2017,4호선,충무로,776488,117857,894345
201702,2017,4호선,한성대입구(삼선교),360415,71520,431935
201702,2017,4호선,혜화,1082889,121755,1204644
201702,2017,4호선,남태령,52232,8328,60560
201702,2017,5호선,강동,454162,86162,540324
201702,2017,5호선,화곡,707961,126866,834827
201702,2017,5호선,개화산,137222,31152,168374
201702,2017,5호선,거여,145868,45008,190876
201702,2017,5호선,고덕,198624,56411,255035
201702,2017,5호선,공덕,333775,43312,377087
201702,2017,5호선,광나루(장신대),338590,58090,396680
201702,2017,5호선,광화문(세종문화회관),1066117,89622,1155739
201702,2017,5호선,군자(능동),280007,36600,316607
201702,2017,5호선,굽은다리(강동구민회관앞),218241,58567,276808
201702,2017,5호선,길동,163364,54352,217716
201702,2017,5호선,김포공항,194426,24183,218609
201702,2017,5호선,까치산,721012,140554,861566
201702,2017,5호선,답십리,389416,77776,467192
201702,2017,5호선,동대문역사문화공원,76123,9665,85788
201702,2017,5호선,둔촌동,293051,70047,363098
201702,2017,5호선,마곡,120709,18719,139428
201702,2017,5호선,마장,130980,40497,171477
201702,2017,5호선,마천,102840,43907,146747
201702,2017,5호선,마포,356751,59210,415961
201702,2017,5호선,명일,177332,55672,233004
201702,2017,5호선,목동,445767,76320,522087
201702,2017,5호선,발산,317349,57460,374809
201702,2017,5호선,방이,169906,39789,209695
201702,2017,5호선,방화,168886,42389,211275
201702,2017,5호선,상일동,255770,55040,310810
201702,2017,5호선,서대문,412027,66298,478325
201702,2017,5호선,송정,209345,56956,266301
201702,2017,5호선,신금호,135431,34541,169972
201702,2017,5호선,신길,74969,10969,85938
201702,2017,5호선,신정(은행정),358592,53775,412367
201702,2017,5호선,아차산(어린이대공원후문),329823,83228,413051
201702,2017,5호선,애오개,163172,35734,198906
201702,2017,5호선,양평,151349,26263,177612
201702,2017,5호선,여의나루,191897,23977,215874
201702,2017,5호선,여의도,612716,50651,663367
201702,2017,5호선,영등포구청,77973,17575,95548
201702,2017,5호선,영등포시장,177581,68655,246236
201702,2017,5호선,오금,87693,15688,103381
201702,2017,5호선,오목교(목동운동장앞),653583,79272,732855
201702,2017,5호선,올림픽공원(한국체대),141553,30015,171568
201702,2017,5호선,왕십리(성동구청),124299,23098,147397
201702,2017,5호선,우장산,367226,72561,439787
201702,2017,5호선,을지로4가,107237,38582,145819
201702,2017,5호선,장한평,443015,91788,534803
201702,2017,5호선,종로3가,301388,116809,418197
201702,2017,5호선,천호(풍납토성),470927,135875,606802
201702,2017,5호선,청구,89339,24267,113606
201702,2017,5호선,충정로(경기대입구),114428,16878,131306
201702,2017,5호선,행당,192749,43779,236528
201702,2017,5호선,개롱,156347,40073,196420
201702,2017,6호선,고려대(종암),224032,32479,256511
201702,2017,6호선,효창공원앞,163650,38208,201858
201702,2017,6호선,광흥창(서강),217015,54950,271965
201702,2017,6호선,구산,178757,49915,228672
201702,2017,6호선,녹사평(용산구청),187428,18787,206215
201702,2017,6호선,대흥(서강대앞),182289,39417,221706
201702,2017,6호선,독바위,64677,17843,82520
201702,2017,6호선,돌곶이,209206,58038,267244
201702,2017,6호선,동묘앞,198643,62071,260714
201702,2017,6호선,디지털미디어시티,351402,53967,405369
201702,2017,6호선,마포구청,312508,74131,386639
201702,2017,6호선,망원,313800,77876,391676
201702,2017,6호선,버티고개,56002,12812,68814
201702,2017,6호선,보문,204223,34963,239186
201702,2017,6호선,불광,128376,37285,165661
201702,2017,6호선,삼각지,184540,20141,204681
201702,2017,6호선,상수,303391,21554,324945
201702,2017,6호선,상월곡(한국과학기술연구원),135512,34792,170304
201702,2017,6호선,새절(신사),294428,77745,372173
201702,2017,6호선,석계,299580,68022,367602
201702,2017,6호선,신당,204130,34664,238794
201702,2017,6호선,안암(고대병원앞),319811,29560,349371
201702,2017,6호선,약수,82325,20898,103223
201702,2017,6호선,역촌,78109,30493,108602
201702,2017,6호선,연신내,14,0,14
201702,2017,6호선,월곡(동덕여대),275369,68262,343631
201702,2017,6호선,월드컵경기장(성산),121337,41701,163038
201702,2017,6호선,응암,404316,99083,503399
201702,2017,6호선,이태원,449508,33051,482559
201702,2017,6호선,증산(명지대앞),234576,61839,296415
201702,2017,6호선,창신,76946,15474,92420
201702,2017,6호선,청구,92109,17173,109282
201702,2017,6호선,태릉입구,120235,24968,145203
201702,2017,6호선,한강진,198812,12282,211094
201702,2017,6호선,합정,367306,35598,402904
201702,2017,6호선,화랑대(서울여대입구),308759,40974,349733
201702,2017,6호선,공덕,441149,66047,507196
201702,2017,7호선,가산디지털단지,1110678,70304,1180982
201702,2017,7호선,학동,577583,58194,635777
201702,2017,7호선,건대입구,429827,49956,479783
201702,2017,7호선,고속터미널,575664,72039,647703
201702,2017,7호선,공릉(서울과학기술대),285013,60874,345887
201702,2017,7호선,광명사거리,639693,134202,773895
201702,2017,7호선,군자(능동),349298,70052,419350
201702,2017,7호선,굴포천,228018,30308,258326
201702,2017,7호선,까치울,165071,20087,185158
201702,2017,7호선,남구로,407607,54682,462289
201702,2017,7호선,남성,265468,62910,328378
201702,2017,7호선,내방,343337,58938,402275
201702,2017,7호선,노원,512885,103964,616849
201702,2017,7호선,논현,518160,47099,565259
201702,2017,7호선,대림(구로구청),279420,32081,311501
201702,2017,7호선,도봉산,213571,34458,248029
201702,2017,7호선,뚝섬유원지,184538,35348,219886
201702,2017,7호선,마들,279109,68858,347967
201702,2017,7호선,먹골,252453,52547,305000
201702,2017,7호선,면목,357110,77000,434110
201702,2017,7호선,반포,153427,29109,182536
201702,2017,7호선,보라매,238011,38212,276223
201702,2017,7호선,부천시청,323729,41138,364867
201702,2017,7호선,부천종합운동장,132646,14711,147357
201702,2017,7호선,부평구청,311257,27310,338567
201702,2017,7호선,사가정,365701,83228,448929
201702,2017,7호선,삼산체육관,130334,21914,152248
201702,2017,7호선,상도,250475,55789,306264
201702,2017,7호선,상동,375509,40983,416492
201702,2017,7호선,상봉(시외버스터미널),433734,65565,499299
201702,2017,7호선,수락산,320575,80211,400786
201702,2017,7호선,숭실대입구(살피재),324360,52763,377123
201702,2017,7호선,신대방삼거리,375873,85061,460934
201702,2017,7호선,신중동,369935,43088,413023
201702,2017,7호선,신풍,247817,58755,306572
201702,2017,7호선,어린이대공원(세종대),346829,39829,386658
201702,2017,7호선,온수(성공회대입구),259058,30866,289924
201702,2017,7호선,용마산,146747,31550,178297
201702,2017,7호선,이수,420218,71254,491472
201702,2017,7호선,장승배기,247988,70707,318695
201702,2017,7호선,장암,59352,6338,65690
201702,2017,7호선,중계,355072,83571,438643
201702,2017,7호선,중곡,233235,56341,289576
201702,2017,7호선,중화,268826,55141,323967
201702,2017,7호선,천왕,194296,40342,234638
201702,2017,7호선,철산,609587,89509,699096
201702,2017,7호선,청담,534431,70120,604551
201702,2017,7호선,춘의,220821,24509,245330
201702,2017,7호선,태릉입구,205897,36434,242331
201702,2017,7호선,하계,471505,97379,568884
201702,2017,7호선,강남구청,390447,45418,435865
201702,2017,8호선,가락시장,165278,46250,211528
201702,2017,8호선,천호(풍납토성),455598,84206,539804
201702,2017,8호선,남한산성입구(성남법원.검찰청),327534,66324,393858
201702,2017,8호선,단대오거리,270088,61952,332040
201702,2017,8호선,모란,85630,46493,132123
201702,2017,8호선,몽촌토성(평화의문),153623,36281,189904
201702,2017,8호선,문정,265916,33608,299524
201702,2017,8호선,복정,246618,38677,285295
201702,2017,8호선,산성,145342,31698,177040
201702,2017,8호선,석촌,199187,53545,252732
201702,2017,8호선,송파,121244,32741,153985
201702,2017,8호선,수진,110546,39960,150506
201702,2017,8호선,신흥,101914,41457,143371
201702,2017,8호선,암사,418539,80735,499274
201702,2017,8호선,잠실(송파구청),333034,56397,389431
201702,2017,8호선,장지,395869,55477,451346
201702,2017,8호선,강동구청,246502,56835,303337
201702,2017,9호선,가양,487762,108594,596356
201702,2017,9호선,개화,147460,29153,176613
201702,2017,9호선,고속터미널,342524,43544,386068
201702,2017,9호선,공항시장,64052,19208,83260
201702,2017,9호선,구반포,73156,21682,94838
201702,2017,9호선,국회의사당,410153,49484,459637
201702,2017,9호선,김포공항,251706,16612,268318
201702,2017,9호선,노들,108055,26723,134778
201702,2017,9호선,노량진,738572,76450,815022
201702,2017,9호선,당산,463978,55604,519582
201702,2017,9호선,동작(현충원),39160,11216,50376
201702,2017,9호선,등촌,225114,72216,297330
201702,2017,9호선,마곡나루,88853,9507,98360
201702,2017,9호선,사평,62374,12729,75103
201702,2017,9호선,샛강,124839,23066,147905
201702,2017,9호선,선유도,173867,23142,197009
201702,2017,9호선,신논현,823671,45301,868972
201702,2017,9호선,신목동,99023,16392,115415
201702,2017,9호선,신반포,78518,21568,100086
201702,2017,9호선,신방화,191001,39069,230070
201702,2017,9호선,양천향교,182649,34651,217300
201702,2017,9호선,여의도,522228,38647,560875
201702,2017,9호선,염창,402338,53747,456085
201702,2017,9호선,증미,167441,36770,204211
201702,2017,9호선,흑석(중앙대입구),210327,48826,259153
201702,2017,9호선2단계,봉은사,323496,31494,354990
201702,2017,9호선2단계,삼성중앙,119248,17509,136757
201702,2017,9호선2단계,종합운동장,161781,12565,174346
201702,2017,9호선2단계,언주,210675,21010,231685
201702,2017,9호선2단계,선정릉,177748,17181,194929
201702,2017,경강선,초월,52154,9185,61339
201702,2017,경강선,판교,68557,7989,76546
201702,2017,경강선,부발,35551,4645,40196
201702,2017,경강선,삼동,30984,5948,36932
201702,2017,경강선,세종대왕릉,4914,2605,7519
201702,2017,경강선,곤지암,41873,9896,51769
201702,2017,경강선,여주,40393,13219,53612
201702,2017,경강선,이매,32104,8038,40142
201702,2017,경강선,이천,56110,10175,66285
201702,2017,경강선,경기광주,122493,17577,140070
201702,2017,경강선,신둔도예촌,20893,4468,25361
201702,2017,경부선,지제,39665,5148,44813
201702,2017,경부선,명학,238154,39397,277551
201702,2017,경부선,진위,37322,6880,44202
201702,2017,경부선,천안,148686,55209,203895
201702,2017,경부선,평택,317023,60925,377948
201702,2017,경부선,화서,193790,37854,231644
201702,2017,경부선,병점,349499,50896,400395
201702,2017,경부선,서동탄,36807,7795,44602
201702,2017,경부선,서울역,14,3,17
201702,2017,경부선,서정리,107549,22637,130186
201702,2017,경부선,석수,273837,42800,316637
201702,2017,경부선,성균관대,372810,47687,420497
201702,2017,경부선,성환,83010,18693,101703
201702,2017,경부선,세류,100177,16978,117155
201702,2017,경부선,세마,62036,11541,73577
201702,2017,경부선,송탄,112417,22710,135127
201702,2017,경부선,수원,1063467,127209,1190676
201702,2017,경부선,신길,248428,43295,291723
201702,2017,경부선,신도림,90457,17846,108303
201702,2017,경부선,안양,625851,104969,730820
201702,2017,경부선,영등포,1203813,255098,1458911
201702,2017,경부선,오산,243966,37541,281507
201702,2017,경부선,오산대,56541,10147,66688
201702,2017,경부선,용산,1002084,119356,1121440
201702,2017,경부선,의왕,203333,34402,237735
201702,2017,경부선,가산디지털단지,415242,26658,441900
201702,2017,경부선,관악,189922,49515,239437
201702,2017,경부선,광명,38929,2599,41528
201702,2017,경부선,구로,512520,85308,597828
201702,2017,경부선,군포,177672,30309,207981
201702,2017,경부선,금정,696711,97390,794101
201702,2017,경부선,금천구청,257962,70160,328122
201702,2017,경부선,남영,264776,37159,301935
201702,2017,경부선,노량진,423963,45849,469812
201702,2017,경부선,당정,170396,26326,196722
201702,2017,경부선,대방,370622,67960,438582
201702,2017,경부선,독산,391183,59358,450541
201702,2017,경부선,두정,131134,20041,151175
201702,2017,경부선,직산,21089,5044,26133
201702,2017,경원선,지행,162068,40608,202676
201702,2017,경원선,방학,189734,92778,282512
201702,2017,경원선,청량리(서울시립대입구),300264,124968,425232
201702,2017,경원선,한남,93881,30599,124480
201702,2017,경원선,회룡,245389,122574,367963
201702,2017,경원선,보산,37975,13363,51338
201702,2017,경원선,서빙고,43914,14662,58576
201702,2017,경원선,석계,240344,57998,298342
201702,2017,경원선,소요산,54428,59913,114341
201702,2017,경원선,신이문,212425,59416,271841
201702,2017,경원선,양주,204344,45993,250337
201702,2017,경원선,옥수,1202,112,1314
201702,2017,경원선,왕십리(성동구청),419107,54632,473739
201702,2017,경원선,외대앞,270568,50758,321326
201702,2017,경원선,월계,90464,46186,136650
201702,2017,경원선,응봉,37634,16343,53977
201702,2017,경원선,의정부,517363,112565,629928
201702,2017,경원선,이촌(국립중앙박물관),101269,26702,127971
201702,2017,경원선,가능,149201,54192,203393
201702,2017,경원선,광운대,207801,48737,256538
201702,2017,경원선,녹양,108868,29876,138744
201702,2017,경원선,녹천,106980,34700,141680
201702,2017,경원선,덕계,45334,14526,59860
201702,2017,경원선,덕정,150940,30711,181651
201702,2017,경원선,도봉,118482,61484,179966
201702,2017,경원선,도봉산,145165,77719,222884
201702,2017,경원선,동두천,41641,16443,58084
201702,2017,경원선,동두천중앙,74681,37504,112185
201702,2017,경원선,망월사,155435,61306,216741
201702,2017,경원선,창동,6,0,6
201702,2017,경의선,일산,208752,50122,258874
201702,2017,경의선,백마,157824,28019,185843
201702,2017,경의선,파주,27524,6291,33815
201702,2017,경의선,풍산,105592,24926,130518
201702,2017,경의선,행신,181477,30583,212060
201702,2017,경의선,홍대입구,43783,4164,47947
201702,2017,경의선,화전,37765,7206,44971
201702,2017,경의선,효창공원앞,45991,10213,56204
201702,2017,경의선,서강대,52211,8107,60318
201702,2017,경의선,서울역,70382,9085,79467
201702,2017,경의선,수색,51091,15013,66104
201702,2017,경의선,신촌,18758,2862,21620
201702,2017,경의선,야당,79234,19113,98347
201702,2017,경의선,운정,111591,25205,136796
201702,2017,경의선,월롱,51608,6996,58604
201702,2017,경의선,가좌,86336,38235,124571
201702,2017,경의선,강매,57149,13536,70685
201702,2017,경의선,곡산,11329,4030,15359
201702,2017,경의선,공덕,55495,8892,64387
201702,2017,경의선,금릉,115144,21919,137063
201702,2017,경의선,금촌,161617,39558,201175
201702,2017,경의선,능곡,79250,25856,105106
201702,2017,경의선,디지털미디어시티,54655,8558,63213
201702,2017,경의선,문산,138717,39249,177966
201702,2017,경의선,탄현,183608,33811,217419
201702,2017,경인선,인천,96424,29634,126058
201702,2017,경인선,제물포,224313,49013,273326
201702,2017,경인선,주안,627478,96122,723600
201702,2017,경인선,중동,224619,58945,283564
201702,2017,경인선,백운,192516,59223,251739
201702,2017,경인선,부개,228825,58146,286971
201702,2017,경인선,부천,980704,191086,1171790
201702,2017,경인선,부평,995672,131252,1126924
201702,2017,경인선,소사,283605,78592,362197
201702,2017,경인선,송내,800903,105268,906171
201702,2017,경인선,역곡,709378,129686,839064
201702,2017,경인선,오류동,263969,79757,343726
201702,2017,경인선,온수(성공회대입구),148009,40208,188217
201702,2017,경인선,간석,149248,39931,189179
201702,2017,경인선,개봉,530908,141477,672385
201702,2017,경인선,구일,188371,32695,221066
201702,2017,경인선,도원,66824,31364,98188
201702,2017,경인선,도화,77610,31464,109074
201702,2017,경인선,동암,480870,101884,582754
201702,2017,경인선,동인천,415020,113465,528485
201701,2017,6호선,상수,301359,21064,322423
201701,2017,6호선,상월곡(한국과학기술연구원),138124,33809,171933
201701,2017,6호선,새절(신사),301854,76900,378754
201701,2017,6호선,석계,307043,66712,373755
201701,2017,6호선,신당,202934,33643,236577
201701,2017,6호선,안암(고대병원앞),306744,27979,334723
201701,2017,6호선,약수,82136,21315,103451
201701,2017,6호선,역촌,80734,29945,110679
201701,2017,6호선,연신내,9,1,10
201701,2017,6호선,월곡(동덕여대),278435,67453,345888
201701,2017,6호선,월드컵경기장(성산),124113,43150,167263
201701,2017,6호선,응암,412539,96949,509488
201701,2017,6호선,이태원,455375,33560,488935
201701,2017,6호선,증산(명지대앞),241009,60576,301585
201701,2017,6호선,창신,75872,15601,91473
201701,2017,6호선,청구,91611,16628,108239
201701,2017,6호선,태릉입구,121967,24579,146546
201701,2017,6호선,한강진,184793,11970,196763
201701,2017,6호선,합정,365006,34763,399769
201701,2017,6호선,화랑대(서울여대입구),309171,40652,349823
201701,2017,6호선,공덕,437142,64656,501798
201701,2017,7호선,가산디지털단지,1118954,68374,1187328
201701,2017,7호선,학동,560001,53672,613673
201701,2017,7호선,건대입구,432578,48544,481122
201701,2017,7호선,고속터미널,607793,72493,680286
201701,2017,7호선,공릉(서울과학기술대),286665,59742,346407
201701,2017,7호선,광명사거리,662923,137159,800082
201701,2017,7호선,군자(능동),356354,69848,426202
201701,2017,7호선,굴포천,234523,29287,263810
201701,2017,7호선,까치울,165226,18870,184096
201701,2017,7호선,남구로,426805,54502,481307
201701,2017,7호선,남성,268452,61115,329567
201701,2017,7호선,내방,344803,57861,402664
201701,2017,7호선,노원,523864,100487,624351
201701,2017,7호선,논현,516878,46081,562959
201701,2017,7호선,대림(구로구청),308938,33086,342024
201701,2017,7호선,도봉산,215779,33166,248945
201701,2017,7호선,뚝섬유원지,188746,33691,222437
201701,2017,7호선,마들,286289,67306,353595
201701,2017,7호선,먹골,254075,52263,306338
201701,2017,7호선,면목,362724,75790,438514
201701,2017,7호선,반포,154791,28274,183065
201701,2017,7호선,보라매,225403,37986,263389
201701,2017,7호선,부천시청,330227,39972,370199
201701,2017,7호선,부천종합운동장,134341,14403,148744
201701,2017,7호선,부평구청,317008,26844,343852
201701,2017,7호선,사가정,373884,82675,456559
201701,2017,7호선,삼산체육관,132342,21104,153446
201701,2017,7호선,상도,251215,54388,305603
201701,2017,7호선,상동,377838,39349,417187
201701,2017,7호선,상봉(시외버스터미널),443293,65989,509282
201701,2017,7호선,수락산,327787,76136,403923
201701,2017,7호선,숭실대입구(살피재),329586,51772,381358
201701,2017,7호선,신대방삼거리,380857,83361,464218
201701,2017,7호선,신중동,375574,42624,418198
201701,2017,7호선,신풍,254788,57682,312470
201701,2017,7호선,어린이대공원(세종대),337753,37053,374806
201701,2017,7호선,온수(성공회대입구),262024,30773,292797
201701,2017,7호선,용마산,150344,31707,182051
201701,2017,7호선,이수,418962,69748,488710
201701,2017,7호선,장승배기,252327,68606,320933
201701,2017,7호선,장암,60157,6129,66286
201701,2017,7호선,중계,359196,82207,441403
201701,2017,7호선,중곡,235393,55335,290728
201701,2017,7호선,중화,274572,53421,327993
201701,2017,7호선,천왕,199337,40195,239532
201701,2017,7호선,철산,610353,89071,699424
201701,2017,7호선,청담,524944,66634,591578
201701,2017,7호선,춘의,223125,24264,247389
201701,2017,7호선,태릉입구,206309,35263,241572
201701,2017,7호선,하계,480399,94341,574740
201701,2017,7호선,강남구청,379959,43285,423244
201701,2017,8호선,가락시장,167936,52102,220038
201701,2017,8호선,천호(풍납토성),463953,82793,546746
201701,2017,8호선,남한산성입구(성남법원.검찰청),328780,66092,394872
201701,2017,8호선,단대오거리,277515,62246,339761
201701,2017,8호선,모란,87158,46993,134151
201701,2017,8호선,몽촌토성(평화의문),149982,35558,185540
201701,2017,8호선,문정,252397,32378,284775
201701,2017,8호선,복정,241244,35878,277122
201701,2017,8호선,산성,149389,31768,181157
201701,2017,8호선,석촌,209828,53381,263209
201701,2017,8호선,송파,117702,31011,148713
201701,2017,8호선,수진,113149,40662,153811
201701,2017,8호선,신흥,105125,41372,146497
201701,2017,8호선,암사,426368,78955,505323
201701,2017,8호선,잠실(송파구청),353476,56167,409643
201701,2017,8호선,장지,397620,53803,451423
201701,2017,8호선,강동구청,251454,55460,306914
201701,2017,9호선,가양,494123,108008,602131
201701,2017,9호선,개화,148304,27753,176057
201701,2017,9호선,고속터미널,355376,43566,398942
201701,2017,9호선,공항시장,66421,19366,85787
201701,2017,9호선,구반포,73130,21176,94306
201701,2017,9호선,국회의사당,394354,47958,442312
201701,2017,9호선,김포공항,259916,17277,277193
201701,2017,9호선,노들,112328,26672,139000
201701,2017,9호선,노량진,767308,80433,847741
201701,2017,9호선,당산,461861,53949,515810
201701,2017,9호선,동작(현충원),41171,11839,53010
201701,2017,9호선,등촌,225808,71751,297559
201701,2017,9호선,마곡나루,81700,9092,90792
201701,2017,9호선,사평,62795,12259,75054
201701,2017,9호선,샛강,124394,22033,146427
201701,2017,9호선,선유도,171400,23111,194511
201701,2017,9호선,신논현,827260,43898,871158
201701,2017,9호선,신목동,100404,15622,116026
201701,2017,9호선,신반포,77642,21173,98815
201701,2017,9호선,신방화,192678,38774,231452
201701,2017,9호선,양천향교,181039,34928,215967
201701,2017,9호선,여의도,525209,37511,562720
201701,2017,9호선,염창,406958,53065,460023
201701,2017,9호선,증미,171439,38339,209778
201701,2017,9호선,흑석(중앙대입구),208940,47869,256809
201701,2017,9호선2단계,봉은사,325305,31489,356794
201701,2017,9호선2단계,삼성중앙,117866,16851,134717
201701,2017,9호선2단계,종합운동장,159454,11898,171352
201701,2017,9호선2단계,언주,208025,20114,228139
201701,2017,9호선2단계,선정릉,175908,15812,191720
201701,2017,경강선,초월,51358,8474,59832
201701,2017,경강선,판교,69516,7324,76840
201701,2017,경강선,부발,37471,4310,41781
201701,2017,경강선,삼동,32008,5893,37901
201701,2017,경강선,세종대왕릉,5578,2625,8203
201701,2017,경강선,곤지암,44723,9473,54196
201701,2017,경강선,여주,44512,13905,58417
201701,2017,경강선,이매,32884,7875,40759
201701,2017,경강선,이천,58776,9801,68577
201701,2017,경강선,경기광주,122659,16355,139014
201701,2017,경강선,신둔도예촌,21475,4139,25614
201701,2017,경부선,지제,40693,5182,45875
201701,2017,경부선,명학,235349,38101,273450
201701,2017,경부선,진위,37391,6942,44333
201701,2017,경부선,천안,163412,55100,218512
201701,2017,경부선,평택,334590,60258,394848
201701,2017,경부선,화서,196457,36006,232463
201701,2017,경부선,병점,350347,49827,400174
201701,2017,경부선,서동탄,36670,7618,44288
201701,2017,경부선,서울역,10,1,11
201701,2017,경부선,서정리,110467,22429,132896
201701,2017,경부선,석수,278102,41771,319873
201701,2017,경부선,성균관대,373651,47067,420718
201701,2017,경부선,성환,83606,18069,101675
201701,2017,경부선,세류,103636,16540,120176
201701,2017,경부선,세마,61375,11157,72532
201701,2017,경부선,송탄,116478,22422,138900
201701,2017,경부선,수원,1113033,125213,1238246
201701,2017,경부선,신길,253489,41605,295094
201701,2017,경부선,신도림,87009,16996,104005
201701,2017,경부선,안양,626146,103354,729500
201701,2017,경부선,영등포,1279065,251869,1530934
201701,2017,경부선,오산,258287,36584,294871
201701,2017,경부선,오산대,54985,9745,64730
201701,2017,경부선,용산,1052806,118902,1171708
201701,2017,경부선,의왕,203706,34043,237749
201701,2017,경부선,가산디지털단지,418597,25874,444471
201701,2017,경부선,관악,192508,48347,240855
201701,2017,경부선,광명,38755,2412,41167
201701,2017,경부선,구로,528866,84268,613134
201701,2017,경부선,군포,182611,30314,212925
201701,2017,경부선,금정,715728,95593,811321
201701,2017,경부선,금천구청,261828,67456,329284
201701,2017,경부선,남영,271386,37326,308712
201701,2017,경부선,노량진,448725,53729,502454
201701,2017,경부선,당정,171829,25226,197055
201701,2017,경부선,대방,376721,66124,442845
201701,2017,경부선,독산,397994,61022,459016
201701,2017,경부선,두정,134697,19727,154424
201701,2017,경부선,직산,23154,4886,28040
201701,2017,경원선,지행,162595,40292,202887
201701,2017,경원선,방학,196247,93075,289322
201701,2017,경원선,청량리(서울시립대입구),317457,129708,447165
201701,2017,경원선,한남,95634,30030,125664
201701,2017,경원선,회룡,250962,120401,371363
201701,2017,경원선,보산,39497,13102,52599
201701,2017,경원선,서빙고,45457,14585,60042
201701,2017,경원선,석계,245101,57454,302555
201701,2017,경원선,소요산,59229,57118,116347
201701,2017,경원선,신이문,217879,60498,278377
201701,2017,경원선,양주,208921,45124,254045
201701,2017,경원선,옥수,1432,104,1536
201701,2017,경원선,왕십리(성동구청),421626,54734,476360
201701,2017,경원선,외대앞,271411,51556,322967
201701,2017,경원선,월계,90222,46889,137111
201701,2017,경원선,응봉,38696,16032,54728
201701,2017,경원선,의정부,536158,108869,645027
201701,2017,경원선,이촌(국립중앙박물관),103500,26582,130082
201701,2017,경원선,가능,154502,54444,208946
201701,2017,경원선,광운대,209306,49332,258638
201701,2017,경원선,녹양,109677,29284,138961
201701,2017,경원선,녹천,110253,34908,145161
201701,2017,경원선,덕계,45120,14274,59394
201701,2017,경원선,덕정,148262,30501,178763
201701,2017,경원선,도봉,124000,61149,185149
201701,2017,경원선,도봉산,147183,73648,220831
201701,2017,경원선,동두천,42171,16003,58174
201701,2017,경원선,동두천중앙,78320,36837,115157
201701,2017,경원선,망월사,151354,59446,210800
201701,2017,경원선,창동,2,0,2
201701,2017,경의선,일산,208761,49071,257832
201701,2017,경의선,백마,158174,27253,185427
201701,2017,경의선,파주,27208,6122,33330
201701,2017,경의선,풍산,106668,24204,130872
201701,2017,경의선,행신,186579,30280,216859
201701,2017,경의선,홍대입구,42712,4073,46785
201701,2017,경의선,화전,38372,6972,45344
201701,2017,경의선,효창공원앞,46481,9831,56312
201701,2017,경의선,서강대,51704,7941,59645
201701,2017,경의선,서울역,70784,8603,79387
201701,2017,경의선,수색,49733,14985,64718
201701,2017,경의선,신촌,18582,2826,21408
201701,2017,경의선,야당,77413,18449,95862
201701,2017,경의선,운정,112371,24902,137273
201701,2017,경의선,월롱,51993,7118,59111
201701,2017,경의선,가좌,85649,38212,123861
201701,2017,경의선,강매,57151,13290,70441
201701,2017,경의선,곡산,11179,3968,15147
201701,2017,경의선,공덕,53431,8636,62067
201701,2017,경의선,금릉,114614,21843,136457
201701,2017,경의선,금촌,166393,38755,205148
201701,2017,경의선,능곡,80919,26066,106985
201701,2017,경의선,디지털미디어시티,54920,8941,63861
201701,2017,경의선,문산,142146,38086,180232
201701,2017,경의선,탄현,185554,32457,218011
201701,2017,경인선,인천,94127,29577,123704
201701,2017,경인선,제물포,224045,48478,272523
201701,2017,경인선,주안,636553,94309,730862
201701,2017,경인선,중동,231230,58154,289384
201701,2017,경인선,백운,198335,58755,257090
201701,2017,경인선,부개,235207,57039,292246
201701,2017,경인선,부천,1008811,187844,1196655
201701,2017,경인선,부평,1024933,127835,1152768
201701,2017,경인선,소사,291198,76892,368090
201701,2017,경인선,송내,814479,103013,917492
201701,2017,경인선,역곡,724087,127655,851742
201701,2017,경인선,오류동,269319,78775,348094
201701,2017,경인선,온수(성공회대입구),150795,39476,190271
201701,2017,경인선,간석,152130,39321,191451
201701,2017,경인선,개봉,545765,138262,684027
201701,2017,경인선,구일,188026,29776,217802
201701,2017,경인선,도원,63762,31873,95635
201701,2017,경인선,도화,77727,31907,109634
201701,2017,경인선,동암,499558,100000,599558
201701,2017,경인선,동인천,423622,114386,538008
201701,2017,경춘선,평내호평,124036,34884,158920
201701,2017,경춘선,천마산,25712,12896,38608
201701,2017,경춘선,춘천,37790,14755,52545
201701,2017,경춘선,굴봉산,4887,1067,5954
201701,2017,경춘선,청평,54346,12757,67103
201701,2017,경춘선,강촌,13536,3174,16710
201701,2017,경춘선,갈매,36354,10430,46784
201701,2017,경춘선,가평,52601,10683,63284
201701,2017,경춘선,마석,69795,26975,96770
201701,2017,경춘선,남춘천,61640,20561,82201
201701,2017,경춘선,백양리,11434,717,12151
201701,2017,경춘선,김유정,9938,2416,12354
201701,2017,경춘선,별내,49952,13513,63465
201701,2017,경춘선,사릉,79349,15796,95145
201701,2017,경춘선,상천,6396,2809,9205
201701,2017,경춘선,대성리,15810,3982,19792
201701,2017,경춘선,금곡,27704,11937,39641
201701,2017,경춘선,신내,12900,5661,18561
201701,2017,경춘선,퇴계원,74945,21929,96874
201701,2017,공항철도 1호선,공항화물청사,68272,7231,75503
201701,2017,공항철도 1호선,공덕,41018,5562,46580
201701,2017,공항철도 1호선,계양,283851,26448,310299
201701,2017,공항철도 1호선,검암,250499,21418,271917
201701,2017,공항철도 1호선,운서,137730,20662,158392
201701,2017,공항철도 1호선,영종,40519,9501,50020
201701,2017,공항철도 1호선,서울역,274439,26675,301114
201701,2017,공항철도 1호선,홍대입구,239620,15533,255153
201701,2017,공항철도 1호선,청라국제도시,129131,7554,136685
201701,2017,공항철도 1호선,인천국제공항,418854,36730,455584
201701,2017,공항철도 1호선,디지털미디어시티,317512,19767,337279
201701,2017,공항철도 1호선,김포공항,292676,16755,309431
201701,2017,과천선,범계,781873,94606,876479
201701,2017,과천선,인덕원,639900,89477,729377
201701,2017,과천선,평촌,407239,55671,462910
201701,2017,과천선,대공원,69632,20956,90588
201701,2017,과천선,정부과천청사,303465,58835,362300
201701,2017,과천선,선바위,220416,26337,246753
201701,2017,과천선,경마공원,126771,45921,172692
201701,2017,과천선,과천,113277,30284,143561
201701,2017,분당선,가천대,171254,21370,192624
201701,2017,분당선,한티,363631,58882,422513
201701,2017,분당선,개포동,82482,19391,101873
201701,2017,분당선,구룡,36283,16266,52549
201701,2017,분당선,구성,107395,34669,142064
201701,2017,분당선,기흥,180867,27422,208289
201701,2017,분당선,대모산입구,70567,25721,96288
201701,2017,분당선,도곡,147504,34093,181597
201701,2017,분당선,망포,323748,26124,349872
201701,2017,분당선,매교,57185,15596,72781
201701,2017,분당선,매탄권선,108008,12532,120540
201701,2017,분당선,모란,518159,142835,660994
201701,2017,분당선,미금,462331,107046,569377
201701,2017,분당선,보정,55749,21999,77748
201701,2017,분당선,복정,3,0,3
201701,2017,분당선,상갈,122759,26762,149521
201701,2017,분당선,서울숲,157713,18627,176340
201701,2017,분당선,서현,679405,116518,795923
201701,2017,분당선,선릉,221506,24311,245817
201701,2017,분당선,선정릉,189362,30935,220297
201701,2017,분당선,수내,341355,70646,412001
201701,2017,분당선,수서,317811,49616,367427
201701,2017,분당선,수원,256050,24507,280557
201701,2017,분당선,수원시청,275936,29883,305819
201701,2017,분당선,신갈,104892,26983,131875
201701,2017,분당선,압구정로데오,385493,35496,420989
201701,2017,분당선,야탑,684349,136793,821142
201701,2017,분당선,영통,223890,25425,249315
201701,2017,분당선,오리,344528,83505,428033
201701,2017,분당선,이매,123380,34300,157680
201701,2017,분당선,정자,422354,72795,495149
201701,2017,분당선,죽전,374395,70000,444395
201701,2017,분당선,청명,102081,14743,116824
201701,2017,분당선,태평,352438,81254,433692
201701,2017,분당선,강남구청,207226,34439,241665
201701,2017,수인선,남동인더스파크,56746,4404,61150
201701,2017,수인선,달월,2266,1104,3370
201701,2017,수인선,소래포구,102008,35473,137481
201701,2017,수인선,송도,67351,18667,86018
201701,2017,수인선,숭의,65500,20102,85602
201701,2017,수인선,신포,39358,10297,49655
201701,2017,수인선,호구포,90826,14523,105349
201701,2017,수인선,원인재,119039,24796,143835
201701,2017,수인선,월곶,61325,11060,72385
201701,2017,수인선,인천,21356,8016,29372
201701,2017,수인선,인천논현,149732,27716,177448
201701,2017,수인선,인하대,118648,18021,136669
201701,2017,수인선,연수,122525,23308,145833
201701,2017,안산선,고잔,222696,30193,252889
201701,2017,안산선,대야미,95170,19409,114579
201701,2017,안산선,반월,118018,25234,143252
201701,2017,안산선,산본,438060,89148,527208
201701,2017,안산선,상록수,510578,73952,584530
201701,2017,안산선,수리산,100326,28292,128618
201701,2017,안산선,한대앞,219411,35870,255281
201701,2017,안산선,안산,482550,39806,522356
201701,2017,안산선,오이도,213317,26651,239968
201701,2017,안산선,정왕,219132,21116,240248
201701,2017,안산선,중앙,446267,51691,497958
201701,2017,안산선,초지,91928,13686,105614
201701,2017,안산선,신길온천,42065,7427,49492
201701,2017,일산선,대곡,32324,7734,40058
201701,2017,일산선,화정,448013,117799,565812
201701,2017,일산선,마두,169588,66260,235848
201701,2017,일산선,대화,332750,78365,411115
201701,2017,일산선,지축,1,0,1
201701,2017,일산선,주엽,182444,83245,265689
201701,2017,일산선,정발산,211962,48866,260828
201701,2017,일산선,원흥,152299,33217,185516
201701,2017,일산선,원당,267429,74271,341700
201701,2017,일산선,백석,279281,70610,349891
201701,2017,일산선,삼송,309968,71553,381521
201701,2017,장항선,쌍용(나사렛대),50513,13366,63879
201701,2017,장항선,신창(순천향대),31937,7147,39084
201701,2017,장항선,온양온천,96317,65139,161456
201701,2017,장항선,봉명,26978,12889,39867
201701,2017,장항선,아산,66825,7374,74199
201701,2017,장항선,배방,22825,6439,29264
201701,2017,중앙선,구리,316881,72260,389141
201701,2017,중앙선,회기,664299,115479,779778
201701,2017,중앙선,덕소,136156,44548,180704
201701,2017,중앙선,도농,198549,49471,248020
201701,2017,중앙선,국수,14426,6985,21411
201701,2017,중앙선,팔당,17356,4921,22277
201701,2017,중앙선,지평,376,216,592
201701,2017,중앙선,중랑,128088,46495,174583
201701,2017,중앙선,원덕,7152,4168,11320
201701,2017,중앙선,운길산,18057,5774,23831
201701,2017,중앙선,용문,46662,32418,79080
201701,2017,중앙선,오빈,6605,3160,9765
201701,2017,중앙선,양평,78462,28043,106505
201701,2017,중앙선,양정,16079,6230,22309
201701,2017,중앙선,양원,31106,14111,45217
201701,2017,중앙선,양수,38630,14203,52833
201701,2017,중앙선,아신,14735,4570,19305
201701,2017,중앙선,신원,3787,2481,6268
201701,2017,중앙선,상봉(시외버스터미널),127877,32279,160156
201701,2017,중앙선,망우,178241,59177,237418
201701,2017,중앙선,도심,53760,18007,71767
201701,2017,1호선,동대문,325095,119005,444100
201701,2017,1호선,동묘앞,154770,122514,277284
201701,2017,1호선,서울역,1554791,195708,1750499
201701,2017,1호선,시청,619719,106795,726514
201701,2017,1호선,청량리(서울시립대입구),508158,338786,846944
201701,2017,1호선,제기동,282753,308591,591344
201701,2017,1호선,종각,1231571,141085,1372656
201701,2017,1호선,종로3가,716837,328316,1045153
201701,2017,1호선,종로5가,525915,229453,755368
201701,2017,1호선,신설동,335501,110943,446444
201701,2017,2호선,강남,2974554,158179,3132733
201701,2017,2호선,홍대입구,2281971,104746,2386717
201701,2017,2호선,건대입구,1220123,86265,1306388
201701,2017,2호선,교대(법원.검찰청),898850,145579,1044429
201701,2017,2호선,구로디지털단지,1691930,152342,1844272
201701,2017,2호선,구의(광진구청),601330,98482,699812
201701,2017,2호선,낙성대,776266,99186,875452
201701,2017,2호선,당산,526992,57647,584639
201701,2017,2호선,대림(구로구청),791033,105236,896269
201701,2017,2호선,도림천,22883,5179,28062
201701,2017,2호선,동대문역사문화공원,448934,51459,500393
201701,2017,2호선,뚝섬,390979,56918,447897
201701,2017,2호선,문래,468574,73569,542143
201701,2017,2호선,방배,478871,73197,552068
201701,2017,2호선,봉천,537433,130485,667918
201701,2017,2호선,사당,1022523,170271,1192794
201701,2017,2호선,삼성(무역센터),1503128,121565,1624693
201701,2017,2호선,상왕십리,277218,56971,334189
201701,2017,2호선,서울대입구(관악구청),1313526,189566,1503092
201701,2017,2호선,서초,558665,74810,633475
201701,2017,2호선,선릉,1395768,188919,1584687
201701,2017,2호선,성수,670857,91698,762555
201701,2017,2호선,시청,644373,63504,707877
201701,2017,2호선,신답,27487,8917,36404
201701,2017,2호선,신당,329593,97624,427217
201701,2017,2호선,신대방,703147,116027,819174
201701,2017,2호선,신도림,1594741,184282,1779023
201701,2017,2호선,신림,1859342,218538,2077880
201701,2017,2호선,신설동,83826,31006,114832
201701,2017,2호선,신정네거리,229252,58529,287781
201701,2017,2호선,신촌,1330202,127638,1457840
201701,2017,2호선,아현,212147,56515,268662
201701,2017,2호선,양천구청,161756,40572,202328
201701,2017,2호선,역삼,1204407,141353,1345760
201701,2017,2호선,영등포구청,520987,95293,616280
201701,2017,2호선,왕십리(성동구청),501916,53008,554924
201701,2017,2호선,용답,57081,15288,72369
201701,2017,2호선,용두(동대문구청),45721,22497,68218
201701,2017,2호선,을지로3가,509048,80774,589822
201701,2017,2호선,을지로4가,277033,90291,367324
201701,2017,2호선,을지로입구,1369701,107577,1477278
201701,2017,2호선,이대,456636,52941,509577
201701,2017,2호선,잠실(송파구청),2409488,190699,2600187
201701,2017,2호선,잠실나루,423479,78367,501846
201701,2017,2호선,잠실새내,662847,106545,769392
201701,2017,2호선,종합운동장,299679,43948,343627
201701,2017,2호선,충정로(경기대입구),280442,48694,329136
201701,2017,2호선,한양대,214902,13509,228411
201701,2017,2호선,합정,885341,65886,951227
201701,2017,2호선,강변(동서울터미널),1305307,125845,1431152
201701,2017,3호선,가락시장,219673,64750,284423
201701,2017,3호선,홍제,429028,138185,567213
201701,2017,3호선,경찰병원,186206,35341,221547
201701,2017,3호선,고속터미널,1622126,160570,1782696
201701,2017,3호선,교대(법원.검찰청),344755,61847,406602
201701,2017,3호선,구파발,495978,89365,585343
201701,2017,3호선,금호,192812,48993,241805
201701,2017,3호선,남부터미널(예술의전당),946260,114540,1060800
201701,2017,3호선,녹번,315277,62500,377777
201701,2017,3호선,대청,235287,46342,281629
201701,2017,3호선,대치,308774,55536,364310
201701,2017,3호선,도곡,162653,25799,188452
201701,2017,3호선,독립문,148788,63622,212410
201701,2017,3호선,동대입구,285988,33317,319305
201701,2017,3호선,매봉,285079,49978,335057
201701,2017,3호선,무악재,91279,29791,121070
201701,2017,3호선,불광,420257,135795,556052
201701,2017,3호선,수서,403743,88076,491819
201701,2017,3호선,신사,839190,66403,905593
201701,2017,3호선,안국,600328,111876,712204
201701,2017,3호선,압구정,883061,129806,1012867
201701,2017,3호선,약수,329769,76907,406676
201701,2017,3호선,양재(서초구청),1012534,139586,1152120
201701,2017,3호선,연신내,985769,236043,1221812
201701,2017,3호선,오금,176273,24264,200537
201701,2017,3호선,옥수,228050,51034,279084
201701,2017,3호선,을지로3가,206054,54125,260179
201701,2017,3호선,일원,198444,50541,248985
201701,2017,3호선,잠원,139642,30355,169997
201701,2017,3호선,종로3가,202363,51523,253886
201701,2017,3호선,지축,25325,9571,34896
201701,2017,3호선,충무로,48,3,51
201701,2017,3호선,학여울,68235,18267,86502
201701,2017,3호선,경복궁(정부서울청사),580312,77657,657969
201701,2017,4호선,길음,614393,131481,745874
201701,2017,4호선,회현(남대문시장),661549,159816,821365
201701,2017,4호선,노원,589209,81634,670843
201701,2017,4호선,당고개,297870,82414,380284
201701,2017,4호선,동대문,562923,126558,689481
201701,2017,4호선,동대문역사문화공원,604053,58226,662279
201701,2017,4호선,동작(현충원),47689,16568,64257
201701,2017,4호선,명동,1089971,66256,1156227
201701,2017,4호선,미아(서울사이버대학),415303,120040,535343
201701,2017,4호선,미아사거리,776710,169238,945948
201701,2017,4호선,사당,769501,83529,853030
201701,2017,4호선,삼각지,116988,28671,145659
201701,2017,4호선,상계,514135,104759,618894
201701,2017,4호선,서울역,299984,35472,335456
201701,2017,4호선,성신여대입구(돈암),640135,94729,734864
201701,2017,4호선,수유(강북구청),1066436,231532,1297968
201701,2017,4호선,숙대입구(갈월),392035,53690,445725
201701,2017,4호선,신용산,333785,43923,377708
201701,2017,4호선,쌍문,818891,151073,969964
201701,2017,4호선,이촌(국립중앙박물관),264458,41868,306326
201701,2017,4호선,창동,682581,171691,854272
201701,2017,4호선,총신대입구(이수),503142,127278,630420
201701,2017,4호선,충무로,770710,115442,886152
201701,2017,4호선,한성대입구(삼선교),362313,70666,432979
201701,2017,4호선,혜화,1077823,123073,1200896
201701,2017,4호선,남태령,39992,7494,47486
201701,2017,5호선,강동,457867,83503,541370
201701,2017,5호선,화곡,720603,124393,844996
201701,2017,5호선,개화산,143157,30668,173825
201701,2017,5호선,거여,148034,44497,192531
201701,2017,5호선,고덕,185690,50733,236423
201701,2017,5호선,공덕,325346,41407,366753
201701,2017,5호선,광나루(장신대),337049,55461,392510
201701,2017,5호선,광화문(세종문화회관),1015662,81084,1096746
201701,2017,5호선,군자(능동),279745,35303,315048
201701,2017,5호선,굽은다리(강동구민회관앞),226818,56644,283462
201701,2017,5호선,길동,166721,53757,220478
201701,2017,5호선,김포공항,211735,25623,237358
201701,2017,5호선,까치산,740196,139323,879519
201701,2017,5호선,답십리,390384,74605,464989
201701,2017,5호선,동대문역사문화공원,77513,9691,87204
201701,2017,5호선,둔촌동,296845,69025,365870
201701,2017,5호선,마곡,120861,18045,138906
201701,2017,5호선,마장,136780,43938,180718
201701,2017,5호선,마천,106190,43378,149568
201701,2017,5호선,마포,356083,56980,413063
201701,2017,5호선,명일,178353,54141,232494
201701,2017,5호선,목동,450942,74761,525703
201701,2017,5호선,발산,304179,52511,356690
201701,2017,5호선,방이,169466,37726,207192
201701,2017,5호선,방화,172331,41239,213570
201701,2017,5호선,상일동,257428,53404,310832
201701,2017,5호선,서대문,399925,62578,462503
201701,2017,5호선,송정,218929,55361,274290
201701,2017,5호선,신금호,134022,34966,168988
201701,2017,5호선,신길,74219,10812,85031
201701,2017,5호선,신정(은행정),365286,53261,418547
201701,2017,5호선,아차산(어린이대공원후문),325246,80159,405405
201701,2017,5호선,애오개,162365,34731,197096
201701,2017,5호선,양평,153086,25521,178607
201701,2017,5호선,여의나루,179121,22894,202015
201701,2017,5호선,여의도,616927,49291,666218
201701,2017,5호선,영등포구청,76959,17630,94589
201701,2017,5호선,영등포시장,174784,67495,242279
201701,2017,5호선,오금,87121,15288,102409
201701,2017,5호선,오목교(목동운동장앞),665749,77170,742919
201701,2017,5호선,올림픽공원(한국체대),120671,29243,149914
201701,2017,5호선,왕십리(성동구청),124539,22526,147065
201701,2017,5호선,우장산,371493,71224,442717
201701,2017,5호선,을지로4가,103092,38864,141956
201701,2017,5호선,장한평,438954,86952,525906
201701,2017,5호선,종로3가,294141,114602,408743
201701,2017,5호선,천호(풍납토성),475811,131438,607249
201701,2017,5호선,청구,88991,23987,112978
201701,2017,5호선,충정로(경기대입구),113385,16859,130244
201701,2017,5호선,행당,195289,43216,238505
201701,2017,5호선,개롱,154125,38378,192503
201701,2017,6호선,고려대(종암),224013,30545,254558
201701,2017,6호선,효창공원앞,162186,36310,198496
201701,2017,6호선,광흥창(서강),219677,50519,270196
201701,2017,6호선,구산,180678,49336,230014
201701,2017,6호선,녹사평(용산구청),180129,18262,198391
201701,2017,6호선,대흥(서강대앞),184003,38212,222215
201701,2017,6호선,독바위,67113,17947,85060
201701,2017,6호선,돌곶이,213354,56314,269668
201701,2017,6호선,동묘앞,195323,60469,255792
201701,2017,6호선,디지털미디어시티,357582,53387,410969
201701,2017,6호선,마포구청,317016,72128,389144
201701,2017,6호선,망원,312005,78840,390845
201701,2017,6호선,버티고개,56383,12683,69066
201701,2017,6호선,보문,203992,33916,237908
201701,2017,6호선,봉화산(서울의료원),222091,45589,267680
201701,2017,6호선,불광,131302,36825,168127
201701,2017,6호선,삼각지,180327,19030,199357
201612,2016,중앙선,국수,18876,7997,26873
201612,2016,중앙선,팔당,17514,4998,22512
201612,2016,중앙선,중랑,137621,50425,188046
201612,2016,중앙선,원덕,7246,4979,12225
201612,2016,중앙선,운길산,21107,7539,28646
201612,2016,중앙선,용문,47367,35158,82525
201612,2016,중앙선,오빈,7225,3682,10907
201612,2016,중앙선,양평,86566,32639,119205
201612,2016,중앙선,양정,18417,7129,25546
201612,2016,중앙선,양원,42372,15787,58159
201612,2016,중앙선,양수,41944,15708,57652
201612,2016,중앙선,아신,18423,5639,24062
201612,2016,중앙선,신원,4138,2593,6731
201612,2016,중앙선,상봉(시외버스터미널),141081,35586,176667
201612,2016,중앙선,망우,199079,66432,265511
201612,2016,중앙선,도심,61559,20131,81690
201612,2016,중앙선,도농,228540,56516,285056
201612,2016,중앙선,덕소,153820,49319,203139
201612,2016,중앙선,회기,815864,131425,947289
201612,2016,중앙선,구리,350690,83334,434024
201612,2016,장항선,배방,24149,7472,31621
201612,2016,장항선,아산,78691,8890,87581
201612,2016,장항선,봉명,29032,13374,42406
201612,2016,장항선,온양온천,96667,70245,166912
201612,2016,장항선,신창(순천향대),51193,8080,59273
201612,2016,장항선,쌍용(나사렛대),65509,14918,80427
201612,2016,일산선,삼송,356374,80964,437338
201612,2016,일산선,백석,305707,78262,383969
201612,2016,일산선,원당,301204,85236,386440
201612,2016,일산선,원흥,162909,37571,200480
201612,2016,일산선,정발산,238097,56757,294854
201612,2016,일산선,주엽,203446,98792,302238
201612,2016,일산선,지축,0,1,1
201612,2016,일산선,대화,389754,91618,481372
201612,2016,일산선,마두,186888,77358,264246
201612,2016,일산선,화정,497514,132807,630321
201612,2016,일산선,대곡,37150,9061,46211
201612,2016,안산선,신길온천,46753,8413,55166
201612,2016,안산선,초지,115291,15273,130564
201612,2016,안산선,중앙,486384,59137,545521
201612,2016,안산선,정왕,258126,24104,282230
201612,2016,안산선,오이도,241209,30290,271499
201612,2016,안산선,안산,488319,44275,532594
201612,2016,안산선,한대앞,259540,41068,300608
201612,2016,안산선,수리산,113067,30695,143762
201612,2016,안산선,상록수,575433,84565,659998
201612,2016,안산선,산본,484800,101278,586078
201612,2016,안산선,반월,133066,27862,160928
201612,2016,안산선,대야미,104521,21447,125968
201612,2016,안산선,고잔,251952,35161,287113
201612,2016,수인선,연수,136326,26619,162945
201612,2016,수인선,인하대,139721,20208,159929
201612,2016,수인선,인천논현,166490,30931,197421
201612,2016,수인선,인천,20801,8681,29482
201612,2016,수인선,월곶,70087,13159,83246
201612,2016,수인선,원인재,132372,27561,159933
201612,2016,수인선,호구포,98103,16433,114536
201612,2016,수인선,신포,45307,11484,56791
201612,2016,수인선,숭의,70149,22566,92715
201612,2016,수인선,송도,75705,20610,96315
201612,2016,수인선,소래포구,112398,43261,155659
201612,2016,수인선,달월,2386,1060,3446
201612,2016,수인선,남동인더스파크,59667,4745,64412
201612,2016,분당선,강남구청,226888,38722,265610
201612,2016,분당선,태평,380566,88402,468968
201612,2016,분당선,청명,114571,16503,131074
201612,2016,분당선,죽전,437367,80626,517993
201612,2016,분당선,정자,453480,82118,535598
201612,2016,분당선,이매,139234,40580,179814
201612,2016,분당선,오리,377311,94294,471605
201612,2016,분당선,영통,258248,27964,286212
201612,2016,분당선,야탑,746166,155565,901731
201612,2016,분당선,압구정로데오,423685,40112,463797
201612,2016,분당선,신갈,115399,30191,145590
201612,2016,분당선,수원시청,305439,34683,340122
201612,2016,분당선,수원,286787,26853,313640
201612,2016,분당선,수서,275735,50715,326450
201612,2016,분당선,수내,361949,80455,442404
201612,2016,분당선,선정릉,207092,38854,245946
201612,2016,분당선,선릉,237397,27494,264891
201612,2016,분당선,서현,726251,133655,859906
201612,2016,분당선,서울숲,174414,21572,195986
201612,2016,분당선,상갈,132123,30553,162676
201612,2016,분당선,복정,3,0,3
201612,2016,분당선,보정,62712,25350,88062
201612,2016,분당선,미금,493753,120593,614346
201612,2016,분당선,모란,570551,152727,723278
201612,2016,분당선,매탄권선,123175,14186,137361
201612,2016,분당선,매교,69290,17564,86854
201612,2016,분당선,망포,364063,29444,393507
201612,2016,분당선,도곡,166238,40505,206743
201612,2016,분당선,대모산입구,81171,28523,109694
201612,2016,분당선,기흥,217446,30563,248009
201612,2016,분당선,구성,117605,39765,157370
201612,2016,분당선,구룡,47450,18261,65711
201612,2016,분당선,개포동,92098,21684,113782
201612,2016,분당선,한티,367645,66608,434253
201612,2016,분당선,가천대,268475,23731,292206
201612,2016,과천선,과천,132739,34758,167497
201612,2016,과천선,경마공원,171545,60949,232494
201612,2016,과천선,선바위,258496,30873,289369
201612,2016,과천선,정부과천청사,328940,67456,396396
201612,2016,과천선,대공원,101634,31516,133150
201612,2016,과천선,평촌,455715,61625,517340
201612,2016,과천선,인덕원,728896,104367,833263
201612,2016,과천선,범계,873632,109580,983212
201612,2016,공항철도 1호선,김포공항,298046,17085,315131
201612,2016,공항철도 1호선,디지털미디어시티,349788,22815,372603
201612,2016,공항철도 1호선,인천국제공항,398647,36805,435452
201612,2016,공항철도 1호선,청라국제도시,142598,8522,151120
201612,2016,공항철도 1호선,홍대입구,260479,16781,277260
201612,2016,공항철도 1호선,서울역,284662,29808,314470
201612,2016,공항철도 1호선,영종,42860,10719,53579
201612,2016,공항철도 1호선,운서,149528,23025,172553
201612,2016,공항철도 1호선,검암,271033,24653,295686
201612,2016,공항철도 1호선,계양,313762,30229,343991
201612,2016,공항철도 1호선,공덕,42187,6086,48273
201612,2016,공항철도 1호선,공항화물청사,71766,7514,79280
201612,2016,경춘선,퇴계원,82867,23458,106325
201612,2016,경춘선,신내,14668,6153,20821
201612,2016,경춘선,금곡,30374,13566,43940
201612,2016,경춘선,대성리,15873,4092,19965
201612,2016,경춘선,상천,6593,3327,9920
201612,2016,경춘선,사릉,89460,17820,107280
201612,2016,경춘선,별내,56859,15128,71987
201612,2016,경춘선,김유정,10576,2633,13209
201612,2016,경춘선,백양리,9042,814,9856
201612,2016,경춘선,남춘천,73523,22810,96333
201612,2016,경춘선,마석,78070,29574,107644
201612,2016,경춘선,가평,56249,11649,67898
201612,2016,경춘선,갈매,37465,11282,48747
201612,2016,경춘선,강촌,15316,3013,18329
201612,2016,경춘선,청평,55696,13659,69355
201612,2016,경춘선,굴봉산,4243,1200,5443
201612,2016,경춘선,춘천,46038,14776,60814
201612,2016,경춘선,천마산,27377,13734,41111
201612,2016,경춘선,평내호평,140222,39347,179569
201612,2016,경인선,동인천,479680,126779,606459
201612,2016,경인선,동암,557080,112177,669257
201612,2016,경인선,도화,90175,36476,126651
201612,2016,경인선,도원,93126,35741,128867
201612,2016,경인선,구일,177987,32816,210803
201612,2016,경인선,개봉,607478,156949,764427
201612,2016,경인선,간석,170028,45356,215384
201612,2016,경인선,온수(성공회대입구),185952,44867,230819
201612,2016,경인선,오류동,294893,87516,382409
201612,2016,경인선,역곡,835753,144955,980708
201612,2016,경인선,송내,915320,117784,1033104
201612,2016,경인선,소사,321944,86391,408335
201612,2016,경인선,부평,1075610,143187,1218797
201612,2016,경인선,부천,1107373,208277,1315650
201612,2016,경인선,부개,265957,64487,330444
201612,2016,경인선,백운,228968,65549,294517
201612,2016,경인선,중동,255692,65232,320924
201612,2016,경인선,주안,724706,106614,831320
201612,2016,경인선,제물포,278749,53970,332719
201612,2016,경인선,인천,104645,32960,137605
201612,2016,경의선,탄현,205151,37017,242168
201612,2016,경의선,문산,153235,42072,195307
201612,2016,경의선,디지털미디어시티,62029,10038,72067
201612,2016,경의선,능곡,88598,29127,117725
201612,2016,경의선,금촌,187170,42133,229303
201612,2016,경의선,금릉,127574,24323,151897
201612,2016,경의선,공덕,54869,9358,64227
201612,2016,경의선,곡산,12652,4347,16999
201612,2016,경의선,강매,62706,14826,77532
201612,2016,경의선,가좌,97143,41613,138756
201612,2016,경의선,월롱,62092,8009,70101
201612,2016,경의선,운정,125658,28842,154500
201612,2016,경의선,야당,86580,20515,107095
201612,2016,경의선,신촌,20789,3048,23837
201612,2016,경의선,수색,53515,16599,70114
201612,2016,경의선,서울역,77083,9496,86579
201612,2016,경의선,서강대,56407,8691,65098
201612,2016,경의선,효창공원앞,53589,10618,64207
201612,2016,경의선,화전,65431,7902,73333
201612,2016,경의선,홍대입구,45857,4643,50500
201612,2016,경의선,행신,204010,34189,238199
201612,2016,경의선,풍산,118610,28045,146655
201612,2016,경의선,파주,39986,6956,46942
201612,2016,경의선,백마,175523,30575,206098
201612,2016,경의선,일산,237136,55169,292305
201612,2016,경원선,창동,2,0,2
201612,2016,경원선,망월사,197230,67696,264926
201612,2016,경원선,동두천중앙,85819,39827,125646
201612,2016,경원선,동두천,51194,18277,69471
201612,2016,경원선,도봉산,160433,82229,242662
201612,2016,경원선,도봉,135778,67811,203589
201612,2016,경원선,덕정,181966,34636,216602
201612,2016,경원선,덕계,51094,16382,67476
201612,2016,경원선,녹천,125193,38340,163533
201612,2016,경원선,녹양,125257,33530,158787
201612,2016,경원선,광운대,253739,54009,307748
201612,2016,경원선,가능,174862,62512,237374
201612,2016,경원선,이촌(국립중앙박물관),115230,29832,145062
201612,2016,경원선,의정부,587779,123238,711017
201612,2016,경원선,응봉,43113,17784,60897
201612,2016,경원선,월계,131327,51797,183124
201612,2016,경원선,외대앞,330037,56822,386859
201612,2016,경원선,왕십리(성동구청),491522,61441,552963
201612,2016,경원선,옥수,1588,103,1691
201612,2016,경원선,양주,234456,51305,285761
201612,2016,경원선,신이문,242536,67310,309846
201612,2016,경원선,소요산,60727,62044,122771
201612,2016,경원선,석계,280436,64755,345191
201612,2016,경원선,서빙고,49967,16461,66428
201612,2016,경원선,보산,47409,14512,61921
201612,2016,경원선,회룡,277851,137239,415090
201612,2016,경원선,한남,102632,32450,135082
201612,2016,경원선,청량리(서울시립대입구),324870,135302,460172
201612,2016,경원선,방학,219299,103014,322313
201612,2016,경원선,지행,189626,44914,234540
201612,2016,경부선,직산,24514,5290,29804
201612,2016,경부선,두정,171218,22520,193738
201612,2016,경부선,독산,434437,66934,501371
201612,2016,경부선,대방,423773,75650,499423
201612,2016,경부선,당정,202068,30331,232399
201612,2016,경부선,노량진,488754,59370,548124
201612,2016,경부선,남영,332824,42724,375548
201612,2016,경부선,금천구청,290208,76316,366524
201612,2016,경부선,금정,786822,107354,894176
201612,2016,경부선,군포,200626,34079,234705
201612,2016,경부선,구로,582225,94870,677095
201612,2016,경부선,광명,31058,2002,33060
201612,2016,경부선,관악,220212,53865,274077
201612,2016,경부선,가산디지털단지,453395,29777,483172
201612,2016,경부선,의왕,230726,37898,268624
201612,2016,경부선,용산,1090309,133065,1223374
201612,2016,경부선,오산대,73458,10822,84280
201612,2016,경부선,오산,280890,41455,322345
201612,2016,경부선,영등포,1369605,279616,1649221
201612,2016,경부선,안양,751967,115005,866972
201612,2016,경부선,신도림,98616,19670,118286
201612,2016,경부선,신길,283733,48060,331793
201612,2016,경부선,수원,1208232,143344,1351576
201612,2016,경부선,송탄,130797,24904,155701
201612,2016,경부선,세마,72148,12774,84922
201612,2016,경부선,세류,115467,19018,134485
201612,2016,경부선,성환,117368,20407,137775
201612,2016,경부선,성균관대,444335,52944,497279
201612,2016,경부선,석수,320302,46508,366810
201612,2016,경부선,서정리,136012,24872,160884
201612,2016,경부선,서울역,14,0,14
201612,2016,경부선,서동탄,40734,8680,49414
201612,2016,경부선,병점,426998,56416,483414
201612,2016,경부선,화서,225283,41913,267196
201612,2016,경부선,평택,378804,68178,446982
201612,2016,경부선,천안,205225,59794,265019
201612,2016,경부선,진위,45451,8044,53495
201612,2016,경부선,명학,280159,42890,323049
201612,2016,경부선,지제,38851,5758,44609
201612,2016,경강선,신둔도예촌,25379,5188,30567
201612,2016,경강선,경기광주,123469,17587,141056
201612,2016,경강선,이천,60169,11168,71337
201612,2016,경강선,이매,35223,8758,43981
201612,2016,경강선,여주,48720,16202,64922
201612,2016,경강선,곤지암,51261,11074,62335
201612,2016,경강선,세종대왕릉,5341,2974,8315
201612,2016,경강선,삼동,33449,6306,39755
201612,2016,경강선,부발,41642,5034,46676
201612,2016,경강선,판교,71691,9274,80965
201612,2016,경강선,초월,52377,9596,61973
201612,2016,9호선2단계,선정릉,194627,19497,214124
201612,2016,9호선2단계,언주,229629,24064,253693
201612,2016,9호선2단계,종합운동장,172732,13534,186266
201612,2016,9호선2단계,삼성중앙,130651,19476,150127
201612,2016,9호선2단계,봉은사,387987,35059,423046
201612,2016,9호선,흑석(중앙대입구),268312,53644,321956
201612,2016,9호선,증미,184366,40886,225252
201612,2016,9호선,염창,447473,59305,506778
201612,2016,9호선,여의도,573234,43642,616876
201612,2016,9호선,양천향교,198502,38274,236776
201612,2016,9호선,신방화,216547,43006,259553
201612,2016,9호선,신반포,87356,24097,111453
201612,2016,9호선,신목동,111803,18095,129898
201612,2016,9호선,신논현,898579,51685,950264
201612,2016,9호선,선유도,187603,24980,212583
201612,2016,9호선,샛강,134463,25442,159905
201612,2016,9호선,사평,74440,14302,88742
201612,2016,9호선,마곡나루,85621,9763,95384
201612,2016,9호선,등촌,246630,79038,325668
201612,2016,9호선,동작(현충원),43696,11542,55238
201612,2016,9호선,당산,510875,61453,572328
201612,2016,9호선,노량진,809184,88506,897690
201612,2016,9호선,노들,121705,30048,151753
201612,2016,9호선,김포공항,273846,18581,292427
201612,2016,9호선,국회의사당,456736,58599,515335
201612,2016,9호선,구반포,81118,23729,104847
201612,2016,9호선,공항시장,72022,21192,93214
201612,2016,9호선,고속터미널,451844,52922,504766
201612,2016,9호선,개화,170013,33032,203045
201612,2016,9호선,가양,540801,119050,659851
201612,2016,8호선,강동구청,275526,61852,337378
201612,2016,8호선,장지,438736,61203,499939
201612,2016,8호선,잠실(송파구청),369494,61402,430896
201612,2016,8호선,암사,470695,89058,559753
201612,2016,8호선,신흥,113860,45580,159440
201612,2016,8호선,수진,124969,43480,168449
201612,2016,8호선,송파,139000,34709,173709
201612,2016,8호선,석촌,226749,59568,286317
201612,2016,8호선,산성,169614,35669,205283
201612,2016,8호선,복정,286213,40572,326785
201612,2016,8호선,문정,264365,35925,300290
201612,2016,8호선,몽촌토성(평화의문),161963,40028,201991
201612,2016,8호선,모란,97094,50721,147815
201612,2016,8호선,단대오거리,314141,68704,382845
201612,2016,8호선,남한산성입구(성남법원.검찰청),378630,72011,450641
201612,2016,8호선,천호(풍납토성),512026,92408,604434
201612,2016,8호선,가락시장,184110,54026,238136
201612,2016,7호선,강남구청,423513,49574,473087
201612,2016,7호선,하계,550392,108347,658739
201612,2016,7호선,태릉입구,245085,39339,284424
201612,2016,7호선,춘의,236608,26484,263092
201612,2016,7호선,청담,585084,76300,661384
201612,2016,7호선,철산,683083,99883,782966
201612,2016,7호선,천왕,221525,44083,265608
201612,2016,7호선,중화,307604,60631,368235
201612,2016,7호선,중곡,266716,59864,326580
201612,2016,7호선,중계,413553,92975,506528
201612,2016,7호선,장암,69125,7382,76507
201612,2016,7호선,장승배기,276687,77420,354107
201612,2016,7호선,이수,469224,80626,549850
201612,2016,7호선,용마산,167888,34900,202788
201612,2016,7호선,온수(성공회대입구),313419,34312,347731
201612,2016,7호선,어린이대공원(세종대),431409,41624,473033
201612,2016,7호선,신풍,285284,65998,351282
201612,2016,7호선,신중동,414609,48151,462760
201612,2016,7호선,신대방삼거리,419106,92887,511993
201612,2016,7호선,숭실대입구(살피재),422620,59035,481655
201612,2016,7호선,수락산,363315,87646,450961
201612,2016,7호선,상봉(시외버스터미널),490080,75181,565261
201612,2016,7호선,상동,413313,45805,459118
201612,2016,7호선,상도,298232,61695,359927
201612,2016,7호선,삼산체육관,155967,24015,179982
201612,2016,7호선,사가정,415386,91978,507364
201612,2016,7호선,부평구청,351432,30517,381949
201612,2016,7호선,부천종합운동장,149671,16642,166313
201612,2016,7호선,부천시청,361029,44513,405542
201612,2016,7호선,보라매,257249,42448,299697
201612,2016,7호선,반포,174444,32279,206723
201612,2016,7호선,면목,423139,83489,506628
201612,2016,7호선,먹골,283605,58616,342221
201612,2016,7호선,마들,316283,74569,390852
201612,2016,7호선,뚝섬유원지,198424,37815,236239
201612,2016,7호선,도봉산,250206,38156,288362
201612,2016,7호선,대림(구로구청),308996,35913,344909
201612,2016,7호선,논현,566255,53897,620152
201612,2016,7호선,노원,563114,113150,676264
201612,2016,7호선,내방,379229,65059,444288
201612,2016,7호선,남성,298495,69072,367567
201612,2016,7호선,남구로,450212,59391,509603
201612,2016,7호선,까치울,185191,22287,207478
201612,2016,7호선,굴포천,253458,33322,286780
201612,2016,7호선,군자(능동),386676,79181,465857
201612,2016,7호선,광명사거리,720133,149748,869881
201612,2016,7호선,공릉(서울과학기술대),337244,66855,404099
201612,2016,7호선,고속터미널,635694,84268,719962
201612,2016,7호선,건대입구,491476,53724,545200
201612,2016,7호선,학동,627767,64142,691909
201612,2016,7호선,가산디지털단지,1204734,77754,1282488
201612,2016,6호선,공덕,498795,75212,574007
201612,2016,6호선,화랑대(서울여대입구),373310,45401,418711
201612,2016,6호선,합정,404451,38952,443403
201612,2016,6호선,한강진,217392,14099,231491
201612,2016,6호선,태릉입구,139387,26721,166108
201612,2016,6호선,청구,118577,19531,138108
201612,2016,6호선,창신,89495,17133,106628
201612,2016,6호선,증산(명지대앞),268782,68741,337523
201612,2016,6호선,이태원,532774,37807,570581
201612,2016,6호선,응암,458761,109178,567939
201612,2016,6호선,월드컵경기장(성산),149116,48040,197156
201612,2016,6호선,월곡(동덕여대),332194,74334,406528
201612,2016,6호선,연신내,15,1,16
201612,2016,6호선,역촌,87850,34006,121856
201612,2016,6호선,약수,92771,23649,116420
201612,2016,6호선,안암(고대병원앞),396922,32504,429426
201612,2016,6호선,신당,242077,37511,279588
201612,2016,6호선,석계,352364,75196,427560
201612,2016,6호선,새절(신사),354576,85893,440469
201612,2016,6호선,상월곡(한국과학기술연구원),161757,37795,199552
201612,2016,6호선,상수,339248,24581,363829
201612,2016,6호선,삼각지,231199,22349,253548
201612,2016,6호선,불광,144388,41172,185560
201612,2016,6호선,봉화산(서울의료원),247602,51332,298934
201612,2016,6호선,보문,234246,37793,272039
201612,2016,6호선,버티고개,65073,14581,79654
201612,2016,6호선,망원,330180,86835,417015
201612,2016,6호선,마포구청,354111,82190,436301
201612,2016,6호선,디지털미디어시티,402151,61683,463834
201612,2016,6호선,동묘앞,225017,68012,293029
201612,2016,6호선,돌곶이,243317,63720,307037
201612,2016,6호선,독바위,74141,20132,94273
201612,2016,6호선,대흥(서강대앞),218315,43763,262078
201612,2016,6호선,녹사평(용산구청),214451,21594,236045
201612,2016,6호선,구산,204757,56210,260967
201612,2016,6호선,광흥창(서강),245704,60388,306092
201612,2016,6호선,효창공원앞,190265,42572,232837
201612,2016,6호선,고려대(종암),280518,35654,316172
201612,2016,5호선,개롱,179234,43826,223060
201612,2016,5호선,행당,222475,48407,270882
201612,2016,5호선,충정로(경기대입구),140037,21196,161233
201612,2016,5호선,청구,83758,25896,109654
201612,2016,5호선,천호(풍납토성),527398,150054,677452
201612,2016,5호선,종로3가,341800,132427,474227
201612,2016,5호선,장한평,495946,101765,597711
201612,2016,5호선,을지로4가,118260,43454,161714
201612,2016,5호선,우장산,423745,78743,502488
201612,2016,5호선,왕십리(성동구청),142263,26155,168418
201612,2016,5호선,올림픽공원(한국체대),161637,32429,194066
201612,2016,5호선,오목교(목동운동장앞),730659,85059,815718
201612,2016,5호선,오금,100205,16992,117197
201612,2016,5호선,영등포시장,194797,74903,269700
201612,2016,5호선,영등포구청,85580,20579,106159
201612,2016,5호선,여의도,686101,57249,743350
201612,2016,5호선,여의나루,232948,27688,260636
201612,2016,5호선,양평,169246,28718,197964
201612,2016,5호선,애오개,183799,39390,223189
201612,2016,5호선,아차산(어린이대공원후문),385308,91205,476513
201612,2016,5호선,신정(은행정),409324,59600,468924
201612,2016,5호선,신길,83902,12658,96560
201612,2016,5호선,신금호,153331,39322,192653
201612,2016,5호선,송정,241780,64023,305803
201612,2016,5호선,서대문,514859,72206,587065
201612,2016,5호선,상일동,292493,60924,353417
201612,2016,5호선,방화,191375,46327,237702
201612,2016,5호선,방이,189140,43084,232224
201612,2016,5호선,발산,359302,63391,422693
201612,2016,5호선,목동,499730,85345,585075
201612,2016,5호선,명일,203496,61739,265235
201612,2016,5호선,마포,405775,68511,474286
201612,2016,5호선,마천,118724,48550,167274
201612,2016,5호선,마장,158386,43381,201767
201612,2016,5호선,마곡,135420,20661,156081
201612,2016,5호선,둔촌동,337184,78008,415192
201612,2016,5호선,동대문역사문화공원,85418,10981,96399
201612,2016,5호선,답십리,435410,84679,520089
201612,2016,5호선,까치산,811879,155145,967024
201612,2016,5호선,김포공항,217041,26748,243789
201612,2016,5호선,길동,185567,58936,244503
201612,2016,5호선,굽은다리(강동구민회관앞),252575,64507,317082
201612,2016,5호선,군자(능동),315479,40218,355697
201612,2016,5호선,광화문(세종문화회관),1328714,109907,1438621
201612,2016,5호선,광나루(장신대),403319,64962,468281
201612,2016,5호선,공덕,379455,49435,428890
201612,2016,5호선,고덕,213556,59075,272631
201612,2016,5호선,거여,170125,50140,220265
201612,2016,5호선,개화산,156280,34614,190894
201612,2016,5호선,화곡,800115,139446,939561
201612,2016,5호선,강동,517443,95994,613437
201612,2016,4호선,남태령,53181,8895,62076
201612,2016,4호선,혜화,1372359,139444,1511803
201612,2016,4호선,한성대입구(삼선교),448147,80167,528314
201612,2016,4호선,충무로,927794,133730,1061524
201612,2016,4호선,총신대입구(이수),573093,144356,717449
201612,2016,4호선,창동,765564,185910,951474
201612,2016,4호선,이촌(국립중앙박물관),284833,44591,329424
201612,2016,4호선,쌍문,915794,172589,1088383
201612,2016,4호선,신용산,370952,51749,422701
201612,2016,4호선,숙대입구(갈월),500123,61852,561975
201612,2016,4호선,수유(강북구청),1203738,261318,1465056
201612,2016,4호선,성신여대입구(돈암),777913,107785,885698
201612,2016,4호선,서울역,343453,40925,384378
201612,2016,4호선,상계,585402,118489,703891
201612,2016,4호선,삼각지,129818,33404,163222
201612,2016,4호선,사당,882945,99986,982931
201612,2016,4호선,미아사거리,876338,191341,1067679
201612,2016,4호선,미아(서울사이버대학),484369,133838,618207
201612,2016,4호선,명동,1291700,82244,1373944
201612,2016,4호선,동작(현충원),55072,19061,74133
201612,2016,4호선,동대문역사문화공원,693426,68088,761514
201612,2016,4호선,동대문,668727,157387,826114
201612,2016,4호선,당고개,331861,92212,424073
201612,2016,4호선,노원,653570,93216,746786
201612,2016,4호선,회현(남대문시장),777211,201796,979007
201612,2016,4호선,길음,726144,150571,876715
201612,2016,3호선,경복궁(정부서울청사),843813,99989,943802
201612,2016,3호선,학여울,103692,16958,120650
201612,2016,3호선,충무로,38,2,40
201612,2016,3호선,지축,29591,10671,40262
201612,2016,3호선,종로3가,222300,69427,291727
201612,2016,3호선,잠원,156867,35323,192190
201612,2016,3호선,일원,229362,57784,287146
201612,2016,3호선,을지로3가,234839,61743,296582
201612,2016,3호선,옥수,255698,57495,313193
201612,2016,3호선,오금,192083,27862,219945
201612,2016,3호선,연신내,1103861,266036,1369897
201612,2016,3호선,양재(서초구청),1153295,171622,1324917
201612,2016,3호선,약수,376503,86508,463011
201612,2016,3호선,압구정,985757,152652,1138409
201612,2016,3호선,안국,751549,140257,891806
201612,2016,3호선,신사,938346,78226,1016572
201612,2016,3호선,수서,412885,99366,512251
201612,2016,3호선,불광,484602,154239,638841
201612,2016,3호선,무악재,101695,33478,135173
201612,2016,3호선,매봉,318235,57858,376093
201612,2016,3호선,동대입구,358795,40781,399576
201612,2016,3호선,독립문,186925,71559,258484
201612,2016,3호선,도곡,195063,32904,227967
201612,2016,3호선,대치,312311,63102,375413
201612,2016,3호선,대청,278432,53917,332349
201612,2016,3호선,녹번,358146,70858,429004
201612,2016,3호선,남부터미널(예술의전당),1014947,139005,1153952
201612,2016,3호선,금호,207976,54409,262385
201612,2016,3호선,구파발,569662,106491,676153
201612,2016,3호선,교대(법원.검찰청),380870,74698,455568
201612,2016,3호선,고속터미널,1691940,186321,1878261
201612,2016,3호선,경찰병원,203341,40515,243856
201612,2016,3호선,홍제,501599,156089,657688
201612,2016,3호선,가락시장,246730,72030,318760
201612,2016,2호선,강변(동서울터미널),1420279,145322,1565601
201612,2016,2호선,합정,986074,75545,1061619
201612,2016,2호선,한양대,335240,16138,351378
201612,2016,2호선,충정로(경기대입구),319115,55451,374566
201612,2016,2호선,종합운동장,342507,50604,393111
201612,2016,2호선,잠실새내,743899,121141,865040
201612,2016,2호선,잠실나루,471700,89322,561022
201612,2016,2호선,잠실(송파구청),2619839,220322,2840161
201612,2016,2호선,이대,582593,72823,655416
201612,2016,2호선,을지로입구,1605994,127573,1733567
201612,2016,2호선,을지로4가,317918,100286,418204
201612,2016,2호선,을지로3가,574610,93351,667961
201612,2016,2호선,용두(동대문구청),49805,22978,72783
201612,2016,2호선,용답,63170,16829,79999
201612,2016,2호선,왕십리(성동구청),592663,63227,655890
201612,2016,2호선,영등포구청,574646,107910,682556
201612,2016,2호선,역삼,1290857,158104,1448961
201612,2016,2호선,양천구청,178779,46392,225171
201612,2016,2호선,아현,249084,63060,312144
201612,2016,2호선,신촌,1476546,147092,1623638
201612,2016,2호선,신정네거리,252812,66566,319378
201612,2016,2호선,신설동,94323,36074,130397
201612,2016,2호선,신림,2053620,253791,2307411
201612,2016,2호선,신도림,1797431,209484,2006915
201612,2016,2호선,신대방,767127,131646,898773
201612,2016,2호선,신당,373222,109947,483169
201612,2016,2호선,신답,31651,10363,42014
201612,2016,2호선,시청,800798,74624,875422
201612,2016,2호선,성수,732938,102193,835131
201612,2016,2호선,선릉,1527330,211839,1739169
201612,2016,2호선,서초,638036,87400,725436
201612,2016,2호선,서울대입구(관악구청),1450860,216656,1667516
201612,2016,2호선,상왕십리,294216,61653,355869
201612,2016,2호선,삼성(무역센터),1785687,133283,1918970
201612,2016,2호선,사당,1190027,211305,1401332
201612,2016,2호선,봉천,592802,147498,740300
201612,2016,2호선,방배,576219,85220,661439
201612,2016,2호선,문래,522454,83785,606239
201612,2016,2호선,뚝섬,438935,65062,503997
201612,2016,2호선,동대문역사문화공원,534972,62037,597009
201612,2016,2호선,도림천,27512,6026,33538
201612,2016,2호선,대림(구로구청),863311,118642,981953
201612,2016,2호선,당산,601333,67791,669124
201612,2016,2호선,낙성대,860239,112652,972891
201612,2016,2호선,구의(광진구청),665097,111072,776169
201612,2016,2호선,구로디지털단지,1853963,170006,2023969
201612,2016,2호선,교대(법원.검찰청),996325,172642,1168967
201612,2016,2호선,건대입구,1364714,100061,1464775
201612,2016,2호선,홍대입구,2478122,122174,2600296
201612,2016,2호선,강남,2990970,176270,3167240
201612,2016,1호선,신설동,389861,126355,516216
201612,2016,1호선,종로5가,593831,270530,864361
201612,2016,1호선,종로3가,811638,382069,1193707
201612,2016,1호선,종각,1466393,179502,1645895
201612,2016,1호선,제기동,310168,307262,617430
201612,2016,1호선,청량리(서울시립대입구),568313,344587,912900
201612,2016,1호선,시청,812698,126263,938961
201612,2016,1호선,서울역,1709077,226036,1935113
201612,2016,1호선,동묘앞,179272,135180,314452
201612,2016,1호선,동대문,367413,140426,507839
201611,2016,4호선,한성대입구(삼선교),475823,78525,554348
201611,2016,4호선,성신여대입구(돈암),768325,104082,872407
201611,2016,4호선,길음,756333,146795,903128
201611,2016,4호선,미아사거리,846412,184501,1030913
201611,2016,4호선,미아(서울사이버대학),481510,131013,612523
201611,2016,4호선,수유(강북구청),1199619,248664,1448283
201611,2016,4호선,쌍문,899054,164305,1063359
201611,2016,4호선,창동,760382,182014,942396
201611,2016,4호선,노원,628844,89600,718444
201611,2016,4호선,남태령,58253,8812,67065
201611,2016,4호선,당고개,329546,89974,419520
201611,2016,3호선,구파발,490228,89640,579868
201611,2016,3호선,경찰병원,200811,38743,239554
201611,2016,3호선,가락시장,231569,68744,300313
201611,2016,3호선,수서,390643,94904,485547
201611,2016,3호선,일원,238920,61891,300811
201611,2016,3호선,대청,273357,51883,325240
201611,2016,3호선,학여울,65766,16288,82054
201611,2016,3호선,대치,326356,63225,389581
201611,2016,3호선,도곡,192275,30099,222374
201611,2016,3호선,매봉,309999,55588,365587
201611,2016,3호선,양재(서초구청),1151864,160693,1312557
201611,2016,3호선,남부터미널(예술의전당),973394,131339,1104733
201611,2016,3호선,교대(법원.검찰청),375544,68623,444167
201611,2016,3호선,고속터미널,1545195,175882,1721077
201611,2016,3호선,잠원,156250,34618,190868
201611,2016,3호선,신사,886190,75943,962133
201611,2016,3호선,압구정,920702,150996,1071698
201611,2016,3호선,옥수,254679,57321,312000
201611,2016,3호선,금호,195413,52770,248183
201611,2016,3호선,약수,370592,85224,455816
201611,2016,3호선,동대입구,359271,39786,399057
201611,2016,3호선,충무로,47,4,51
201611,2016,3호선,을지로3가,236215,59656,295871
201611,2016,3호선,종로3가,198582,60804,259386
201611,2016,3호선,안국,789049,134742,923791
201611,2016,3호선,경복궁(정부서울청사),858480,96155,954635
201611,2016,3호선,독립문,189418,72342,261760
201611,2016,3호선,무악재,100861,32962,133823
201611,2016,3호선,홍제,501758,150962,652720
201611,2016,3호선,녹번,353580,70615,424195
201611,2016,3호선,불광,476238,147425,623663
201611,2016,3호선,연신내,1072597,256155,1328752
201611,2016,3호선,오금,191171,26916,218087
201611,2016,3호선,지축,31053,10762,41815
201611,2016,2호선,을지로입구,1568630,118425,1687055
201611,2016,2호선,신정네거리,252323,65046,317369
201611,2016,2호선,양천구청,179616,46163,225779
201611,2016,2호선,도림천,27187,6217,33404
201611,2016,2호선,신설동,91662,33467,125129
201611,2016,2호선,신답,31477,10306,41783
201611,2016,2호선,용답,62660,16942,79602
201611,2016,2호선,충정로(경기대입구),325435,54097,379532
201611,2016,2호선,아현,260669,62219,322888
201611,2016,2호선,이대,636988,74145,711133
201611,2016,2호선,신촌,1455118,140644,1595762
201611,2016,2호선,홍대입구,2189797,119133,2308930
201611,2016,2호선,합정,956987,76828,1033815
201611,2016,2호선,당산,604621,64793,669414
201611,2016,2호선,영등포구청,569328,102679,672007
201611,2016,2호선,문래,514051,84776,598827
201611,2016,2호선,신도림,1741259,201378,1942637
201611,2016,2호선,대림(구로구청),851231,115184,966415
201611,2016,2호선,구로디지털단지,1809638,161675,1971313
201611,2016,2호선,신대방,753348,131192,884540
201611,2016,2호선,신림,1981128,239152,2220280
201611,2016,2호선,봉천,581519,145557,727076
201611,2016,2호선,서울대입구(관악구청),1441237,207214,1648451
201611,2016,2호선,낙성대,855189,109920,965109
201611,2016,2호선,사당,1119700,196056,1315756
201611,2016,2호선,방배,599519,82649,682168
201611,2016,2호선,서초,642308,87758,730066
201611,2016,2호선,교대(법원.검찰청),999042,163813,1162855
201611,2016,2호선,강남,2790176,166389,2956565
201611,2016,2호선,역삼,1253489,149075,1402564
201611,2016,2호선,선릉,1492833,203547,1696380
201611,2016,2호선,삼성(무역센터),1642310,125076,1767386
201611,2016,2호선,종합운동장,344177,54346,398523
201611,2016,2호선,신천,708493,116324,824817
201611,2016,2호선,잠실(송파구청),2333442,207433,2540875
201611,2016,2호선,잠실나루,478180,88279,566459
201611,2016,2호선,강변(동서울터미널),1371690,143584,1515274
201611,2016,2호선,구의(광진구청),652883,107619,760502
201611,2016,2호선,건대입구,1314724,95426,1410150
201611,2016,2호선,성수,706605,97713,804318
201611,2016,2호선,뚝섬,450736,65094,515830
201611,2016,2호선,한양대,429394,21318,450712
201611,2016,2호선,왕십리(성동구청),596446,59993,656439
201611,2016,2호선,상왕십리,278614,57480,336094
201611,2016,2호선,신당,364163,106266,470429
201611,2016,2호선,동대문역사문화공원,522340,59420,581760
201611,2016,2호선,을지로4가,316604,93633,410237
201611,2016,2호선,을지로3가,576394,90981,667375
201611,2016,2호선,용두(동대문구청),48112,22591,70703
201611,2016,2호선,시청,832078,65333,897411
201611,2016,1호선,종로5가,595344,251402,846746
201611,2016,1호선,청량리(서울시립대입구),562207,333910,896117
201611,2016,1호선,제기동,305730,304093,609823
201611,2016,1호선,신설동,392750,121016,513766
201611,2016,1호선,동대문,354720,134229,488949
201611,2016,1호선,동묘앞,182480,135046,317526
201611,2016,1호선,종로3가,819339,351300,1170639
201611,2016,1호선,종각,1468143,160931,1629074
201611,2016,1호선,시청,867026,113560,980586
201611,2016,1호선,서울역,1764932,233613,1998545
201611,2016,일산선,대곡,38569,10562,49131
201611,2016,일산선,원흥,161171,36926,198097
201611,2016,일산선,대화,387801,91129,478930
201611,2016,일산선,원당,299940,84700,384640
201611,2016,일산선,화정,482740,129876,612616
201611,2016,장항선,신창(순천향대),74732,7947,82679
201611,2016,장항선,온양온천,95658,62285,157943
201611,2016,장항선,배방,23967,7149,31116
201611,2016,장항선,아산,86943,8969,95912
201611,2016,장항선,쌍용(나사렛대),76150,15869,92019
201611,2016,장항선,봉명,28785,12968,41753
201611,2016,중앙선,회기,871660,130631,1002291
201611,2016,중앙선,용문,53908,43390,97298
201611,2016,중앙선,상봉(시외버스터미널),142256,35934,178190
201611,2016,중앙선,망우,195018,65550,260568
201611,2016,중앙선,양원,45711,16108,61819
201611,2016,중앙선,구리,342685,80759,423444
201611,2016,중앙선,도농,233336,55303,288639
201611,2016,중앙선,양정,19427,8166,27593
201611,2016,중앙선,덕소,153856,48210,202066
201611,2016,중앙선,도심,63705,19907,83612
201611,2016,중앙선,팔당,19318,5679,24997
201611,2016,중앙선,운길산,25258,8738,33996
201611,2016,중앙선,양수,44643,16853,61496
201611,2016,중앙선,신원,4797,2928,7725
201611,2016,중앙선,국수,19470,8346,27816
201611,2016,중앙선,아신,21843,6253,28096
201611,2016,중앙선,오빈,6895,3751,10646
201611,2016,중앙선,양평,89601,33327,122928
201611,2016,중앙선,원덕,7426,5255,12681
201611,2016,중앙선,중랑,136094,50389,186483
201611,2016,분당선,기흥,227138,29753,256891
201611,2016,분당선,상갈,131230,30035,161265
201611,2016,분당선,청명,115124,16074,131198
201611,2016,분당선,영통,258703,26725,285428
201611,2016,분당선,망포,352782,28215,380997
201611,2016,분당선,매탄권선,121666,13741,135407
201611,2016,분당선,수원시청,283683,32862,316545
201611,2016,분당선,한티,370338,66169,436507
201611,2016,수인선,달월,2104,1022,3126
201611,2016,수인선,월곶,70356,13041,83397
201611,2016,수인선,소래포구,114697,57778,172475
201611,2016,수인선,인천논현,160196,29795,189991
201611,2016,수인선,호구포,94701,15386,110087
201611,2016,수인선,남동인더스파크,60152,4653,64805
201611,2016,수인선,인천,19775,8624,28399
201611,2016,수인선,연수,130798,24334,155132
201611,2016,수인선,송도,75255,20113,95368
201611,2016,수인선,인하대,164294,20011,184305
201611,2016,수인선,숭의,68427,21702,90129
201611,2016,수인선,신포,43789,10772,54561
201611,2016,수인선,원인재,131321,27157,158478
201611,2016,안산선,산본,472883,98635,571518
201611,2016,안산선,대야미,104802,22679,127481
201611,2016,안산선,반월,132446,28036,160482
201611,2016,안산선,상록수,588558,82568,671126
201611,2016,안산선,한대앞,270901,40463,311364
201611,2016,안산선,중앙,478974,56490,535464
201611,2016,안산선,수리산,115050,31233,146283
201611,2016,안산선,초지,130584,15362,145946
201611,2016,안산선,안산,486725,43844,530569
201611,2016,안산선,신길온천,47297,8853,56150
201611,2016,안산선,정왕,280448,23810,304258
201611,2016,안산선,오이도,238455,31059,269514
201611,2016,안산선,고잔,254225,35317,289542
201611,2016,일산선,삼송,352364,79619,431983
201611,2016,일산선,주엽,200164,97159,297323
201611,2016,일산선,정발산,211555,56636,268191
201611,2016,일산선,마두,182853,75594,258447
201611,2016,9호선,선유도,185324,25025,210349
201611,2016,9호선,신목동,111757,17861,129618
201611,2016,9호선,염창,440664,56954,497618
201611,2016,9호선,등촌,240541,77004,317545
201611,2016,9호선,증미,180990,39765,220755
201611,2016,9호선,가양,538658,115311,653969
201611,2016,9호선,양천향교,196954,37631,234585
201611,2016,9호선,마곡나루,82834,9623,92457
201611,2016,9호선,신방화,211412,41983,253395
201611,2016,9호선,공항시장,68980,20600,89580
201611,2016,9호선,신반포,87525,23686,111211
201611,2016,9호선,고속터미널,448263,51200,499463
201611,2016,9호선,사평,72066,14873,86939
201611,2016,9호선,신논현,839182,49053,888235
201611,2016,9호선,김포공항,258141,17975,276116
201611,2016,9호선,개화,174631,33188,207819
201611,2016,8호선,천호(풍납토성),488407,87900,576307
201611,2016,8호선,수진,119771,39643,159414
201611,2016,8호선,신흥,108835,45342,154177
201611,2016,8호선,단대오거리,320645,66302,386947
201611,2016,8호선,남한산성입구(성남법원.검찰청),398241,71841,470082
201611,2016,8호선,산성,177365,37114,214479
201611,2016,8호선,복정,296184,41465,337649
201611,2016,8호선,장지,414270,58067,472337
201611,2016,8호선,문정,243006,34502,277508
201611,2016,8호선,가락시장,173199,52948,226147
201611,2016,8호선,송파,139044,34899,173943
201611,2016,8호선,석촌,222747,59289,282036
201611,2016,8호선,잠실(송파구청),321167,56662,377829
201611,2016,8호선,몽촌토성(평화의문),159522,39868,199390
201611,2016,8호선,강동구청,267141,60021,327162
201611,2016,8호선,모란,91867,50265,142132
201611,2016,8호선,암사,462230,86166,548396
201611,2016,7호선,부평구청,348031,28965,376996
201611,2016,7호선,굴포천,243596,30989,274585
201611,2016,7호선,삼산체육관,152308,23136,175444
201611,2016,7호선,상동,394277,43259,437536
201611,2016,7호선,부천시청,344676,42851,387527
201611,2016,7호선,신중동,398714,45716,444430
201611,2016,7호선,춘의,234450,25781,260231
201611,2016,7호선,부천종합운동장,148965,16562,165527
201611,2016,7호선,까치울,181313,22608,203921
201611,2016,7호선,온수(성공회대입구),323135,34000,357135
201611,2016,7호선,천왕,218791,43362,262153
201611,2016,7호선,광명사거리,706705,143606,850311
201611,2016,7호선,철산,662332,94198,756530
201611,2016,7호선,가산디지털단지,1213080,75616,1288696
201611,2016,7호선,남구로,443382,57805,501187
201611,2016,7호선,대림(구로구청),298572,34416,332988
201611,2016,7호선,신풍,285963,64098,350061
201611,2016,7호선,보라매,257841,41824,299665
201611,2016,7호선,신대방삼거리,415815,91285,507100
201611,2016,7호선,장승배기,268783,75412,344195
201611,2016,7호선,상도,316374,60533,376907
201611,2016,7호선,숭실대입구(살피재),472091,58269,530360
201611,2016,7호선,남성,298080,67423,365503
201611,2016,7호선,이수,446553,76686,523239
201611,2016,7호선,내방,380742,62899,443641
201611,2016,7호선,고속터미널,607290,83520,690810
201611,2016,7호선,반포,172947,31275,204222
201611,2016,7호선,논현,556308,51548,607856
201611,2016,7호선,학동,626651,64112,690763
201611,2016,7호선,강남구청,423212,48927,472139
201611,2016,7호선,청담,587822,73562,661384
201611,2016,7호선,뚝섬유원지,203734,37188,240922
201611,2016,7호선,건대입구,474116,49709,523825
201611,2016,7호선,어린이대공원(세종대),491671,44282,535953
201611,2016,7호선,군자(능동),376809,75403,452212
201611,2016,7호선,중곡,267978,59390,327368
201611,2016,7호선,용마산,163878,34626,198504
201611,2016,7호선,사가정,405299,88794,494093
201611,2016,7호선,면목,434482,79607,514089
201611,2016,7호선,상봉(시외버스터미널),477740,70005,547745
201611,2016,7호선,중화,304648,57904,362552
201611,2016,7호선,먹골,276454,55421,331875
201611,2016,7호선,태릉입구,260778,37393,298171
201611,2016,7호선,공릉(서울과학기술대),360218,65679,425897
201611,2016,7호선,하계,546282,105616,651898
201611,2016,7호선,중계,417663,91791,509454
201611,2016,7호선,노원,536711,106792,643503
201611,2016,7호선,마들,312465,72268,384733
201611,2016,7호선,수락산,359059,85458,444517
201611,2016,7호선,도봉산,262756,40167,302923
201611,2016,7호선,장암,70535,7986,78521
201611,2016,6호선,역촌,85155,33648,118803
201611,2016,6호선,화랑대(서울여대입구),400297,45051,445348
201611,2016,6호선,태릉입구,141780,25956,167736
201611,2016,6호선,석계,356820,72888,429708
201611,2016,6호선,돌곶이,247878,60953,308831
201611,2016,6호선,상월곡(한국과학기술연구원),168765,37311,206076
201611,2016,6호선,월곡(동덕여대),348823,71233,420056
201611,2016,6호선,고려대(종암),309321,36470,345791
201611,2016,6호선,안암(고대병원앞),447416,31793,479209
201611,2016,6호선,보문,238946,37656,276602
201611,2016,6호선,창신,90861,16691,107552
201611,2016,6호선,동묘앞,217830,65709,283539
201611,2016,6호선,신당,230804,36783,267587
201611,2016,6호선,청구,123078,19358,142436
201611,2016,6호선,약수,92613,22947,115560
201611,2016,6호선,버티고개,65839,14504,80343
201611,2016,6호선,한강진,201201,14166,215367
201611,2016,6호선,이태원,456159,36907,493066
201611,2016,6호선,녹사평(용산구청),205146,21985,227131
201611,2016,6호선,삼각지,220632,21423,242055
201611,2016,6호선,효창공원앞,193866,43027,236893
201611,2016,6호선,공덕,485329,72043,557372
201611,2016,6호선,대흥(서강대앞),230016,44313,274329
201611,2016,6호선,광흥창(서강),244583,61248,305831
201611,2016,6호선,상수,322819,24595,347414
201611,2016,6호선,합정,394548,39209,433757
201611,2016,6호선,망원,320174,83573,403747
201611,2016,6호선,마포구청,355758,81759,437517
201611,2016,6호선,월드컵경기장(성산),179368,56142,235510
201611,2016,6호선,디지털미디어시티,406480,61302,467782
201611,2016,6호선,증산(명지대앞),264235,67794,332029
201611,2016,6호선,새절(신사),366123,83697,449820
201611,2016,6호선,구산,205967,54478,260445
201611,2016,6호선,연신내,17,1,18
201611,2016,6호선,독바위,72114,19720,91834
201611,2016,6호선,불광,138930,38157,177087
201611,2016,6호선,봉화산(서울의료원),244526,50148,294674
201611,2016,6호선,응암,449790,107054,556844
201611,2016,5호선,개화산,153735,33381,187116
201611,2016,5호선,거여,170186,48385,218571
201611,2016,5호선,개롱,177011,42216,219227
201611,2016,5호선,오금,103109,17246,120355
201611,2016,5호선,방이,186019,40291,226310
201611,2016,5호선,올림픽공원(한국체대),161797,34741,196538
201611,2016,5호선,둔촌동,336785,76343,413128
201611,2016,5호선,상일동,290673,60986,351659
201611,2016,5호선,고덕,212193,58480,270673
201611,2016,5호선,명일,199846,60210,260056
201611,2016,5호선,굽은다리(강동구민회관앞),248113,62284,310397
201611,2016,5호선,길동,177371,56197,233568
201611,2016,5호선,강동,513180,91607,604787
201611,2016,5호선,천호(풍납토성),498626,142232,640858
201611,2016,5호선,광나루(장신대),409785,64691,474476
201611,2016,5호선,아차산(어린이대공원후문),378820,87832,466652
201611,2016,5호선,군자(능동),308238,37062,345300
201611,2016,5호선,장한평,480750,96267,577017
201611,2016,5호선,답십리,427918,81873,509791
201611,2016,5호선,마장,160264,42570,202834
201611,2016,5호선,왕십리(성동구청),137448,25892,163340
201611,2016,5호선,행당,220840,47889,268729
201611,2016,5호선,신금호,150071,35561,185632
201611,2016,5호선,청구,80234,24823,105057
201611,2016,5호선,동대문역사문화공원,82319,11002,93321
201611,2016,5호선,을지로4가,119663,41691,161354
201611,2016,5호선,종로3가,328417,117278,445695
201611,2016,5호선,광화문(세종문화회관),1308652,96102,1404754
201611,2016,5호선,서대문,548562,71195,619757
201611,2016,5호선,충정로(경기대입구),145566,17251,162817
201611,2016,5호선,애오개,183149,39273,222422
201611,2016,5호선,공덕,372485,47322,419807
201611,2016,5호선,마포,396415,64584,460999
201611,2016,5호선,여의나루,218870,27732,246602
201611,2016,5호선,여의도,665056,54449,719505
201611,2016,5호선,신길,85541,12242,97783
201611,2016,5호선,영등포시장,187204,70889,258093
201611,2016,5호선,영등포구청,86497,20583,107080
201611,2016,5호선,양평,168047,27938,195985
201611,2016,5호선,오목교(목동운동장앞),696894,80946,777840
201611,2016,5호선,목동,501581,82317,583898
201611,2016,5호선,신정(은행정),404242,56580,460822
201611,2016,5호선,까치산,789096,147817,936913
201611,2016,5호선,화곡,782812,134265,917077
201611,2016,5호선,우장산,423314,76396,499710
201611,2016,5호선,발산,348676,59566,408242
201611,2016,5호선,마곡,133251,20347,153598
201611,2016,5호선,송정,238296,59981,298277
201611,2016,5호선,김포공항,202003,25731,227734
201611,2016,5호선,마천,118290,47695,165985
201611,2016,5호선,방화,188468,44924,233392
201611,2016,4호선,상계,580347,114855,695202
201611,2016,4호선,사당,866718,92886,959604
201611,2016,4호선,총신대입구(이수),556934,138692,695626
201611,2016,일산선,백석,289207,76920,366127
201611,2016,4호선,동작(현충원),60216,20109,80325
201611,2016,4호선,이촌(국립중앙박물관),243372,44343,287715
201611,2016,4호선,신용산,363894,51914,415808
201611,2016,분당선,신갈,110678,29614,140292
201611,2016,4호선,삼각지,126841,31292,158133
201611,2016,4호선,숙대입구(갈월),524432,60960,585392
201611,2016,4호선,서울역,354300,41240,395540
201611,2016,4호선,회현(남대문시장),772559,192587,965146
201611,2016,4호선,명동,1238829,77795,1316624
201611,2016,4호선,충무로,946791,127708,1074499
201611,2016,4호선,동대문역사문화공원,666693,64480,731173
201611,2016,4호선,동대문,661915,153655,815570
201611,2016,4호선,혜화,1248561,129015,1377576
201611,2016,9호선,당산,490515,58441,548956
201611,2016,9호선,국회의사당,432288,55020,487308
201611,2016,9호선,여의도,556098,41962,598060
201611,2016,9호선,샛강,129012,24257,153269
201611,2016,9호선,노량진,781025,83597,864622
201611,2016,9호선,노들,119703,29102,148805
201611,2016,9호선,흑석(중앙대입구),316190,52634,368824
201611,2016,9호선,동작(현충원),46832,13117,59949
201611,2016,9호선,구반포,79261,23219,102480
201611,2016,9호선2단계,언주,216035,23538,239573
201611,2016,9호선2단계,봉은사,356299,34760,391059
201611,2016,9호선2단계,삼성중앙,129557,18622,148179
201611,2016,9호선2단계,선정릉,191576,19295,210871
201611,2016,9호선2단계,종합운동장,169732,13166,182898
201611,2016,경강선,판교,64429,9704,74133
201611,2016,경강선,이매,36386,9269,45655
201611,2016,경강선,삼동,32099,5886,37985
201611,2016,경강선,경기광주,113597,15950,129547
201611,2016,경강선,초월,49657,8992,58649
201611,2016,경강선,여주,53414,17911,71325
201611,2016,경강선,신둔도예촌,29887,5012,34899
201611,2016,경강선,이천,58017,10864,68881
201611,2016,경강선,부발,40608,4778,45386
201611,2016,경강선,세종대왕릉,6215,4268,10483
201611,2016,경강선,곤지암,65803,14525,80328
201611,2016,경부선,구로,576798,90597,667395
201611,2016,경부선,신길,288248,46990,335238
201611,2016,경부선,금천구청,283770,75267,359037
201611,2016,경부선,석수,330528,45993,376521
201611,2016,경부선,관악,225918,52195,278113
201611,2016,경부선,안양,789655,108241,897896
201611,2016,경부선,명학,293833,41316,335149
201611,2016,경부선,금정,785424,102922,888346
201611,2016,경부선,군포,199236,34055,233291
201611,2016,경부선,의왕,234322,37561,271883
201611,2016,경부선,성균관대,469470,50077,519547
201611,2016,경부선,화서,229192,41430,270622
201611,2016,경부선,수원,1252684,138934,1391618
201611,2016,경부선,독산,436919,64324,501243
201611,2016,경부선,세류,117481,18496,135977
201611,2016,경부선,병점,459324,55204,514528
201611,2016,경부선,세마,71429,12516,83945
201611,2016,경부선,오산대,83215,12081,95296
201611,2016,경부선,오산,280111,39887,319998
201611,2016,경부선,진위,45671,7677,53348
201611,2016,경부선,송탄,129331,23836,153167
201611,2016,경부선,서정리,147289,24058,171347
201611,2016,경부선,지제,31555,4764,36319
201611,2016,경부선,평택,385877,65211,451088
201611,2016,경부선,성환,152405,19594,171999
201611,2016,경부선,직산,24595,5591,30186
201611,2016,경부선,두정,181115,20711,201826
201611,2016,경부선,천안,228655,57263,285918
201611,2016,경부선,당정,213504,29828,243332
201611,2016,경부선,서동탄,41626,8392,50018
201611,2016,경부선,광명,25203,1291,26494
201611,2016,경부선,서울역,21,0,21
201611,2016,경부선,남영,346759,41167,387926
201611,2016,경부선,용산,1060217,135138,1195355
201611,2016,경부선,노량진,490888,53871,544759
201611,2016,경부선,대방,428982,73863,502845
201611,2016,경부선,영등포,1243335,256739,1500074
201611,2016,경부선,신도림,103201,20389,123590
201611,2016,경부선,가산디지털단지,463680,29936,493616
201611,2016,경원선,방학,217540,100854,318394
201611,2016,경원선,창동,9,0,9
201611,2016,경원선,도봉산,165864,83574,249438
201611,2016,경원선,망월사,219636,66904,286540
201611,2016,경원선,회룡,276946,134656,411602
201611,2016,경원선,의정부,565468,116969,682437
201611,2016,경원선,가능,176288,62255,238543
201611,2016,경원선,녹양,128696,33039,161735
201611,2016,경원선,양주,240027,52851,292878
201611,2016,경원선,덕계,52226,16667,68893
201611,2016,경원선,덕정,196507,35039,231546
201611,2016,경원선,지행,187838,43638,231476
201611,2016,경원선,동두천중앙,85062,38105,123167
201611,2016,경원선,보산,45693,13903,59596
201611,2016,경원선,동두천,52228,18139,70367
201611,2016,경원선,소요산,64409,76759,141168
201611,2016,경원선,이촌(국립중앙박물관),112763,30145,142908
201611,2016,경원선,서빙고,51249,16817,68066
201611,2016,경원선,한남,103510,32700,136210
201611,2016,경원선,옥수,1562,130,1692
201611,2016,경원선,응봉,44118,18042,62160
201611,2016,경원선,왕십리(성동구청),496670,58605,555275
201611,2016,경원선,청량리(서울시립대입구),306999,130475,437474
201611,2016,경원선,외대앞,366345,56693,423038
201611,2016,경원선,신이문,242155,66188,308343
201611,2016,경원선,석계,290502,64270,354772
201611,2016,경원선,광운대,291562,53601,345163
201611,2016,경원선,월계,148410,52378,200788
201611,2016,경원선,녹천,125118,38889,164007
201611,2016,경원선,도봉,136476,67400,203876
201611,2016,경의선,서울역,80054,9353,89407
201611,2016,경의선,문산,151779,54457,206236
201611,2016,경의선,효창공원앞,54236,10600,64836
201611,2016,경의선,공덕,55048,9082,64130
201611,2016,경의선,서강대,63106,8847,71953
201611,2016,경의선,홍대입구,42952,4633,47585
201611,2016,경의선,가좌,98505,41831,140336
201611,2016,경의선,디지털미디어시티,64825,9964,74789
201611,2016,경의선,수색,56322,17137,73459
201611,2016,경의선,화전,85249,7757,93006
201611,2016,경의선,강매,64643,14761,79404
201611,2016,경의선,행신,205596,33616,239212
201611,2016,경의선,능곡,89018,28623,117641
201611,2016,경의선,곡산,12835,4836,17671
201611,2016,경의선,백마,178230,30882,209112
201611,2016,경의선,풍산,117096,27553,144649
201611,2016,경의선,일산,240613,55201,295814
201611,2016,경의선,탄현,206605,36852,243457
201611,2016,경의선,야당,86389,20355,106744
201611,2016,경의선,운정,125742,28513,154255
201611,2016,경의선,금릉,125393,23913,149306
201611,2016,경의선,금촌,182999,42265,225264
201611,2016,경의선,월롱,67217,8087,75304
201611,2016,경의선,파주,47841,7568,55409
201611,2016,경의선,신촌,21222,3001,24223
201611,2016,경인선,구일,220188,32710,252898
201611,2016,경인선,소사,330505,84403,414908
201611,2016,경인선,부개,267525,63736,331261
201611,2016,경인선,간석,167719,44399,212118
201611,2016,경인선,도원,97105,35914,133019
201611,2016,경인선,온수(성공회대입구),194652,44810,239462
201611,2016,경인선,중동,256193,63979,320172
201611,2016,경인선,도화,87800,34807,122607
201611,2016,경인선,개봉,603937,151034,754971
201611,2016,경인선,오류동,286444,84048,370492
201611,2016,경인선,역곡,856208,142194,998402
201611,2016,경인선,부천,1093516,199354,1292870
201611,2016,경인선,송내,923339,113170,1036509
201611,2016,경인선,부평,1030581,136652,1167233
201611,2016,경인선,백운,231519,62884,294403
201611,2016,경인선,동암,553684,109945,663629
201611,2016,경인선,주안,749445,104226,853671
201611,2016,경인선,제물포,295180,52281,347461
201611,2016,경인선,동인천,459277,116819,576096
201611,2016,경인선,인천,100220,35237,135457
201611,2016,경춘선,천마산,27948,13250,41198
201611,2016,경춘선,상천,8560,4923,13483
201611,2016,경춘선,금곡,31114,14044,45158
201611,2016,경춘선,사릉,91763,16964,108727
201611,2016,경춘선,퇴계원,82779,22852,105631
201611,2016,경춘선,별내,57621,15125,72746
201611,2016,경춘선,갈매,31225,10132,41357
201611,2016,경춘선,신내,15505,6120,21625
201611,2016,경춘선,마석,81114,28791,109905
201611,2016,경춘선,대성리,16698,4582,21280
201611,2016,경춘선,청평,50445,14450,64895
201611,2016,경춘선,김유정,11644,3178,14822
201611,2016,경춘선,남춘천,78822,23234,102056
201611,2016,경춘선,춘천,58455,17760,76215
201611,2016,경춘선,강촌,19796,3889,23685
201611,2016,경춘선,백양리,2869,910,3779
201611,2016,경춘선,굴봉산,4077,1402,5479
201611,2016,경춘선,가평,68780,13790,82570
201611,2016,경춘선,평내호평,140570,38562,179132
201611,2016,공항철도 1호선,영종,37254,9792,47046
201611,2016,공항철도 1호선,인천국제공항,363578,37077,400655
201611,2016,공항철도 1호선,공항화물청사,69576,7434,77010
201611,2016,공항철도 1호선,운서,139387,22586,161973
201611,2016,공항철도 1호선,청라국제도시,141291,8537,149828
201611,2016,공항철도 1호선,검암,268672,24753,293425
201611,2016,공항철도 1호선,계양,311998,29661,341659
201611,2016,공항철도 1호선,김포공항,293538,17564,311102
201611,2016,공항철도 1호선,디지털미디어시티,356484,23395,379879
201611,2016,공항철도 1호선,홍대입구,248339,16642,264981
201611,2016,공항철도 1호선,서울역,276973,30244,307217
201611,2016,공항철도 1호선,공덕,41565,5958,47523
201611,2016,과천선,평촌,453554,61016,514570
201611,2016,과천선,인덕원,725917,101373,827290
201611,2016,과천선,정부과천청사,320973,64025,384998
201611,2016,과천선,과천,137748,34667,172415
201611,2016,과천선,대공원,111507,45917,157424
201611,2016,과천선,경마공원,158103,56844,214947
201611,2016,과천선,선바위,265154,31780,296934
201611,2016,과천선,범계,846040,105256,951296
201611,2016,분당선,선릉,231902,25949,257851
201611,2016,분당선,매교,68492,16713,85205
201611,2016,분당선,도곡,162986,38914,201900
201611,2016,분당선,구룡,49997,18338,68335
201611,2016,분당선,개포동,91635,21606,113241
201611,2016,분당선,대모산입구,81973,28363,110336
201611,2016,분당선,수서,120853,36513,157366
201611,2016,분당선,복정,3,0,3
201611,2016,분당선,수원,288735,25829,314564
201611,2016,분당선,서울숲,187488,23279,210767
201611,2016,분당선,압구정로데오,399375,38835,438210
201611,2016,분당선,강남구청,225380,38275,263655
201611,2016,분당선,선정릉,204326,38472,242798
201611,2016,분당선,가천대,307554,23443,330997
201611,2016,분당선,태평,367890,85064,452954
201611,2016,분당선,모란,559325,152505,711830
201611,2016,분당선,야탑,718483,154316,872799
201611,2016,분당선,서현,677358,128496,805854
201611,2016,분당선,수내,344576,77415,421991
201611,2016,분당선,정자,432016,81252,513268
201611,2016,분당선,미금,472340,118940,591280
201611,2016,분당선,오리,360714,91645,452359
201611,2016,분당선,이매,136797,40675,177472
201611,2016,분당선,보정,62274,24808,87082
201611,2016,분당선,죽전,445907,80372,526279
201611,2016,분당선,구성,118543,38320,156863
201610,2016,중앙선,원덕,8243,6346,14589
201610,2016,중앙선,용문,64579,58166,122745
201610,2016,중앙선,상봉(시외버스터미널),146743,39568,186311
201610,2016,4호선,동대문역사문화공원,705057,66525,771582
201610,2016,4호선,동대문,677606,159210,836816
201610,2016,4호선,혜화,1222540,135708,1358248
201610,2016,4호선,한성대입구(삼선교),470185,82297,552482
201610,2016,4호선,성신여대입구(돈암),753086,107493,860579
201610,2016,4호선,길음,747463,154644,902107
201610,2016,4호선,미아사거리,846587,194830,1041417
201610,2016,4호선,미아(서울사이버대학),481768,137831,619599
201610,2016,4호선,수유(강북구청),1194573,262714,1457287
201610,2016,4호선,쌍문,893672,172663,1066335
201610,2016,4호선,창동,758637,190763,949400
201610,2016,4호선,노원,633487,95015,728502
201610,2016,4호선,남태령,68402,9726,78128
201610,2016,4호선,당고개,333627,95885,429512
201610,2016,3호선,구파발,480519,94241,574760
201610,2016,3호선,경찰병원,194474,38784,233258
201610,2016,3호선,가락시장,225215,68928,294143
201610,2016,3호선,수서,284637,87018,371655
201610,2016,3호선,일원,228238,61922,290160
201610,2016,3호선,대청,265983,51812,317795
201610,2016,3호선,학여울,74714,15987,90701
201610,2016,3호선,대치,319319,63809,383128
201610,2016,3호선,도곡,189350,29511,218861
201610,2016,3호선,매봉,297309,55870,353179
201610,2016,3호선,양재(서초구청),1102503,165005,1267508
201610,2016,3호선,남부터미널(예술의전당),971373,134341,1105714
201610,2016,3호선,교대(법원.검찰청),368116,68865,436981
201610,2016,3호선,고속터미널,1607441,184610,1792051
201610,2016,3호선,잠원,151857,34833,186690
201610,2016,3호선,신사,884696,75976,960672
201610,2016,3호선,압구정,913375,157487,1070862
201610,2016,3호선,옥수,257977,61082,319059
201610,2016,3호선,금호,192972,54648,247620
201610,2016,3호선,약수,361514,88448,449962
201610,2016,3호선,동대입구,370633,43031,413664
201610,2016,3호선,충무로,30,3,33
201610,2016,3호선,을지로3가,213581,58028,271609
201610,2016,3호선,종로3가,190653,64032,254685
201610,2016,3호선,안국,758530,133689,892219
201610,2016,3호선,경복궁(정부서울청사),754910,97739,852649
201610,2016,3호선,독립문,173898,75532,249430
201610,2016,3호선,무악재,96842,33768,130610
201610,2016,3호선,홍제,485010,156185,641195
201610,2016,3호선,녹번,345924,72880,418804
201610,2016,3호선,불광,472078,153577,625655
201610,2016,3호선,연신내,1063111,268289,1331400
201610,2016,3호선,오금,186906,27427,214333
201610,2016,3호선,지축,32400,12507,44907
201610,2016,2호선,을지로입구,1463612,117936,1581548
201610,2016,2호선,신정네거리,258768,67866,326634
201610,2016,2호선,양천구청,175180,48415,223595
201610,2016,2호선,도림천,24807,6161,30968
201610,2016,2호선,신설동,90693,36292,126985
201610,2016,2호선,신답,31559,11275,42834
201610,2016,2호선,용답,63036,17322,80358
201610,2016,2호선,충정로(경기대입구),304367,54922,359289
201610,2016,2호선,아현,251986,65020,317006
201610,2016,2호선,이대,626398,74754,701152
201610,2016,2호선,신촌,1429866,145010,1574876
201610,2016,2호선,홍대입구,2257023,122192,2379215
201610,2016,2호선,합정,968891,80025,1048916
201610,2016,2호선,당산,606859,69141,676000
201610,2016,2호선,영등포구청,552002,105216,657218
201610,2016,2호선,문래,503551,86671,590222
201610,2016,2호선,신도림,1761989,211004,1972993
201610,2016,2호선,대림(구로구청),876304,122014,998318
201610,2016,2호선,구로디지털단지,1784485,169041,1953526
201610,2016,2호선,신대방,762988,138411,901399
201610,2016,2호선,신림,1997889,249822,2247711
201610,2016,2호선,봉천,580690,153037,733727
201610,2016,2호선,서울대입구(관악구청),1434399,215042,1649441
201610,2016,2호선,낙성대,856137,114184,970321
201610,2016,2호선,사당,1123093,204213,1327306
201610,2016,2호선,방배,591706,83309,675015
201610,2016,2호선,서초,650171,88871,739042
201610,2016,2호선,교대(법원.검찰청),987441,165041,1152482
201610,2016,2호선,강남,2744849,164766,2909615
201610,2016,2호선,역삼,1170975,149345,1320320
201610,2016,2호선,선릉,1433228,198288,1631516
201610,2016,2호선,삼성(무역센터),1568343,127702,1696045
201610,2016,2호선,종합운동장,525082,68518,593600
201610,2016,2호선,신천,708127,119231,827358
201610,2016,2호선,잠실(송파구청),2489913,225061,2714974
201610,2016,2호선,잠실나루,471222,90604,561826
201610,2016,2호선,강변(동서울터미널),1426467,158436,1584903
201610,2016,2호선,구의(광진구청),639018,111451,750469
201610,2016,2호선,건대입구,1324155,100138,1424293
201610,2016,2호선,성수,688587,99992,788579
201610,2016,2호선,뚝섬,450601,66984,517585
201610,2016,2호선,한양대,387578,16998,404576
201610,2016,2호선,왕십리(성동구청),576568,63458,640026
201610,2016,2호선,상왕십리,276163,59383,335546
201610,2016,2호선,신당,366050,110172,476222
201610,2016,2호선,동대문역사문화공원,559753,59562,619315
201610,2016,2호선,을지로4가,302571,94350,396921
201610,2016,2호선,을지로3가,527581,91054,618635
201610,2016,2호선,용두(동대문구청),47116,23427,70543
201610,2016,2호선,시청,693784,59195,752979
201610,2016,1호선,종로5가,570581,263393,833974
201610,2016,1호선,청량리(서울시립대입구),562758,349566,912324
201610,2016,1호선,제기동,302169,319124,621293
201610,2016,1호선,신설동,384106,125253,509359
201610,2016,1호선,동대문,360282,139497,499779
201610,2016,1호선,동묘앞,183813,145243,329056
201610,2016,1호선,종로3가,734517,369426,1103943
201610,2016,1호선,종각,1246215,156210,1402425
201610,2016,1호선,시청,688625,101695,790320
201610,2016,1호선,서울역,1723041,232308,1955349
201610,2016,중앙선,상봉(시외버스터미널),146743,39568,186311
201610,2016,중앙선,용문,64579,58166,122745
201610,2016,중앙선,원덕,8243,6346,14589
201610,2016,중앙선,양평,99532,39095,138627
201610,2016,중앙선,오빈,7412,4324,11736
201610,2016,중앙선,아신,24945,7322,32267
201610,2016,중앙선,국수,20509,9617,30126
201610,2016,중앙선,신원,5728,3914,9642
201610,2016,중앙선,양수,52435,20896,73331
201610,2016,중앙선,운길산,36136,12744,48880
201610,2016,중앙선,팔당,28093,7657,35750
201610,2016,중앙선,도심,64963,22262,87225
201610,2016,중앙선,덕소,157841,52235,210076
201610,2016,중앙선,양정,19810,9667,29477
201610,2016,중앙선,도농,236192,59907,296099
201610,2016,중앙선,구리,354998,88090,443088
201610,2016,중앙선,양원,44618,17615,62233
201610,2016,중앙선,망우,201158,71389,272547
201610,2016,중앙선,회기,839194,137085,976279
201610,2016,중앙선,중랑,137859,53394,191253
201610,2016,장항선,봉명,28637,13953,42590
201610,2016,장항선,쌍용(나사렛대),78219,16895,95114
201610,2016,장항선,아산,90420,9805,100225
201610,2016,장항선,배방,26768,8115,34883
201610,2016,장항선,온양온천,105411,64382,169793
201610,2016,장항선,신창(순천향대),72657,9214,81871
201610,2016,일산선,화정,492146,137462,629608
201610,2016,일산선,원당,302443,91325,393768
201610,2016,일산선,대화,392813,95533,488346
201610,2016,일산선,원흥,162357,39140,201497
201610,2016,일산선,대곡,39602,12324,51926
201610,2016,일산선,백석,284722,80653,365375
201610,2016,일산선,마두,184207,79783,263990
201610,2016,일산선,정발산,228539,67934,296473
201610,2016,일산선,주엽,200420,99886,300306
201610,2016,일산선,삼송,348381,83114,431495
201610,2016,안산선,고잔,264025,39020,303045
201610,2016,안산선,오이도,250635,37560,288195
201610,2016,안산선,정왕,286482,25093,311575
201610,2016,안산선,신길온천,48592,10103,58695
201610,2016,안산선,안산,513816,46574,560390
201610,2016,안산선,초지,131178,16295,147473
201610,2016,안산선,수리산,114262,33291,147553
201610,2016,안산선,중앙,506272,60551,566823
201610,2016,안산선,한대앞,276510,43065,319575
201610,2016,안산선,상록수,599646,89646,689292
201610,2016,안산선,반월,136246,30809,167055
201610,2016,안산선,대야미,107585,25236,132821
201610,2016,안산선,산본,479587,105502,585089
201610,2016,수인선,원인재,135085,28483,163568
201610,2016,수인선,신포,46706,11790,58496
201610,2016,수인선,숭의,69201,23446,92647
201610,2016,수인선,인하대,158303,21095,179398
201610,2016,수인선,송도,80019,21826,101845
201610,2016,수인선,연수,137658,26586,164244
201610,2016,수인선,인천,25345,10247,35592
201610,2016,수인선,남동인더스파크,58846,4870,63716
201610,2016,수인선,호구포,97028,16855,113883
201610,2016,수인선,인천논현,166463,31262,197725
201610,2016,수인선,소래포구,152290,91190,243480
201610,2016,수인선,월곶,75197,14503,89700
201610,2016,수인선,달월,1993,1142,3135
201610,2016,분당선,구룡,48536,18686,67222
201610,2016,분당선,수원시청,292358,34610,326968
201610,2016,분당선,매탄권선,120799,14603,135402
201610,2016,분당선,망포,349442,29490,378932
201610,2016,분당선,영통,254553,27246,281799
201610,2016,분당선,청명,113839,16777,130616
201610,2016,분당선,상갈,136096,31173,167269
201610,2016,분당선,기흥,225872,31428,257300
201610,2016,분당선,신갈,110674,31058,141732
201610,2016,분당선,구성,120548,40534,161082
201610,2016,분당선,죽전,450609,87537,538146
201610,2016,분당선,보정,61358,25857,87215
201610,2016,분당선,이매,153181,43425,196606
201610,2016,분당선,오리,359333,94306,453639
201610,2016,분당선,미금,475619,123208,598827
201610,2016,분당선,정자,424418,83934,508352
201610,2016,분당선,수내,337951,80564,418515
201610,2016,분당선,서현,674543,131199,805742
201610,2016,분당선,야탑,723381,161660,885041
201610,2016,분당선,모란,575987,160839,736826
201610,2016,분당선,태평,373321,89108,462429
201610,2016,분당선,가천대,319196,24327,343523
201610,2016,분당선,선정릉,197046,37867,234913
201610,2016,분당선,강남구청,218880,39580,258460
201610,2016,분당선,압구정로데오,395444,38725,434169
201610,2016,분당선,서울숲,196461,25619,222080
201610,2016,분당선,수원,295239,27517,322756
201610,2016,분당선,한티,359310,69175,428485
201610,2016,분당선,선릉,220241,25328,245569
201610,2016,분당선,복정,5,1,6
201610,2016,분당선,수서,203843,47325,251168
201610,2016,분당선,대모산입구,82908,29933,112841
201610,2016,분당선,개포동,91786,23198,114984
201610,2016,분당선,매교,68798,17599,86397
201610,2016,분당선,도곡,162589,39213,201802
201610,2016,과천선,과천,142803,37069,179872
201610,2016,과천선,평촌,444243,64125,508368
201610,2016,과천선,인덕원,723779,107153,830932
201610,2016,과천선,정부과천청사,321947,67123,389070
201610,2016,과천선,대공원,217765,58592,276357
201610,2016,과천선,경마공원,196098,69834,265932
201610,2016,과천선,선바위,260641,34197,294838
201610,2016,과천선,범계,854483,112171,966654
201610,2016,공항철도 1호선,디지털미디어시티,362316,23157,385473
201610,2016,공항철도 1호선,홍대입구,266925,17555,284480
201610,2016,공항철도 1호선,공덕,41384,6209,47593
201610,2016,공항철도 1호선,영종,38165,10655,48820
201610,2016,공항철도 1호선,김포공항,305921,18808,324729
201610,2016,공항철도 1호선,계양,312179,31515,343694
201610,2016,공항철도 1호선,검암,280950,27756,308706
201610,2016,공항철도 1호선,청라국제도시,142286,9493,151779
201610,2016,공항철도 1호선,운서,146595,25613,172208
201610,2016,공항철도 1호선,공항화물청사,71238,7632,78870
201610,2016,공항철도 1호선,인천국제공항,389144,43708,432852
201610,2016,공항철도 1호선,서울역,286826,31263,318089
201610,2016,경춘선,상천,12310,7249,19559
201610,2016,경춘선,가평,89233,18079,107312
201610,2016,경춘선,굴봉산,6126,2296,8422
201610,2016,경춘선,백양리,3783,1310,5093
201610,2016,경춘선,강촌,28311,5680,33991
201610,2016,경춘선,김유정,17193,4339,21532
201610,2016,경춘선,남춘천,85387,25788,111175
201610,2016,경춘선,춘천,69238,25609,94847
201610,2016,경춘선,신내,15677,6828,22505
201610,2016,경춘선,갈매,30187,10971,41158
201610,2016,경춘선,별내,60622,16272,76894
201610,2016,경춘선,청평,58765,17801,76566
201610,2016,경춘선,대성리,21252,5731,26983
201610,2016,경춘선,마석,87977,31864,119841
201610,2016,경춘선,천마산,29005,14344,43349
201610,2016,경춘선,평내호평,144788,41499,186287
201610,2016,경춘선,금곡,33023,15540,48563
201610,2016,경춘선,사릉,95820,19066,114886
201610,2016,경춘선,퇴계원,86503,24755,111258
201610,2016,경인선,오류동,291527,87509,379036
201610,2016,경인선,역곡,851969,147165,999134
201610,2016,경인선,부천,1131629,212000,1343629
201610,2016,경인선,송내,932834,118514,1051348
201610,2016,경인선,부평,1077648,146520,1224168
201610,2016,경인선,백운,233055,67113,300168
201610,2016,경인선,동암,570650,118913,689563
201610,2016,경인선,주안,758650,112600,871250
201610,2016,경인선,제물포,291902,55866,347768
201610,2016,경인선,동인천,473771,131684,605455
201610,2016,경인선,인천,122277,49912,172189
201610,2016,경인선,구일,184232,36011,220243
201610,2016,경인선,소사,340189,90572,430761
201610,2016,경인선,부개,269688,67071,336759
201610,2016,경인선,간석,170481,47965,218446
201610,2016,경인선,도원,100395,36182,136577
201610,2016,경인선,온수(성공회대입구),197631,48386,246017
201610,2016,경인선,중동,258123,68075,326198
201610,2016,경인선,개봉,613608,161299,774907
201610,2016,경인선,도화,89124,36026,125150
201610,2016,경의선,검암,1,0,1
201610,2016,경의선,문산,160552,55067,215619
201610,2016,경의선,파주,51112,8818,59930
201610,2016,경의선,월롱,68238,9184,77422
201610,2016,경의선,금촌,193361,45969,239330
201610,2016,경의선,금릉,130791,26133,156924
201610,2016,경의선,운정,127329,30646,157975
201610,2016,경의선,야당,86576,20791,107367
201610,2016,경의선,탄현,208670,39183,247853
201610,2016,경의선,일산,244643,58712,303355
201610,2016,경의선,풍산,120307,29605,149912
201610,2016,경의선,백마,178407,33075,211482
201610,2016,경의선,곡산,13439,5494,18933
201610,2016,경의선,능곡,92169,31255,123424
201610,2016,경의선,행신,206367,36046,242413
201610,2016,경의선,강매,63218,15957,79175
201610,2016,경의선,화전,78860,8333,87193
201610,2016,경의선,수색,57827,18366,76193
201610,2016,경의선,디지털미디어시티,66711,11056,77767
201610,2016,경의선,가좌,99147,44799,143946
201610,2016,경의선,홍대입구,46053,4838,50891
201610,2016,경의선,서강대,63441,9846,73287
201610,2016,경의선,공덕,57412,9846,67258
201610,2016,경의선,효창공원앞,51649,11198,62847
201610,2016,경의선,신촌,22129,3268,25397
201610,2016,경의선,서울역,73934,9686,83620
201610,2016,경원선,도봉,137368,71176,208544
201610,2016,경원선,왕십리(성동구청),487434,62847,550281
201610,2016,경원선,응봉,47316,19334,66650
201610,2016,경원선,옥수,1592,154,1746
201610,2016,경원선,한남,106268,33635,139903
201610,2016,경원선,서빙고,55430,17376,72806
201610,2016,경원선,이촌(국립중앙박물관),126882,32274,159156
201610,2016,경원선,창동,3,0,3
201610,2016,경원선,녹천,124604,41375,165979
201610,2016,경원선,월계,147101,53919,201020
201610,2016,경원선,광운대,279163,56863,336026
201610,2016,경원선,석계,290710,68886,359596
201610,2016,경원선,신이문,242467,68438,310905
201610,2016,경원선,외대앞,343326,58715,402041
201610,2016,경원선,소요산,81870,109492,191362
201610,2016,경원선,동두천,54276,20612,74888
201610,2016,경원선,보산,47182,15819,63001
201610,2016,경원선,동두천중앙,89024,41483,130507
201610,2016,4호선,명동,1257987,78961,1336948
201610,2016,4호선,회현(남대문시장),760961,204575,965536
201610,2016,4호선,서울역,340265,40478,380743
201610,2016,4호선,숙대입구(갈월),499243,62215,561458
201610,2016,4호선,삼각지,123944,33654,157598
201610,2016,4호선,신용산,362760,54359,417119
201610,2016,4호선,이촌(국립중앙박물관),252037,48598,300635
201610,2016,4호선,동작(현충원),71831,22530,94361
201610,2016,4호선,총신대입구(이수),557177,144951,702128
201610,2016,4호선,사당,860453,97668,958121
201610,2016,4호선,상계,574379,120576,694955
201610,2016,5호선,방화,189184,47881,237065
201610,2016,5호선,마천,118270,49908,168178
201610,2016,5호선,김포공항,209153,27236,236389
201610,2016,5호선,송정,239660,66284,305944
201610,2016,5호선,마곡,124541,20406,144947
201610,2016,5호선,발산,342567,62272,404839
201610,2016,5호선,우장산,415446,78650,494096
201610,2016,5호선,화곡,771952,140858,912810
201610,2016,5호선,까치산,783839,154234,938073
201610,2016,5호선,신정(은행정),395256,59125,454381
201610,2016,5호선,목동,496627,84778,581405
201610,2016,5호선,오목교(목동운동장앞),688599,85571,774170
201610,2016,5호선,양평,160284,28436,188720
201610,2016,5호선,영등포구청,84779,20624,105403
201610,2016,5호선,영등포시장,184940,73682,258622
201610,2016,5호선,신길,86493,12760,99253
201610,2016,5호선,여의도,664690,55894,720584
201610,2016,5호선,여의나루,339927,32925,372852
201610,2016,5호선,마포,389668,66570,456238
201610,2016,5호선,공덕,350592,47091,397683
201610,2016,5호선,애오개,172878,40126,213004
201610,2016,5호선,충정로(경기대입구),122987,17257,140244
201610,2016,5호선,서대문,466600,69389,535989
201610,2016,5호선,광화문(세종문화회관),1058102,89954,1148056
201610,2016,5호선,종로3가,308602,121715,430317
201610,2016,5호선,을지로4가,112477,42253,154730
201610,2016,5호선,동대문역사문화공원,77941,10551,88492
201610,2016,5호선,청구,103236,27185,130421
201610,2016,5호선,신금호,147370,36840,184210
201610,2016,5호선,행당,215843,49417,265260
201610,2016,5호선,왕십리(성동구청),132904,26000,158904
201610,2016,5호선,마장,156119,43928,200047
201610,2016,5호선,답십리,419355,85170,504525
201610,2016,5호선,장한평,475691,99432,575123
201610,2016,5호선,군자(능동),304448,39193,343641
201610,2016,5호선,아차산(어린이대공원후문),386988,93313,480301
201610,2016,5호선,광나루(장신대),405542,68463,474005
201610,2016,5호선,천호(풍납토성),499875,147014,646889
201610,2016,5호선,강동,511993,96980,608973
201610,2016,5호선,길동,175726,58439,234165
201610,2016,5호선,굽은다리(강동구민회관앞),246903,65057,311960
201610,2016,5호선,명일,196516,62538,259054
201610,2016,5호선,고덕,207708,59002,266710
201610,2016,5호선,상일동,289828,64183,354011
201610,2016,5호선,둔촌동,328893,78703,407596
201610,2016,5호선,올림픽공원(한국체대),182718,37316,220034
201610,2016,5호선,방이,180257,41278,221535
201610,2016,5호선,오금,99374,17433,116807
201610,2016,5호선,개롱,174569,43546,218115
201610,2016,5호선,거여,168084,49024,217108
201610,2016,5호선,개화산,149833,35171,185004
201610,2016,6호선,응암,449488,113108,562596
201610,2016,6호선,봉화산(서울의료원),239705,51860,291565
201610,2016,6호선,불광,139159,39799,178958
201610,2016,6호선,독바위,71667,20866,92533
201610,2016,6호선,연신내,23,0,23
201610,2016,6호선,구산,204408,57851,262259
201610,2016,6호선,새절(신사),358803,89966,448769
201610,2016,6호선,증산(명지대앞),260782,71273,332055
201610,2016,6호선,디지털미디어시티,407398,64866,472264
201610,2016,6호선,월드컵경기장(성산),307854,107497,415351
201610,2016,6호선,마포구청,356063,87253,443316
201610,2016,6호선,망원,316104,84532,400636
201610,2016,6호선,합정,402144,41778,443922
201610,2016,6호선,상수,322327,24289,346616
201610,2016,6호선,광흥창(서강),243481,61175,304656
201610,2016,6호선,대흥(서강대앞),221752,45744,267496
201610,2016,6호선,공덕,480690,74751,555441
201610,2016,6호선,효창공원앞,191004,45420,236424
201610,2016,6호선,삼각지,227686,26136,253822
201610,2016,6호선,녹사평(용산구청),226117,23917,250034
201610,2016,6호선,이태원,543982,39642,583624
201610,2016,6호선,한강진,196573,14660,211233
201610,2016,6호선,버티고개,64683,15037,79720
201610,2016,6호선,약수,90364,23376,113740
201610,2016,6호선,청구,101107,19044,120151
201610,2016,6호선,신당,230650,37292,267942
201610,2016,6호선,동묘앞,218933,68435,287368
201610,2016,6호선,창신,89071,17343,106414
201610,2016,6호선,보문,233320,39820,273140
201610,2016,6호선,안암(고대병원앞),411355,31934,443289
201610,2016,6호선,고려대(종암),295909,37001,332910
201610,2016,6호선,월곡(동덕여대),340574,73108,413682
201610,2016,6호선,상월곡(한국과학기술연구원),165183,38841,204024
201610,2016,6호선,돌곶이,245143,62848,307991
201610,2016,6호선,석계,352223,75125,427348
201610,2016,6호선,태릉입구,140562,27537,168099
201610,2016,6호선,화랑대(서울여대입구),388229,46673,434902
201610,2016,6호선,역촌,84938,36079,121017
201610,2016,7호선,장암,73039,9368,82407
201610,2016,7호선,도봉산,267958,46627,314585
201610,2016,7호선,수락산,362123,91485,453608
201610,2016,7호선,마들,308647,75077,383724
201610,2016,7호선,노원,537039,112293,649332
201610,2016,7호선,중계,416449,95937,512386
201610,2016,7호선,하계,535237,107801,643038
201610,2016,7호선,공릉(서울과학기술대),343466,68383,411849
201610,2016,7호선,태릉입구,254756,39480,294236
201610,2016,7호선,먹골,276650,57645,334295
201610,2016,7호선,중화,303568,60301,363869
201610,2016,7호선,상봉(시외버스터미널),480087,74617,554704
201610,2016,7호선,면목,432491,83196,515687
201610,2016,7호선,사가정,406549,92415,498964
201610,2016,7호선,용마산,163823,37009,200832
201610,2016,7호선,중곡,270510,61415,331925
201610,2016,7호선,군자(능동),382599,79902,462501
201610,2016,7호선,어린이대공원(세종대),508506,49871,558377
201610,2016,7호선,건대입구,474894,50645,525539
201610,2016,7호선,뚝섬유원지,263249,46841,310090
201610,2016,7호선,청담,572779,73991,646770
201610,2016,7호선,강남구청,417848,50380,468228
201610,2016,7호선,학동,606555,65916,672471
201610,2016,7호선,논현,544080,52759,596839
201610,2016,7호선,반포,171297,31879,203176
201610,2016,7호선,고속터미널,625039,85669,710708
201610,2016,7호선,내방,368452,64307,432759
201610,2016,7호선,이수,447139,78582,525721
201610,2016,7호선,남성,294215,70145,364360
201610,2016,7호선,숭실대입구(살피재),457068,60897,517965
201610,2016,7호선,상도,303108,63567,366675
201610,2016,7호선,장승배기,266006,77864,343870
201610,2016,7호선,신대방삼거리,412362,94126,506488
201610,2016,7호선,보라매,259030,44219,303249
201610,2016,7호선,신풍,291002,66391,357393
201610,2016,7호선,대림(구로구청),314908,36082,350990
201610,2016,7호선,남구로,438739,59953,498692
201610,2016,7호선,가산디지털단지,1128475,74804,1203279
201610,2016,7호선,철산,662069,98773,760842
201610,2016,7호선,광명사거리,713427,149790,863217
201610,2016,7호선,천왕,217397,45193,262590
201610,2016,7호선,온수(성공회대입구),315261,35099,350360
201610,2016,7호선,까치울,185644,25862,211506
201610,2016,7호선,부천종합운동장,154996,18794,173790
201610,2016,7호선,춘의,231868,26653,258521
201610,2016,7호선,신중동,398943,47795,446738
201610,2016,7호선,부천시청,345464,45644,391108
201610,2016,7호선,상동,400975,45814,446789
201610,2016,7호선,삼산체육관,152654,24242,176896
201610,2016,7호선,굴포천,241793,32800,274593
201610,2016,7호선,부평구청,344691,30365,375056
201610,2016,8호선,암사,461791,90967,552758
201610,2016,8호선,모란,94388,52665,147053
201610,2016,8호선,강동구청,257550,61790,319340
201610,2016,8호선,몽촌토성(평화의문),184041,46175,230216
201610,2016,8호선,잠실(송파구청),330016,60200,390216
201610,2016,8호선,석촌,216052,60180,276232
201610,2016,8호선,송파,136754,37931,174685
201610,2016,8호선,가락시장,167100,51920,219020
201610,2016,8호선,문정,222450,34228,256678
201610,2016,8호선,장지,403031,58615,461646
201610,2016,8호선,복정,289070,42849,331919
201610,2016,8호선,산성,190684,41052,231736
201610,2016,8호선,남한산성입구(성남법원.검찰청),398158,76429,474587
201610,2016,8호선,단대오거리,324130,68711,392841
201610,2016,8호선,신흥,110462,47542,158004
201610,2016,8호선,수진,119857,40083,159940
201610,2016,8호선,천호(풍납토성),486845,92194,579039
201610,2016,9호선,개화,174786,36471,211257
201610,2016,9호선,김포공항,267930,18673,286603
201610,2016,9호선,신논현,833734,50270,884004
201610,2016,9호선,사평,71089,15189,86278
201610,2016,9호선,고속터미널,484271,54098,538369
201610,2016,9호선,신반포,88747,23747,112494
201610,2016,9호선,공항시장,70528,21506,92034
201610,2016,9호선,신방화,212024,43800,255824
201610,2016,9호선,마곡나루,80197,9802,89999
201610,2016,9호선,양천향교,194042,38965,233007
201610,2016,9호선,가양,533703,120876,654579
201610,2016,9호선,증미,175525,41740,217265
201610,2016,9호선,등촌,236529,80893,317422
201610,2016,9호선,염창,433688,59307,492995
201610,2016,9호선,신목동,110376,18149,128525
201610,2016,9호선,선유도,180100,25873,205973
201610,2016,9호선,당산,489423,60743,550166
201610,2016,9호선,국회의사당,419307,55079,474386
201610,2016,9호선,여의도,556671,42362,599033
201610,2016,9호선,샛강,140787,25415,166202
201610,2016,9호선,노량진,809285,86807,896092
201610,2016,9호선,노들,130832,30562,161394
201610,2016,9호선,흑석(중앙대입구),284202,55579,339781
201610,2016,9호선,동작(현충원),51719,14888,66607
201610,2016,9호선,구반포,79966,23695,103661
201610,2016,9호선2단계,언주,206586,22433,229019
201610,2016,9호선2단계,봉은사,346346,36432,382778
201610,2016,9호선2단계,삼성중앙,120866,18196,139062
201610,2016,9호선2단계,선정릉,187026,19520,206546
201610,2016,9호선2단계,종합운동장,172681,13825,186506
201610,2016,경강선,판교,67858,11633,79491
201610,2016,경강선,이매,39841,12562,52403
201610,2016,경강선,삼동,30274,6407,36681
201610,2016,경강선,경기광주,106850,17316,124166
201610,2016,경강선,초월,51403,9930,61333
201610,2016,경강선,여주,65128,29681,94809
201610,2016,경강선,신둔도예촌,28641,5489,34130
201610,2016,경강선,이천,58429,13103,71532
201610,2016,경강선,부발,39537,5766,45303
201610,2016,경강선,세종대왕릉,8705,6710,15415
201610,2016,경강선,곤지암,65793,16455,82248
201610,2016,경부선,구로,583977,94620,678597
201610,2016,경부선,신길,293606,49754,343360
201610,2016,경부선,금천구청,289148,80206,369354
201610,2016,경부선,석수,329270,49133,378403
201610,2016,경부선,관악,227669,56059,283728
201610,2016,경부선,안양,809916,116874,926790
201610,2016,경부선,명학,291541,43159,334700
201610,2016,경부선,금정,791720,110261,901981
201610,2016,경부선,군포,199931,35862,235793
201610,2016,경부선,의왕,232199,40674,272873
201610,2016,경부선,성균관대,465613,52616,518229
201610,2016,경부선,화서,235798,45161,280959
201610,2016,경부선,수원,1314244,154693,1468937
201610,2016,경부선,독산,431138,67658,498796
201610,2016,경부선,세류,119674,19868,139542
201610,2016,경부선,병점,464015,59718,523733
201610,2016,경부선,세마,71429,13748,85177
201610,2016,경부선,오산대,87592,14040,101632
201610,2016,경부선,오산,296896,43392,340288
201610,2016,경부선,진위,45820,8349,54169
201610,2016,경부선,송탄,135155,26231,161386
201610,2016,경부선,서정리,154882,26320,181202
201610,2016,경부선,지제,30325,4830,35155
201610,2016,경부선,평택,407028,71622,478650
201610,2016,경부선,성환,154139,21325,175464
201610,2016,경부선,직산,25918,6227,32145
201610,2016,경부선,두정,188617,22576,211193
201610,2016,경부선,천안,242986,64912,307898
201610,2016,경부선,당정,214163,31688,245851
201610,2016,경부선,서동탄,42282,8944,51226
201610,2016,경부선,광명,25636,1522,27158
201610,2016,경부선,서울역,24,0,24
201610,2016,경부선,남영,332609,42416,375025
201610,2016,경부선,용산,1113995,148288,1262283
201610,2016,경부선,노량진,525619,57360,582979
201610,2016,경부선,대방,436236,78867,515103
201610,2016,경부선,영등포,1294349,277435,1571784
201610,2016,경부선,신도림,109460,22633,132093
201610,2016,경부선,가산디지털단지,457125,31411,488536
201610,2016,경원선,방학,218336,107644,325980
201610,2016,경원선,청량리(서울시립대입구),326435,141983,468418
201610,2016,경원선,망월사,223341,70596,293937
201610,2016,경원선,회룡,285890,145082,430972
201610,2016,경원선,의정부,600324,129066,729390
201610,2016,경원선,가능,181295,67204,248499
201610,2016,경원선,녹양,131007,35528,166535
201610,2016,경원선,양주,249122,60050,309172
201610,2016,경원선,덕계,53837,17871,71708
201610,2016,경원선,덕정,204367,38225,242592
201610,2016,경원선,지행,195183,48319,243502
201610,2016,경원선,도봉산,176424,93749,270173
201610,2016,1호선,서울역,1723041,232308,1955349
201610,2016,1호선,시청,688625,101695,790320
201610,2016,1호선,종각,1246215,156210,1402425
201610,2016,1호선,종로3가,734517,369426,1103943
201610,2016,1호선,동묘앞,183813,145243,329056
201610,2016,1호선,동대문,360282,139497,499779
201610,2016,1호선,신설동,384106,125253,509359
201610,2016,1호선,제기동,302169,319124,621293
201610,2016,1호선,청량리(서울시립대입구),562758,349566,912324
201610,2016,1호선,종로5가,570581,263393,833974
201610,2016,2호선,시청,693784,59195,752979
201610,2016,2호선,용두(동대문구청),47116,23427,70543
201610,2016,2호선,을지로3가,527581,91054,618635
201610,2016,2호선,을지로4가,302571,94350,396921
201610,2016,2호선,동대문역사문화공원,559753,59562,619315
201610,2016,2호선,신당,366050,110172,476222
201610,2016,2호선,상왕십리,276163,59383,335546
201610,2016,2호선,왕십리(성동구청),576568,63458,640026
201610,2016,2호선,한양대,387578,16998,404576
201610,2016,2호선,뚝섬,450601,66984,517585
201610,2016,2호선,성수,688587,99992,788579
201610,2016,2호선,건대입구,1324155,100138,1424293
201610,2016,2호선,구의(광진구청),639018,111451,750469
201610,2016,2호선,강변(동서울터미널),1426467,158436,1584903
201610,2016,2호선,잠실나루,471222,90604,561826
201610,2016,2호선,잠실(송파구청),2489913,225061,2714974
201610,2016,2호선,신천,708127,119231,827358
201610,2016,2호선,종합운동장,525082,68518,593600
201610,2016,2호선,삼성(무역센터),1568343,127702,1696045
201610,2016,2호선,선릉,1433228,198288,1631516
201610,2016,2호선,역삼,1170975,149345,1320320
201610,2016,2호선,강남,2744849,164766,2909615
201610,2016,2호선,교대(법원.검찰청),987441,165041,1152482
201610,2016,2호선,서초,650171,88871,739042
201610,2016,2호선,방배,591706,83309,675015
201610,2016,2호선,사당,1123093,204213,1327306
201610,2016,2호선,낙성대,856137,114184,970321
201610,2016,2호선,서울대입구(관악구청),1434399,215042,1649441
201610,2016,2호선,봉천,580690,153037,733727
201610,2016,2호선,신림,1997889,249822,2247711
201610,2016,2호선,신대방,762988,138411,901399
201610,2016,2호선,구로디지털단지,1784485,169041,1953526
201610,2016,2호선,대림(구로구청),876304,122014,998318
201610,2016,2호선,신도림,1761989,211004,1972993
201610,2016,2호선,문래,503551,86671,590222
201610,2016,2호선,영등포구청,552002,105216,657218
201610,2016,2호선,당산,606859,69141,676000
201610,2016,2호선,합정,968891,80025,1048916
201610,2016,2호선,홍대입구,2257023,122192,2379215
201610,2016,2호선,신촌,1429866,145010,1574876
201610,2016,2호선,이대,626398,74754,701152
201610,2016,2호선,아현,251986,65020,317006
201610,2016,2호선,충정로(경기대입구),304367,54922,359289
201610,2016,2호선,용답,63036,17322,80358
201610,2016,2호선,신답,31559,11275,42834
201610,2016,2호선,신설동,90693,36292,126985
201610,2016,2호선,도림천,24807,6161,30968
201610,2016,2호선,양천구청,175180,48415,223595
201610,2016,2호선,신정네거리,258768,67866,326634
201610,2016,2호선,을지로입구,1463612,117936,1581548
201610,2016,3호선,지축,32400,12507,44907
201610,2016,3호선,오금,186906,27427,214333
201610,2016,3호선,연신내,1063111,268289,1331400
201610,2016,3호선,불광,472078,153577,625655
201610,2016,3호선,녹번,345924,72880,418804
201610,2016,3호선,홍제,485010,156185,641195
201610,2016,3호선,무악재,96842,33768,130610
201610,2016,3호선,독립문,173898,75532,249430
201610,2016,3호선,경복궁(정부서울청사),754910,97739,852649
201610,2016,3호선,안국,758530,133689,892219
201610,2016,3호선,종로3가,190653,64032,254685
201610,2016,3호선,을지로3가,213581,58028,271609
201610,2016,3호선,충무로,30,3,33
201610,2016,3호선,동대입구,370633,43031,413664
201610,2016,3호선,약수,361514,88448,449962
201610,2016,3호선,금호,192972,54648,247620
201610,2016,3호선,옥수,257977,61082,319059
201610,2016,3호선,압구정,913375,157487,1070862
201610,2016,3호선,신사,884696,75976,960672
201610,2016,3호선,잠원,151857,34833,186690
201610,2016,3호선,고속터미널,1607441,184610,1792051
201610,2016,3호선,교대(법원.검찰청),368116,68865,436981
201610,2016,3호선,남부터미널(예술의전당),971373,134341,1105714
201610,2016,3호선,양재(서초구청),1102503,165005,1267508
201610,2016,3호선,매봉,297309,55870,353179
201610,2016,3호선,도곡,189350,29511,218861
201610,2016,3호선,대치,319319,63809,383128
201610,2016,3호선,학여울,74714,15987,90701
201610,2016,3호선,대청,265983,51812,317795
201610,2016,3호선,일원,228238,61922,290160
201610,2016,3호선,수서,284637,87018,371655
201610,2016,3호선,가락시장,225215,68928,294143
201610,2016,3호선,경찰병원,194474,38784,233258
201610,2016,3호선,구파발,480519,94241,574760
201610,2016,4호선,당고개,333627,95885,429512
201610,2016,4호선,남태령,68402,9726,78128
201610,2016,4호선,노원,633487,95015,728502
201610,2016,4호선,창동,758637,190763,949400
201610,2016,4호선,쌍문,893672,172663,1066335
201610,2016,4호선,수유(강북구청),1194573,262714,1457287
201610,2016,4호선,미아(서울사이버대학),481768,137831,619599
201610,2016,4호선,미아사거리,846587,194830,1041417
201610,2016,4호선,길음,747463,154644,902107
201610,2016,4호선,성신여대입구(돈암),753086,107493,860579
201610,2016,4호선,한성대입구(삼선교),470185,82297,552482
201610,2016,4호선,혜화,1222540,135708,1358248
201610,2016,4호선,동대문,677606,159210,836816
201610,2016,4호선,동대문역사문화공원,705057,66525,771582
201610,2016,4호선,충무로,933894,134692,1068586
201610,2016,4호선,명동,1257987,78961,1336948
201610,2016,4호선,회현(남대문시장),760961,204575,965536
201610,2016,4호선,서울역,340265,40478,380743
201610,2016,4호선,숙대입구(갈월),499243,62215,561458
201610,2016,4호선,삼각지,123944,33654,157598
201610,2016,4호선,신용산,362760,54359,417119
201610,2016,4호선,이촌(국립중앙박물관),252037,48598,300635
201610,2016,4호선,동작(현충원),71831,22530,94361
201610,2016,4호선,총신대입구(이수),557177,144951,702128
201610,2016,4호선,사당,860453,97668,958121
201610,2016,4호선,상계,574379,120576,694955
201610,2016,5호선,방화,189184,47881,237065
201610,2016,5호선,마천,118270,49908,168178
201610,2016,5호선,김포공항,209153,27236,236389
201610,2016,5호선,송정,239660,66284,305944
201610,2016,5호선,마곡,124541,20406,144947
201610,2016,5호선,발산,342567,62272,404839
201610,2016,5호선,우장산,415446,78650,494096
201610,2016,5호선,화곡,771952,140858,912810
201610,2016,5호선,까치산,783839,154234,938073
201610,2016,5호선,신정(은행정),395256,59125,454381
201610,2016,5호선,목동,496627,84778,581405
201610,2016,5호선,오목교(목동운동장앞),688599,85571,774170
201610,2016,5호선,양평,160284,28436,188720
201610,2016,5호선,영등포구청,84779,20624,105403
201610,2016,5호선,영등포시장,184940,73682,258622
201610,2016,5호선,신길,86493,12760,99253
201610,2016,5호선,여의도,664690,55894,720584
201610,2016,5호선,여의나루,339927,32925,372852
201610,2016,5호선,마포,389668,66570,456238
201610,2016,5호선,공덕,350592,47091,397683
201610,2016,5호선,애오개,172878,40126,213004
201610,2016,5호선,충정로(경기대입구),122987,17257,140244
201610,2016,5호선,서대문,466600,69389,535989
201610,2016,5호선,광화문(세종문화회관),1058102,89954,1148056
201610,2016,5호선,종로3가,308602,121715,430317
201610,2016,5호선,을지로4가,112477,42253,154730
201610,2016,5호선,동대문역사문화공원,77941,10551,88492
201610,2016,5호선,청구,103236,27185,130421
201610,2016,5호선,신금호,147370,36840,184210
201610,2016,5호선,행당,215843,49417,265260
201610,2016,5호선,왕십리(성동구청),132904,26000,158904
201610,2016,5호선,마장,156119,43928,200047
201610,2016,5호선,답십리,419355,85170,504525
201610,2016,5호선,장한평,475691,99432,575123
201610,2016,5호선,군자(능동),304448,39193,343641
201610,2016,5호선,아차산(어린이대공원후문),386988,93313,480301
201610,2016,5호선,광나루(장신대),405542,68463,474005
201610,2016,5호선,천호(풍납토성),499875,147014,646889
201610,2016,5호선,강동,511993,96980,608973
201610,2016,5호선,길동,175726,58439,234165
201610,2016,5호선,굽은다리(강동구민회관앞),246903,65057,311960
201610,2016,5호선,명일,196516,62538,259054
201610,2016,5호선,고덕,207708,59002,266710
201610,2016,5호선,상일동,289828,64183,354011
201610,2016,5호선,둔촌동,328893,78703,407596
201610,2016,5호선,올림픽공원(한국체대),182718,37316,220034
201610,2016,5호선,방이,180257,41278,221535
201610,2016,5호선,오금,99374,17433,116807
201610,2016,5호선,개롱,174569,43546,218115
201610,2016,5호선,거여,168084,49024,217108
201610,2016,5호선,개화산,149833,35171,185004
201610,2016,6호선,응암,449488,113108,562596
201610,2016,6호선,봉화산(서울의료원),239705,51860,291565
201610,2016,6호선,불광,139159,39799,178958
201610,2016,6호선,독바위,71667,20866,92533
201610,2016,6호선,연신내,23,0,23
201610,2016,6호선,구산,204408,57851,262259
201610,2016,6호선,새절(신사),358803,89966,448769
201610,2016,6호선,증산(명지대앞),260782,71273,332055
201610,2016,6호선,디지털미디어시티,407398,64866,472264
201610,2016,6호선,월드컵경기장(성산),307854,107497,415351
201610,2016,6호선,마포구청,356063,87253,443316
201610,2016,6호선,망원,316104,84532,400636
201610,2016,6호선,합정,402144,41778,443922
201610,2016,6호선,상수,322327,24289,346616
201610,2016,6호선,광흥창(서강),243481,61175,304656
201610,2016,6호선,대흥(서강대앞),221752,45744,267496
201610,2016,6호선,공덕,480690,74751,555441
201610,2016,6호선,효창공원앞,191004,45420,236424
201610,2016,6호선,삼각지,227686,26136,253822
201610,2016,6호선,녹사평(용산구청),226117,23917,250034
201610,2016,6호선,이태원,543982,39642,583624
201610,2016,6호선,한강진,196573,14660,211233
201610,2016,6호선,버티고개,64683,15037,79720
201610,2016,6호선,약수,90364,23376,113740
201610,2016,6호선,청구,101107,19044,120151
201610,2016,6호선,신당,230650,37292,267942
201610,2016,6호선,동묘앞,218933,68435,287368
201610,2016,6호선,창신,89071,17343,106414
201610,2016,6호선,보문,233320,39820,273140
201610,2016,6호선,안암(고대병원앞),411355,31934,443289
201610,2016,6호선,고려대(종암),295909,37001,332910
201610,2016,6호선,월곡(동덕여대),340574,73108,413682
201610,2016,6호선,상월곡(한국과학기술연구원),165183,38841,204024
201610,2016,6호선,돌곶이,245143,62848,307991
201610,2016,6호선,석계,352223,75125,427348
201610,2016,6호선,태릉입구,140562,27537,168099
201610,2016,6호선,화랑대(서울여대입구),388229,46673,434902
201610,2016,6호선,역촌,84938,36079,121017
201610,2016,7호선,장암,73039,9368,82407
201610,2016,7호선,도봉산,267958,46627,314585
201610,2016,7호선,수락산,362123,91485,453608
201610,2016,7호선,마들,308647,75077,383724
201610,2016,7호선,노원,537039,112293,649332
201610,2016,7호선,중계,416449,95937,512386
201610,2016,7호선,하계,535237,107801,643038
201610,2016,7호선,공릉(서울과학기술대),343466,68383,411849
201610,2016,7호선,태릉입구,254756,39480,294236
201610,2016,7호선,먹골,276650,57645,334295
201610,2016,7호선,중화,303568,60301,363869
201610,2016,7호선,상봉(시외버스터미널),480087,74617,554704
201610,2016,7호선,면목,432491,83196,515687
201610,2016,7호선,사가정,406549,92415,498964
201610,2016,7호선,용마산,163823,37009,200832
201610,2016,7호선,중곡,270510,61415,331925
201610,2016,7호선,군자(능동),382599,79902,462501
201610,2016,7호선,어린이대공원(세종대),508506,49871,558377
201610,2016,7호선,건대입구,474894,50645,525539
201610,2016,7호선,뚝섬유원지,263249,46841,310090
201610,2016,7호선,청담,572779,73991,646770
201610,2016,7호선,강남구청,417848,50380,468228
201610,2016,7호선,학동,606555,65916,672471
201610,2016,7호선,논현,544080,52759,596839
201610,2016,7호선,반포,171297,31879,203176
201610,2016,7호선,고속터미널,625039,85669,710708
201610,2016,7호선,내방,368452,64307,432759
201610,2016,7호선,이수,447139,78582,525721
201610,2016,7호선,남성,294215,70145,364360
201610,2016,7호선,숭실대입구(살피재),457068,60897,517965
201610,2016,7호선,상도,303108,63567,366675
201610,2016,7호선,장승배기,266006,77864,343870
201610,2016,7호선,신대방삼거리,412362,94126,506488
201610,2016,7호선,보라매,259030,44219,303249
201610,2016,7호선,신풍,291002,66391,357393
201610,2016,7호선,대림(구로구청),314908,36082,350990
201610,2016,7호선,남구로,438739,59953,498692
201610,2016,7호선,가산디지털단지,1128475,74804,1203279
201610,2016,7호선,철산,662069,98773,760842
201610,2016,7호선,광명사거리,713427,149790,863217
201610,2016,7호선,천왕,217397,45193,262590
201610,2016,7호선,온수(성공회대입구),315261,35099,350360
201610,2016,7호선,까치울,185644,25862,211506
201610,2016,7호선,부천종합운동장,154996,18794,173790
201610,2016,7호선,춘의,231868,26653,258521
201610,2016,7호선,신중동,398943,47795,446738
201610,2016,7호선,부천시청,345464,45644,391108
201610,2016,7호선,상동,400975,45814,446789
201610,2016,7호선,삼산체육관,152654,24242,176896
201610,2016,7호선,굴포천,241793,32800,274593
201610,2016,7호선,부평구청,344691,30365,375056
201610,2016,8호선,암사,461791,90967,552758
201610,2016,8호선,모란,94388,52665,147053
201610,2016,8호선,강동구청,257550,61790,319340
201610,2016,8호선,몽촌토성(평화의문),184041,46175,230216
201610,2016,8호선,잠실(송파구청),330016,60200,390216
201610,2016,8호선,석촌,216052,60180,276232
201610,2016,8호선,송파,136754,37931,174685
201610,2016,8호선,가락시장,167100,51920,219020
201610,2016,8호선,문정,222450,34228,256678
201610,2016,8호선,장지,403031,58615,461646
201610,2016,8호선,복정,289070,42849,331919
201610,2016,8호선,산성,190684,41052,231736
201610,2016,8호선,남한산성입구(성남법원.검찰청),398158,76429,474587
201610,2016,8호선,단대오거리,324130,68711,392841
201610,2016,8호선,신흥,110462,47542,158004
201610,2016,8호선,수진,119857,40083,159940
201610,2016,8호선,천호(풍납토성),486845,92194,579039
201610,2016,9호선,개화,174786,36471,211257
201610,2016,9호선,김포공항,267930,18673,286603
201610,2016,9호선,신논현,833734,50270,884004
201610,2016,9호선,사평,71089,15189,86278
201610,2016,9호선,고속터미널,484271,54098,538369
201610,2016,9호선,신반포,88747,23747,112494
201610,2016,9호선,공항시장,70528,21506,92034
201610,2016,9호선,신방화,212024,43800,255824
201610,2016,9호선,마곡나루,80197,9802,89999
201610,2016,9호선,양천향교,194042,38965,233007
201610,2016,9호선,가양,533703,120876,654579
201610,2016,9호선,증미,175525,41740,217265
201610,2016,9호선,등촌,236529,80893,317422
201610,2016,9호선,염창,433688,59307,492995
201610,2016,9호선,신목동,110376,18149,128525
201610,2016,9호선,선유도,180100,25873,205973
201610,2016,9호선,당산,489423,60743,550166
201610,2016,9호선,국회의사당,419307,55079,474386
201610,2016,9호선,여의도,556671,42362,599033
201610,2016,9호선,샛강,140787,25415,166202
201610,2016,9호선,노량진,809285,86807,896092
201610,2016,9호선,노들,130832,30562,161394
201610,2016,9호선,흑석(중앙대입구),284202,55579,339781
201610,2016,9호선,동작(현충원),51719,14888,66607
201610,2016,4호선,충무로,933894,134692,1068586
201610,2016,9호선,구반포,79966,23695,103661
201610,2016,9호선2단계,언주,206586,22433,229019
201610,2016,9호선2단계,봉은사,346346,36432,382778
201610,2016,9호선2단계,삼성중앙,120866,18196,139062
201610,2016,9호선2단계,선정릉,187026,19520,206546
201610,2016,9호선2단계,종합운동장,172681,13825,186506
201610,2016,경강선,판교,67858,11633,79491
201610,2016,경강선,이매,39841,12562,52403
201610,2016,경강선,삼동,30274,6407,36681
201610,2016,경강선,경기광주,106850,17316,124166
201610,2016,경강선,초월,51403,9930,61333
201610,2016,경강선,여주,65128,29681,94809
201610,2016,경강선,신둔도예촌,28641,5489,34130
201610,2016,경강선,이천,58429,13103,71532
201610,2016,경강선,부발,39537,5766,45303
201610,2016,경강선,세종대왕릉,8705,6710,15415
201610,2016,경강선,곤지암,65793,16455,82248
201610,2016,경부선,구로,583977,94620,678597
201610,2016,경부선,신길,293606,49754,343360
201610,2016,경부선,금천구청,289148,80206,369354
201610,2016,경부선,석수,329270,49133,378403
201610,2016,경부선,관악,227669,56059,283728
201610,2016,경부선,안양,809916,116874,926790
201610,2016,경부선,명학,291541,43159,334700
201610,2016,경부선,금정,791720,110261,901981
201610,2016,경부선,군포,199931,35862,235793
201610,2016,경부선,의왕,232199,40674,272873
201610,2016,경부선,성균관대,465613,52616,518229
201610,2016,경부선,화서,235798,45161,280959
201610,2016,경부선,수원,1314244,154693,1468937
201610,2016,경부선,독산,431138,67658,498796
201610,2016,경부선,세류,119674,19868,139542
201610,2016,경부선,병점,464015,59718,523733
201610,2016,경부선,세마,71429,13748,85177
201610,2016,경부선,오산대,87592,14040,101632
201610,2016,경부선,오산,296896,43392,340288
201610,2016,경부선,진위,45820,8349,54169
201610,2016,경부선,송탄,135155,26231,161386
201610,2016,경부선,서정리,154882,26320,181202
201610,2016,경부선,지제,30325,4830,35155
201610,2016,경부선,평택,407028,71622,478650
201610,2016,경부선,성환,154139,21325,175464
201610,2016,경부선,직산,25918,6227,32145
201610,2016,경부선,두정,188617,22576,211193
201610,2016,경부선,천안,242986,64912,307898
201610,2016,경부선,당정,214163,31688,245851
201610,2016,경부선,서동탄,42282,8944,51226
201610,2016,경부선,광명,25636,1522,27158
201610,2016,경부선,서울역,24,0,24
201610,2016,경부선,남영,332609,42416,375025
201610,2016,경부선,용산,1113995,148288,1262283
201610,2016,경부선,노량진,525619,57360,582979
201610,2016,경부선,대방,436236,78867,515103
201610,2016,경부선,영등포,1294349,277435,1571784
201610,2016,경부선,신도림,109460,22633,132093
201610,2016,경부선,가산디지털단지,457125,31411,488536
201610,2016,경원선,방학,218336,107644,325980
201610,2016,경원선,청량리(서울시립대입구),326435,141983,468418
201610,2016,경원선,도봉산,176424,93749,270173
201610,2016,경원선,망월사,223341,70596,293937
201610,2016,경원선,회룡,285890,145082,430972
201610,2016,경원선,의정부,600324,129066,729390
201610,2016,경원선,가능,181295,67204,248499
201610,2016,경원선,녹양,131007,35528,166535
201610,2016,경원선,양주,249122,60050,309172
201610,2016,경원선,덕계,53837,17871,71708
201610,2016,경원선,덕정,204367,38225,242592
201610,2016,경원선,지행,195183,48319,243502
201610,2016,경원선,동두천중앙,89024,41483,130507
201610,2016,경원선,보산,47182,15819,63001
201610,2016,경원선,동두천,54276,20612,74888
201610,2016,경원선,소요산,81870,109492,191362
201610,2016,경원선,외대앞,343326,58715,402041
201610,2016,경원선,신이문,242467,68438,310905
201610,2016,경원선,석계,290710,68886,359596
201610,2016,경원선,광운대,279163,56863,336026
201610,2016,경원선,월계,147101,53919,201020
201610,2016,경원선,녹천,124604,41375,165979
201610,2016,경원선,창동,3,0,3
201610,2016,경원선,이촌(국립중앙박물관),126882,32274,159156
201610,2016,경원선,서빙고,55430,17376,72806
201610,2016,경원선,한남,106268,33635,139903
201610,2016,경원선,옥수,1592,154,1746
201610,2016,경원선,응봉,47316,19334,66650
201610,2016,경원선,왕십리(성동구청),487434,62847,550281
201610,2016,경원선,도봉,137368,71176,208544
201610,2016,경의선,서울역,73934,9686,83620
201610,2016,경의선,신촌,22129,3268,25397
201610,2016,경의선,효창공원앞,51649,11198,62847
201610,2016,경의선,공덕,57412,9846,67258
201610,2016,경의선,서강대,63441,9846,73287
201610,2016,경의선,홍대입구,46053,4838,50891
201610,2016,경의선,가좌,99147,44799,143946
201610,2016,경의선,디지털미디어시티,66711,11056,77767
201610,2016,경의선,수색,57827,18366,76193
201610,2016,경의선,화전,78860,8333,87193
201610,2016,경의선,강매,63218,15957,79175
201610,2016,경의선,행신,206367,36046,242413
201610,2016,경의선,능곡,92169,31255,123424
201610,2016,경의선,곡산,13439,5494,18933
201610,2016,경의선,백마,178407,33075,211482
201610,2016,경의선,풍산,120307,29605,149912
201610,2016,경의선,일산,244643,58712,303355
201610,2016,경의선,탄현,208670,39183,247853
201610,2016,경의선,야당,86576,20791,107367
201610,2016,경의선,운정,127329,30646,157975
201610,2016,경의선,금릉,130791,26133,156924
201610,2016,경의선,금촌,193361,45969,239330
201610,2016,경의선,월롱,68238,9184,77422
201610,2016,경의선,파주,51112,8818,59930
201610,2016,경의선,문산,160552,55067,215619
201610,2016,경의선,검암,1,0,1
201610,2016,경인선,도화,89124,36026,125150
201610,2016,경인선,개봉,613608,161299,774907
201610,2016,경인선,중동,258123,68075,326198
201610,2016,경인선,온수(성공회대입구),197631,48386,246017
201610,2016,경인선,도원,100395,36182,136577
201610,2016,경인선,간석,170481,47965,218446
201610,2016,경인선,부개,269688,67071,336759
201610,2016,경인선,소사,340189,90572,430761
201610,2016,경인선,구일,184232,36011,220243
201610,2016,경인선,인천,122277,49912,172189
201610,2016,경인선,동인천,473771,131684,605455
201610,2016,경인선,제물포,291902,55866,347768
201610,2016,경인선,주안,758650,112600,871250
201610,2016,경인선,동암,570650,118913,689563
201610,2016,경인선,백운,233055,67113,300168
201610,2016,경인선,부평,1077648,146520,1224168
201610,2016,경인선,송내,932834,118514,1051348
201610,2016,경인선,부천,1131629,212000,1343629
201610,2016,경인선,역곡,851969,147165,999134
201610,2016,경인선,오류동,291527,87509,379036
201610,2016,경춘선,퇴계원,86503,24755,111258
201610,2016,경춘선,사릉,95820,19066,114886
201610,2016,경춘선,금곡,33023,15540,48563
201610,2016,경춘선,평내호평,144788,41499,186287
201610,2016,경춘선,천마산,29005,14344,43349
201610,2016,경춘선,마석,87977,31864,119841
201610,2016,경춘선,대성리,21252,5731,26983
201610,2016,경춘선,청평,58765,17801,76566
201610,2016,경춘선,별내,60622,16272,76894
201610,2016,경춘선,갈매,30187,10971,41158
201610,2016,경춘선,신내,15677,6828,22505
201610,2016,경춘선,춘천,69238,25609,94847
201610,2016,경춘선,남춘천,85387,25788,111175
201610,2016,경춘선,김유정,17193,4339,21532
201610,2016,경춘선,강촌,28311,5680,33991
201610,2016,경춘선,백양리,3783,1310,5093
201610,2016,경춘선,굴봉산,6126,2296,8422
201610,2016,경춘선,가평,89233,18079,107312
201610,2016,경춘선,상천,12310,7249,19559
201610,2016,공항철도 1호선,서울역,286826,31263,318089
201610,2016,공항철도 1호선,인천국제공항,389144,43708,432852
201610,2016,공항철도 1호선,공항화물청사,71238,7632,78870
201610,2016,공항철도 1호선,운서,146595,25613,172208
201610,2016,공항철도 1호선,청라국제도시,142286,9493,151779
201610,2016,공항철도 1호선,검암,280950,27756,308706
201610,2016,공항철도 1호선,계양,312179,31515,343694
201610,2016,공항철도 1호선,김포공항,305921,18808,324729
201610,2016,공항철도 1호선,영종,38165,10655,48820
201610,2016,공항철도 1호선,공덕,41384,6209,47593
201610,2016,공항철도 1호선,홍대입구,266925,17555,284480
201610,2016,공항철도 1호선,디지털미디어시티,362316,23157,385473
201610,2016,과천선,범계,854483,112171,966654
201610,2016,과천선,선바위,260641,34197,294838
201610,2016,과천선,경마공원,196098,69834,265932
201610,2016,과천선,대공원,217765,58592,276357
201610,2016,과천선,정부과천청사,321947,67123,389070
201610,2016,과천선,인덕원,723779,107153,830932
201610,2016,과천선,평촌,444243,64125,508368
201610,2016,과천선,과천,142803,37069,179872
201610,2016,분당선,도곡,162589,39213,201802
201610,2016,분당선,매교,68798,17599,86397
201610,2016,분당선,개포동,91786,23198,114984
201610,2016,분당선,대모산입구,82908,29933,112841
201610,2016,분당선,수서,203843,47325,251168
201610,2016,분당선,복정,5,1,6
201610,2016,분당선,선릉,220241,25328,245569
201610,2016,분당선,한티,359310,69175,428485
201610,2016,분당선,수원,295239,27517,322756
201610,2016,분당선,서울숲,196461,25619,222080
201610,2016,분당선,압구정로데오,395444,38725,434169
201610,2016,분당선,강남구청,218880,39580,258460
201610,2016,분당선,선정릉,197046,37867,234913
201610,2016,분당선,가천대,319196,24327,343523
201610,2016,분당선,태평,373321,89108,462429
201610,2016,분당선,모란,575987,160839,736826
201610,2016,분당선,야탑,723381,161660,885041
201610,2016,분당선,서현,674543,131199,805742
201610,2016,분당선,수내,337951,80564,418515
201610,2016,분당선,정자,424418,83934,508352
201610,2016,분당선,미금,475619,123208,598827
201610,2016,분당선,오리,359333,94306,453639
201610,2016,분당선,이매,153181,43425,196606
201610,2016,분당선,보정,61358,25857,87215
201610,2016,분당선,죽전,450609,87537,538146
201610,2016,분당선,구성,120548,40534,161082
201610,2016,분당선,신갈,110674,31058,141732
201610,2016,분당선,기흥,225872,31428,257300
201610,2016,분당선,상갈,136096,31173,167269
201610,2016,분당선,청명,113839,16777,130616
201610,2016,분당선,영통,254553,27246,281799
201610,2016,분당선,망포,349442,29490,378932
201610,2016,분당선,매탄권선,120799,14603,135402
201610,2016,분당선,수원시청,292358,34610,326968
201610,2016,분당선,구룡,48536,18686,67222
201610,2016,수인선,달월,1993,1142,3135
201610,2016,수인선,월곶,75197,14503,89700
201610,2016,수인선,소래포구,152290,91190,243480
201610,2016,수인선,인천논현,166463,31262,197725
201610,2016,수인선,호구포,97028,16855,113883
201610,2016,수인선,남동인더스파크,58846,4870,63716
201610,2016,수인선,인천,25345,10247,35592
201610,2016,수인선,연수,137658,26586,164244
201610,2016,수인선,송도,80019,21826,101845
201610,2016,수인선,인하대,158303,21095,179398
201610,2016,수인선,숭의,69201,23446,92647
201610,2016,수인선,신포,46706,11790,58496
201610,2016,수인선,원인재,135085,28483,163568
201610,2016,안산선,산본,479587,105502,585089
201610,2016,안산선,대야미,107585,25236,132821
201610,2016,안산선,반월,136246,30809,167055
201610,2016,안산선,상록수,599646,89646,689292
201610,2016,안산선,한대앞,276510,43065,319575
201610,2016,안산선,중앙,506272,60551,566823
201610,2016,안산선,수리산,114262,33291,147553
201610,2016,안산선,초지,131178,16295,147473
201610,2016,안산선,안산,513816,46574,560390
201610,2016,안산선,신길온천,48592,10103,58695
201610,2016,안산선,정왕,286482,25093,311575
201610,2016,안산선,오이도,250635,37560,288195
201610,2016,안산선,고잔,264025,39020,303045
201610,2016,일산선,삼송,348381,83114,431495
201610,2016,일산선,주엽,200420,99886,300306
201610,2016,일산선,정발산,228539,67934,296473
201610,2016,일산선,마두,184207,79783,263990
201610,2016,일산선,백석,284722,80653,365375
201610,2016,일산선,대곡,39602,12324,51926
201610,2016,일산선,원흥,162357,39140,201497
201610,2016,일산선,대화,392813,95533,488346
201610,2016,일산선,원당,302443,91325,393768
201610,2016,일산선,화정,492146,137462,629608
201610,2016,장항선,신창(순천향대),72657,9214,81871
201610,2016,장항선,온양온천,105411,64382,169793
201610,2016,장항선,배방,26768,8115,34883
201610,2016,장항선,아산,90420,9805,100225
201610,2016,장항선,쌍용(나사렛대),78219,16895,95114
201610,2016,장항선,봉명,28637,13953,42590
201610,2016,중앙선,중랑,137859,53394,191253
201610,2016,중앙선,회기,839194,137085,976279
201610,2016,중앙선,망우,201158,71389,272547
201610,2016,중앙선,양원,44618,17615,62233
201610,2016,중앙선,구리,354998,88090,443088
201610,2016,중앙선,도농,236192,59907,296099
201610,2016,중앙선,양정,19810,9667,29477
201610,2016,중앙선,덕소,157841,52235,210076
201610,2016,중앙선,도심,64963,22262,87225
201610,2016,중앙선,팔당,28093,7657,35750
201610,2016,중앙선,운길산,36136,12744,48880
201610,2016,중앙선,양수,52435,20896,73331
201610,2016,중앙선,신원,5728,3914,9642
201610,2016,중앙선,국수,20509,9617,30126
201610,2016,중앙선,아신,24945,7322,32267
201610,2016,중앙선,오빈,7412,4324,11736
201610,2016,중앙선,양평,99532,39095,138627
201609,2016,수인선,숭의,63999,21631,85630
201609,2016,수인선,신포,41958,10857,52815
201609,2016,수인선,원인재,124534,26324,150858
201609,2016,안산선,산본,441703,96029,537732
201609,2016,안산선,대야미,99204,23472,122676
201609,2016,안산선,반월,127982,28205,156187
201609,2016,안산선,상록수,565844,81608,647452
201609,2016,안산선,한대앞,258219,38911,297130
201609,2016,안산선,중앙,463868,54942,518810
201609,2016,안산선,수리산,106798,31421,138219
201609,2016,안산선,초지,123098,15338,138436
201609,2016,안산선,안산,500313,43303,543616
201609,2016,안산선,신길온천,44976,9366,54342
201609,2016,안산선,정왕,275662,23157,298819
201609,2016,안산선,오이도,228302,31797,260099
201609,2016,안산선,고잔,235772,34236,270008
201609,2016,일산선,삼송,319950,76792,396742
201609,2016,일산선,주엽,184344,92702,277046
201609,2016,일산선,정발산,202924,58983,261907
201609,2016,일산선,마두,165257,73470,238727
201609,2016,일산선,백석,260458,74002,334460
201609,2016,일산선,대곡,35278,11415,46693
201609,2016,일산선,원흥,147929,36078,184007
201609,2016,일산선,대화,345595,88585,434180
201609,2016,일산선,원당,281645,83013,364658
201609,2016,일산선,화정,448828,126037,574865
201609,2016,장항선,신창,76984,8433,85417
201609,2016,장항선,온양온천,96059,55882,151941
201609,2016,장항선,배방,24427,7113,31540
201609,2016,장항선,아산,76476,8054,84530
201609,2016,장항선,쌍용동,74275,15224,89499
201609,2016,장항선,봉명,28499,13343,41842
201609,2016,중앙선,회기,788766,124390,913156
201609,2016,중앙선,용문,55800,48841,104641
201609,2016,중앙선,상봉,137456,36848,174304
201609,2016,중앙선,망우,189225,66238,255463
201609,2016,중앙선,양원,43045,16752,59797
201609,2016,중앙선,구리,334529,82832,417361
201609,2016,중앙선,도농,219102,55291,274393
201609,2016,중앙선,양정,18541,8711,27252
201609,2016,중앙선,덕소,148555,50210,198765
201609,2016,중앙선,도심,60886,20611,81497
201609,2016,중앙선,팔당,25575,7645,33220
201609,2016,중앙선,운길산,30085,11506,41591
201609,2016,중앙선,양수,49080,20089,69169
201609,2016,중앙선,신원,5879,4267,10146
201609,2016,중앙선,국수,20085,9224,29309
201609,2016,중앙선,아신,22904,7088,29992
201609,2016,중앙선,오빈,6777,3902,10679
201609,2016,중앙선,양평,88819,35783,124602
201609,2016,중앙선,원덕,8260,5933,14193
201609,2016,중앙선,중랑,131555,50522,182077
201609,2016,1호선,서울역,1611633,210972,1822605
201609,2016,1호선,시청,622884,99092,721976
201609,2016,1호선,종각,1132850,141884,1274734
201609,2016,1호선,종로3가,663131,344064,1007195
201609,2016,1호선,동묘앞,164099,138036,302135
201609,2016,1호선,동대문,347492,127161,474653
201609,2016,1호선,신설동,356617,115439,472056
201609,2016,1호선,제기동,272728,319290,592018
201609,2016,1호선,청량리(지하),535725,346268,881993
201609,2016,1호선,종로5가,506941,246578,753519
201609,2016,2호선,시청,629480,56094,685574
201609,2016,2호선,용두,44339,22600,66939
201609,2016,2호선,을지로3가,479597,84640,564237
201609,2016,2호선,을지로4가,272330,90241,362571
201609,2016,2호선,동대문역사문화공원,489474,53153,542627
201609,2016,2호선,신당,334327,104087,438414
201609,2016,2호선,상왕십리,252201,55155,307356
201609,2016,2호선,왕십리(성동구청),538418,57457,595875
201609,2016,2호선,한양대,354190,14428,368618
201609,2016,2호선,뚝섬,400669,61737,462406
201609,2016,2호선,성수,615403,92249,707652
201609,2016,2호선,건대입구,1225337,89918,1315255
201609,2016,2호선,구의,592709,102023,694732
201609,2016,2호선,강변,1331667,140790,1472457
201609,2016,2호선,잠실나루,429507,83249,512756
201609,2016,2호선,잠실,2334535,196525,2531060
201609,2016,2호선,신천,650287,109442,759729
201609,2016,2호선,종합운동장,475185,58517,533702
201609,2016,2호선,삼성,1368684,112025,1480709
201609,2016,2호선,선릉,1313259,179863,1493122
201609,2016,2호선,역삼,1087104,139616,1226720
201609,2016,2호선,강남,2563708,148230,2711938
201609,2016,2호선,교대,919298,151632,1070930
201609,2016,2호선,서초,563775,76542,640317
201609,2016,2호선,방배,546306,76214,622520
201609,2016,2호선,사당,1019242,181787,1201029
201609,2016,2호선,낙성대,785601,104397,889998
201609,2016,2호선,서울대입구,1331261,196708,1527969
201609,2016,2호선,봉천,536247,139303,675550
201609,2016,2호선,신림,1832289,227300,2059589
201609,2016,2호선,신대방,703968,124036,828004
201609,2016,2호선,구로디지털단지,1641680,154345,1796025
201609,2016,2호선,대림,815680,111145,926825
201609,2016,2호선,신도림,1603961,190616,1794577
201609,2016,2호선,문래,456242,78869,535111
201609,2016,2호선,영등포구청,509934,97266,607200
201609,2016,2호선,당산,554591,61883,616474
201609,2016,2호선,합정,875092,71695,946787
201609,2016,2호선,홍대입구,2056949,112897,2169846
201609,2016,2호선,신촌,1332698,132627,1465325
201609,2016,2호선,이대,569608,69018,638626
201609,2016,2호선,아현,236554,60492,297046
201609,2016,2호선,충정로,278943,51143,330086
201609,2016,2호선,용답,59078,16240,75318
201609,2016,2호선,신답,29121,10574,39695
201609,2016,2호선,신설동,80648,31227,111875
201609,2016,2호선,도림천,23274,5466,28740
201609,2016,2호선,양천구청,161840,43665,205505
201609,2016,2호선,신정네거리,246735,63477,310212
201609,2016,2호선,을지로입구,1341893,107529,1449422
201609,2016,3호선,지축,28829,11832,40661
201609,2016,3호선,오금,171395,24970,196365
201609,2016,3호선,연신내,990214,247885,1238099
201609,2016,3호선,불광,436732,144021,580753
201609,2016,3호선,녹번,320737,67688,388425
201609,2016,3호선,홍제,448345,145230,593575
201609,2016,3호선,무악재,90499,31569,122068
201609,2016,3호선,독립문,154938,68582,223520
201609,2016,3호선,경복궁,643649,88241,731890
201609,2016,3호선,안국,643355,108113,751468
201609,2016,3호선,종로3가,174915,61819,236734
201609,2016,3호선,을지로3가,193279,54258,247537
201609,2016,3호선,충무로,36,0,36
201609,2016,3호선,동대입구,309943,38814,348757
201609,2016,3호선,약수,333452,82455,415907
201609,2016,3호선,금호,177836,49555,227391
201609,2016,3호선,옥수,239270,56327,295597
201609,2016,3호선,압구정,834373,140288,974661
201609,2016,3호선,신사,802422,66686,869108
201609,2016,3호선,잠원,138587,32423,171010
201609,2016,3호선,고속터미널,1471044,166567,1637611
201609,2016,3호선,교대,340498,61533,402031
201609,2016,3호선,남부터미널,898519,122594,1021113
201609,2016,3호선,양재,996895,145348,1142243
201609,2016,3호선,매봉,274606,51936,326542
201609,2016,3호선,도곡,169372,26856,196228
201609,2016,3호선,대치,304067,61726,365793
201609,2016,3호선,학여울,65653,14142,79795
201609,2016,3호선,대청,248889,47960,296849
201609,2016,3호선,일원,211234,58300,269534
201609,2016,3호선,수서,261988,79945,341933
201609,2016,3호선,가락시장,205007,65430,270437
201609,2016,3호선,경찰병원,179086,35878,214964
201609,2016,3호선,구파발,433230,84958,518188
201609,2016,4호선,당고개,315489,90543,406032
201609,2016,4호선,남태령,52532,8733,61265
201609,2016,4호선,노원,594665,86552,681217
201609,2016,4호선,창동,712106,179370,891476
201609,2016,4호선,쌍문,829673,158180,987853
201609,2016,4호선,수유(강북구청),1118845,238961,1357806
201609,2016,4호선,미아,446063,126711,572774
201609,2016,4호선,미아사거리,789983,177548,967531
201609,2016,4호선,길음,696990,141343,838333
201609,2016,4호선,성신여대입구,706531,99595,806126
201609,2016,4호선,한성대입구,432410,75200,507610
201609,2016,4호선,혜화,1067482,125674,1193156
201609,2016,4호선,동대문,601768,138931,740699
201609,2016,4호선,동대문역사문화공원,624847,59684,684531
201609,2016,4호선,충무로,838551,123913,962464
201609,2016,4호선,명동,1128302,68198,1196500
201609,2016,4호선,회현,671586,179316,850902
201609,2016,4호선,서울역,314619,36990,351609
201609,2016,4호선,숙대입구,462389,56934,519323
201609,2016,4호선,삼각지,110910,29072,139982
201609,2016,4호선,신용산,327667,49527,377194
201609,2016,4호선,이촌,219199,43522,262721
201609,2016,4호선,동작,61401,20110,81511
201609,2016,4호선,총신대입구,510999,133794,644793
201609,2016,4호선,사당,803566,87515,891081
201609,2016,4호선,상계,539600,112455,652055
201609,2016,5호선,방화,174211,44267,218478
201609,2016,5호선,마천,108729,46012,154741
201609,2016,5호선,김포공항,194237,26119,220356
201609,2016,5호선,송정,225153,60656,285809
201609,2016,5호선,마곡,105592,16559,122151
201609,2016,5호선,발산,296762,53093,349855
201609,2016,5호선,우장산,387833,73246,461079
201609,2016,5호선,화곡,712432,129099,841531
201609,2016,5호선,까치산,724164,141890,866054
201609,2016,5호선,신정,364611,54711,419322
201609,2016,5호선,목동,458862,78001,536863
201609,2016,5호선,오목교,645406,76999,722405
201609,2016,5호선,양평,147937,26295,174232
201609,2016,5호선,영등포구청,77039,18893,95932
201609,2016,5호선,영등포시장,162506,67883,230389
201609,2016,5호선,신길,78752,11284,90036
201609,2016,5호선,여의도,578049,49632,627681
201609,2016,5호선,여의나루,382105,30130,412235
201609,2016,5호선,마포,344501,60121,404622
201609,2016,5호선,공덕,314696,42144,356840
201609,2016,5호선,애오개,158597,38010,196607
201609,2016,5호선,충정로,113874,15857,129731
201609,2016,5호선,서대문,423919,64635,488554
201609,2016,5호선,광화문,936989,81148,1018137
201609,2016,5호선,종로3가,272584,114260,386844
201609,2016,5호선,을지로4가,101712,39365,141077
201609,2016,5호선,동대문역사문화공원,70426,9951,80377
201609,2016,5호선,청구,95413,25056,120469
201609,2016,5호선,신금호,135879,34477,170356
201609,2016,5호선,행당,198233,45684,243917
201609,2016,5호선,왕십리(성동구청),120522,24062,144584
201609,2016,5호선,마장,145026,43063,188089
201609,2016,5호선,답십리,385183,78023,463206
201609,2016,5호선,장한평,431145,90998,522143
201609,2016,5호선,군자,276494,34333,310827
201609,2016,5호선,아차산,351910,84818,436728
201609,2016,5호선,광나루,362137,62645,424782
201609,2016,5호선,천호,459431,136157,595588
201609,2016,5호선,강동,471423,87193,558616
201609,2016,5호선,길동,162080,53697,215777
201609,2016,5호선,굽은다리,223695,59966,283661
201609,2016,5호선,명일,179725,57966,237691
201609,2016,5호선,고덕,191102,55643,246745
201609,2016,5호선,상일동,257180,57988,315168
201609,2016,5호선,둔촌동,302908,72683,375591
201609,2016,5호선,올림픽공원,196525,33578,230103
201609,2016,5호선,방이,168310,37802,206112
201609,2016,5호선,오금,90931,16843,107774
201609,2016,5호선,개롱,159685,40017,199702
201609,2016,5호선,거여,154931,45729,200660
201609,2016,5호선,개화산,140122,32574,172696
201609,2016,6호선,응암,415715,102837,518552
201609,2016,6호선,봉화산(서울의료원),221091,48752,269843
201609,2016,6호선,불광,127061,37522,164583
201609,2016,6호선,독바위,66577,20036,86613
201609,2016,6호선,연신내,24,1,25
201609,2016,6호선,구산,189136,52863,241999
201609,2016,6호선,새절,334015,82699,416714
201609,2016,6호선,증산,240114,64804,304918
201609,2016,6호선,디지털미디어시티,366016,57832,423848
201609,2016,6호선,월드컵경기장,213304,61196,274500
201609,2016,6호선,마포구청,321216,76035,397251
201609,2016,6호선,망원,291018,79908,370926
201609,2016,6호선,합정,355922,36503,392425
201609,2016,6호선,상수,293572,21829,315401
201609,2016,6호선,광흥창,215487,57367,272854
201609,2016,6호선,대흥,204269,42480,246749
201609,2016,6호선,공덕,432862,67231,500093
201609,2016,6호선,효창공원앞,171835,39802,211637
201609,2016,6호선,삼각지,197299,18893,216192
201609,2016,6호선,녹사평(용산구청),195409,20566,215975
201609,2016,6호선,이태원,446213,34963,481176
201609,2016,6호선,한강진,166688,12856,179544
201609,2016,6호선,버티고개,59321,13455,72776
201609,2016,6호선,약수,82830,21857,104687
201609,2016,6호선,청구,92981,17681,110662
201609,2016,6호선,신당,201391,33672,235063
201609,2016,6호선,동묘앞,200839,62091,262930
201609,2016,6호선,창신,82928,16371,99299
201609,2016,6호선,보문,214717,36086,250803
201609,2016,6호선,안암,409201,29947,439148
201609,2016,6호선,고려대,272665,34144,306809
201609,2016,6호선,월곡,323972,66004,389976
201609,2016,6호선,상월곡,153456,36135,189591
201609,2016,6호선,돌곶이,225003,57598,282601
201609,2016,6호선,석계,324722,69493,394215
201609,2016,6호선,태릉입구,129322,25007,154329
201609,2016,6호선,화랑대,352746,42553,395299
201609,2016,6호선,역촌,79354,33237,112591
201609,2016,7호선,장암,68315,9200,77515
201609,2016,7호선,도봉산,246203,43281,289484
201609,2016,7호선,수락산,335275,84581,419856
201609,2016,7호선,마들,288530,70236,358766
201609,2016,7호선,노원,501732,102092,603824
201609,2016,7호선,중계,389348,89045,478393
201609,2016,7호선,하계,495123,98013,593136
201609,2016,7호선,공릉,323682,62772,386454
201609,2016,7호선,태릉입구,236779,35870,272649
201609,2016,7호선,먹골,252275,52212,304487
201609,2016,7호선,중화,282322,55783,338105
201609,2016,7호선,상봉,438847,67751,506598
201609,2016,7호선,면목,401407,76222,477629
201609,2016,7호선,사가정,377801,85488,463289
201609,2016,7호선,용마산,152243,33872,186115
201609,2016,7호선,중곡,244544,56591,301135
201609,2016,7호선,군자,351185,72431,423616
201609,2016,7호선,어린이대공원,469734,44522,514256
201609,2016,7호선,건대입구,431106,46814,477920
201609,2016,7호선,뚝섬유원지,274099,42915,317014
201609,2016,7호선,청담,518434,67263,585697
201609,2016,7호선,강남구청,373907,43978,417885
201609,2016,7호선,학동,536977,56669,593646
201609,2016,7호선,논현,497778,46195,543973
201609,2016,7호선,반포,162431,29267,191698
201609,2016,7호선,고속터미널,577974,76961,654935
201609,2016,7호선,내방,342367,58822,401189
201609,2016,7호선,이수,412356,72055,484411
201609,2016,7호선,남성,272069,64712,336781
201609,2016,7호선,숭실대입구,433073,56229,489302
201609,2016,7호선,상도,281796,58381,340177
201609,2016,7호선,장승배기,243422,70826,314248
201609,2016,7호선,신대방삼거리,380087,86957,467044
201609,2016,7호선,보라매,232353,40641,272994
201609,2016,7호선,신풍,271888,61442,333330
201609,2016,7호선,대림,306124,33538,339662
201609,2016,7호선,남구로,416225,55158,471383
201609,2016,7호선,가산디지털단지,1037183,67273,1104456
201609,2016,7호선,철산,609242,91816,701058
201609,2016,7호선,광명사거리,665438,140973,806411
201609,2016,7호선,천왕,198338,41835,240173
201609,2016,7호선,온수,290484,31604,322088
201609,2016,7호선,까치울,168180,22976,191156
201609,2016,7호선,부천종합운동장,139580,16490,156070
201609,2016,7호선,춘의,214866,24698,239564
201609,2016,7호선,신중동,366414,43568,409982
201609,2016,7호선,부천시청,317135,41414,358549
201609,2016,7호선,상동,355117,40394,395511
201609,2016,7호선,삼산체육관,137432,22032,159464
201609,2016,7호선,굴포천,224447,30478,254925
201609,2016,7호선,부평구청,319791,28202,347993
201609,2016,8호선,암사,424312,83186,507498
201609,2016,8호선,모란,88405,48817,137222
201609,2016,8호선,강동구청,233584,56765,290349
201609,2016,8호선,몽촌토성,153746,37866,191612
201609,2016,8호선,잠실,312150,54719,366869
201609,2016,8호선,석촌,198303,54833,253136
201609,2016,8호선,송파,121470,31507,152977
201609,2016,8호선,가락시장,151317,49386,200703
201609,2016,8호선,문정,199193,30632,229825
201609,2016,8호선,장지,354243,52755,406998
201609,2016,8호선,복정,257823,37780,295603
201609,2016,8호선,산성,178786,38772,217558
201609,2016,8호선,남한산성입구,366786,70013,436799
201609,2016,8호선,단대오거리,303496,64235,367731
201609,2016,8호선,신흥,104790,44266,149056
201609,2016,8호선,수진,111432,37666,149098
201609,2016,8호선,천호,449854,84572,534426
201609,2016,9호선,개화,160638,32920,193558
201609,2016,9호선,김포공항,248663,17757,266420
201609,2016,9호선,신논현,773020,45736,818756
201609,2016,9호선,사평,65965,13702,79667
201609,2016,9호선,고속터미널,449716,49912,499628
201609,2016,9호선,신반포,76472,21197,97669
201609,2016,9호선,공항시장,65954,20354,86308
201609,2016,9호선,신방화,194839,40095,234934
201609,2016,9호선,마곡나루,69737,8868,78605
201609,2016,9호선,양천향교,177594,36338,213932
201609,2016,9호선,가양,491133,111216,602349
201609,2016,9호선,증미,163536,39716,203252
201609,2016,9호선,등촌,223114,73443,296557
201609,2016,9호선,염창,397678,54552,452230
201609,2016,9호선,신목동,101078,16411,117489
201609,2016,9호선,선유도,166732,24045,190777
201609,2016,9호선,당산,443144,55895,499039
201609,2016,9호선,국회의사당,370224,48321,418545
201609,2016,9호선,여의도,493450,38570,532020
201609,2016,9호선,샛강,115993,22972,138965
201609,2016,9호선,노량진,730549,79040,809589
201609,2016,9호선,노들,112206,28270,140476
201609,2016,9호선,흑석(중앙대입구),273092,50745,323837
201609,2016,9호선,동작,49699,13744,63443
201609,2016,9호선,구반포,70392,21996,92388
201609,2016,9호선2단계,언주,184562,20483,205045
201609,2016,9호선2단계,봉은사,296189,32037,328226
201609,2016,9호선2단계,삼성중앙,111236,16962,128198
201609,2016,9호선2단계,선정릉,166778,17292,184070
201609,2016,9호선2단계,종합운동장,153027,12491,165518
201609,2016,경강선,판교,13801,3359,17160
201609,2016,경강선,이매,8986,4283,13269
201609,2016,경강선,삼동,5779,1634,7413
201609,2016,경강선,경기광주,19622,4205,23827
201609,2016,경강선,초월,10308,2481,12789
201609,2016,경강선,여주,13935,10819,24754
201609,2016,경강선,신둔도예촌,5477,1305,6782
201609,2016,경강선,이천,10181,3310,13491
201609,2016,경강선,부발,7215,1709,8924
201609,2016,경강선,세종대왕릉,1587,1648,3235
201609,2016,경강선,곤지암,10233,3428,13661
201609,2016,경부선,구로,537593,86175,623768
201609,2016,경부선,신길,267878,44774,312652
201609,2016,경부선,금천구청,268443,71930,340373
201609,2016,경부선,석수,306081,45186,351267
201609,2016,경부선,관악,212004,52038,264042
201609,2016,경부선,안양,763796,109662,873458
201609,2016,경부선,명학,265093,39188,304281
201609,2016,경부선,금정,737539,100414,837953
201609,2016,경부선,군포,186822,33019,219841
201609,2016,경부선,의왕,219489,37000,256489
201609,2016,경부선,성균관대,444960,48332,493292
201609,2016,경부선,화서,216633,40874,257507
201609,2016,경부선,수원,1269655,139373,1409028
201609,2016,경부선,독산,404123,62942,467065
201609,2016,경부선,세류,109916,17456,127372
201609,2016,경부선,병점,434392,53584,487976
201609,2016,경부선,세마,67124,12500,79624
201609,2016,경부선,오산대,82198,12092,94290
201609,2016,경부선,오산,282443,40157,322600
201609,2016,경부선,진위,44789,7593,52382
201609,2016,경부선,송탄,131862,24336,156198
201609,2016,경부선,서정리,145619,25159,170778
201609,2016,경부선,지제,27235,4150,31385
201609,2016,경부선,평택,393830,67300,461130
201609,2016,경부선,성환,151353,20301,171654
201609,2016,경부선,직산,26174,5666,31840
201609,2016,경부선,두정,181783,21138,202921
201609,2016,경부선,천안,244040,61942,305982
201609,2016,경부선,당정,200292,28829,229121
201609,2016,경부선,서동탄,40187,8333,48520
201609,2016,경부선,광명,23587,1333,24920
201609,2016,경부선,서울역,19,0,19
201609,2016,경부선,남영,310636,39125,349761
201609,2016,경부선,용산,1030187,135258,1165445
201609,2016,경부선,노량진,476469,54167,530636
201609,2016,경부선,대방,388231,70745,458976
201609,2016,경부선,영등포,1222224,256474,1478698
201609,2016,경부선,신도림,100201,20943,121144
201609,2016,경부선,가산디지털단지,428653,28721,457374
201609,2016,경원선,방학,207962,99761,307723
201609,2016,경원선,창동,6,0,6
201609,2016,경원선,도봉산,154067,82571,236638
201609,2016,경원선,망월사,208934,65498,274432
201609,2016,경원선,회룡,267670,133252,400922
201609,2016,경원선,의정부,564153,119681,683834
201609,2016,경원선,가능,170091,61715,231806
201609,2016,경원선,녹양,121810,32986,154796
201609,2016,경원선,양주,233550,56265,289815
201609,2016,경원선,덕계,50528,16333,66861
201609,2016,경원선,덕정,189866,35065,224931
201609,2016,경원선,지행,184498,44138,228636
201609,2016,경원선,동두천 중앙,83784,38464,122248
201609,2016,경원선,보산,47252,14707,61959
201609,2016,경원선,동두천,51203,18964,70167
201609,2016,경원선,소요산,67017,83265,150282
201609,2016,경원선,이촌,111158,29204,140362
201609,2016,경원선,서빙고,51884,16112,67996
201609,2016,경원선,한남,100209,29819,130028
201609,2016,경원선,옥수,1892,129,2021
201609,2016,경원선,응봉,43189,18232,61421
201609,2016,경원선,왕십리,452932,58980,511912
201609,2016,경원선,청량리(지상),325233,137354,462587
201609,2016,경원선,외대앞,332626,55068,387694
201609,2016,경원선,신이문,228239,63729,291968
201609,2016,경원선,석계,278445,64162,342607
201609,2016,경원선,광운대,268529,53054,321583
201609,2016,경원선,월계,139606,50586,190192
201609,2016,경원선,녹천,119976,38864,158840
201609,2016,경원선,도봉,131605,67510,199115
201609,2016,경의선,서울역,70599,9968,80567
201609,2016,경의선,검암,1,0,1
201609,2016,경의선,효창공원앞,46691,10430,57121
201609,2016,경의선,공덕,52915,9245,62160
201609,2016,경의선,서강대,61282,8746,70028
201609,2016,경의선,홍대입구,42466,4548,47014
201609,2016,경의선,가좌,92636,41525,134161
201609,2016,경의선,디지털미디어시티,61109,9958,71067
201609,2016,경의선,수색,49819,17235,67054
201609,2016,경의선,화전,79152,8030,87182
201609,2016,경의선,강매,59595,14841,74436
201609,2016,경의선,행신,193803,33037,226840
201609,2016,경의선,능곡,85317,29112,114429
201609,2016,경의선,곡산,12294,4984,17278
201609,2016,경의선,백마,169002,30632,199634
201609,2016,경의선,풍산,112201,27405,139606
201609,2016,경의선,일산,230522,55289,285811
201609,2016,경의선,탄현,194837,36389,231226
201609,2016,경의선,야당,76181,18831,95012
201609,2016,경의선,운정,117807,27853,145660
201609,2016,경의선,금릉,122837,24318,147155
201609,2016,경의선,금촌,181438,43078,224516
201609,2016,경의선,월롱,64863,8323,73186
201609,2016,경의선,파주,46350,8263,54613
201609,2016,경의선,문산,148928,47612,196540
201609,2016,경의선,신촌,22847,3498,26345
201609,2016,경인선,인천,118878,46725,165603
201609,2016,경인선,구일,202091,33626,235717
201609,2016,경인선,소사,316743,83575,400318
201609,2016,경인선,부개,256546,62418,318964
201609,2016,경인선,간석,161481,44046,205527
201609,2016,경인선,도원,99100,34143,133243
201609,2016,경인선,온수,186409,44613,231022
201609,2016,경인선,중동,240758,62992,303750
201609,2016,경인선,도화,84164,34436,118600
201609,2016,경인선,개봉,565016,147596,712612
201609,2016,경인선,오류동,273661,80091,353752
201609,2016,경인선,역곡,788656,131735,920391
201609,2016,경인선,부천,1061952,200248,1262200
201609,2016,경인선,송내,869245,109917,979162
201609,2016,경인선,부평,1023456,134152,1157608
201609,2016,경인선,백운,221726,62482,284208
201609,2016,경인선,동암,544998,112189,657187
201609,2016,경인선,주안,719825,105449,825274
201609,2016,경인선,제물포,271300,51232,322532
201609,2016,경인선,동인천,448219,120049,568268
201609,2016,경춘선,평내호평,134183,39089,173272
201609,2016,경춘선,상천,10500,6797,17297
201609,2016,경춘선,사릉,92613,18216,110829
201609,2016,경춘선,퇴계원,81277,22872,104149
201609,2016,경춘선,별내,56834,15181,72015
201609,2016,경춘선,갈매,26161,10113,36274
201609,2016,경춘선,신내,15697,6499,22196
201609,2016,경춘선,천마산,27371,13452,40823
201609,2016,경춘선,마석,84468,30716,115184
201609,2016,경춘선,대성리,22425,5858,28283
201609,2016,경춘선,청평,54517,16796,71313
201609,2016,경춘선,강촌,24442,4864,29306
201609,2016,경춘선,김유정,13428,3905,17333
201609,2016,경춘선,남춘천,79502,22615,102117
201609,2016,경춘선,춘천,62560,19498,82058
201609,2016,경춘선,백양리,3782,1223,5005
201609,2016,경춘선,굴봉산,5901,2358,8259
201609,2016,경춘선,가평,64463,15541,80004
201609,2016,경춘선,금곡,31977,14671,46648
201609,2016,공항철도 1호선,영종,34570,9804,44374
201609,2016,공항철도 1호선,인천국제공항,390933,42413,433346
201609,2016,공항철도 1호선,공항화물청사,66219,7207,73426
201609,2016,공항철도 1호선,운서,134448,23545,157993
201609,2016,공항철도 1호선,청라국제도시,130040,8510,138550
201609,2016,공항철도 1호선,검암,270248,26305,296553
201609,2016,공항철도 1호선,계양,288060,28752,316812
201609,2016,공항철도 1호선,김포공항,287874,17298,305172
201609,2016,공항철도 1호선,디지털미디어시티,307768,19524,327292
201609,2016,공항철도 1호선,홍대입구,246667,16389,263056
201609,2016,공항철도 1호선,서울역,276471,29067,305538
201609,2016,공항철도 1호선,공덕,38291,5772,44063
201609,2016,과천선,평촌,405522,58443,463965
201609,2016,과천선,인덕원,654770,96023,750793
201609,2016,과천선,정부과천청사,297062,61357,358419
201609,2016,과천선,과천,129050,34288,163338
201609,2016,과천선,대공원,147389,50560,197949
201609,2016,과천선,경마공원,151424,56713,208137
201609,2016,과천선,선바위,232914,31800,264714
201609,2016,과천선,범계,781092,99966,881058
201609,2016,분당선,선릉,205814,23432,229246
201609,2016,분당선,매교,65154,16464,81618
201609,2016,분당선,도곡,148208,35838,184046
201609,2016,분당선,구룡,44986,17124,62110
201609,2016,분당선,개포동,84684,20714,105398
201609,2016,분당선,대모산입구,77163,28008,105171
201609,2016,분당선,수서,193419,45172,238591
201609,2016,분당선,복정,1,0,1
201609,2016,분당선,수원,275992,25187,301179
201609,2016,분당선,서울숲,173904,22512,196416
201609,2016,분당선,압구정로데오,364042,35992,400034
201609,2016,분당선,강남구청,202110,34777,236887
201609,2016,분당선,선정릉,180586,35775,216361
201609,2016,분당선,가천대,285431,22489,307920
201609,2016,분당선,태평,347376,82569,429945
201609,2016,분당선,모란,568653,159837,728490
201609,2016,분당선,야탑,663886,145576,809462
201609,2016,분당선,서현,624088,119580,743668
201609,2016,분당선,수내,312356,73737,386093
201609,2016,분당선,정자,392666,75579,468245
201609,2016,분당선,미금,444774,115298,560072
201609,2016,분당선,오리,331557,89731,421288
201609,2016,분당선,이매,152145,41268,193413
201609,2016,분당선,보정,58251,24060,82311
201609,2016,분당선,죽전,420634,79626,500260
201609,2016,분당선,구성,111061,37136,148197
201609,2016,분당선,신갈,103952,28804,132756
201609,2016,분당선,기흥,211368,29041,240409
201609,2016,분당선,상갈,124734,28964,153698
201609,2016,분당선,청명,106570,15193,121763
201609,2016,분당선,영통,237528,25041,262569
201609,2016,분당선,망포,325840,27214,353054
201609,2016,분당선,매탄권선,115507,13316,128823
201609,2016,분당선,수원시청,267243,31034,298277
201609,2016,분당선,한티,347780,61612,409392
201609,2016,수인선,달월,2206,1245,3451
201609,2016,수인선,월곶,71171,13607,84778
201609,2016,수인선,소래포구,126283,62179,188462
201609,2016,수인선,인천논현,155202,28471,183673
201609,2016,수인선,호구포,88424,15912,104336
201609,2016,수인선,남동인더스파크,57211,4476,61687
201609,2016,수인선,인천,23846,9726,33572
201609,2016,수인선,연수,127530,24205,151735
201609,2016,수인선,송도,74414,20017,94431
201609,2016,수인선,인하대,150269,18556,168825
201609,2016,1호선,서울역,1611633,210972,1822605
201609,2016,1호선,시청,622884,99092,721976
201609,2016,1호선,종각,1132850,141884,1274734
201609,2016,1호선,종로3가,663131,344064,1007195
201609,2016,1호선,동묘앞,164099,138036,302135
201609,2016,1호선,동대문,347492,127161,474653
201609,2016,1호선,신설동,356617,115439,472056
201609,2016,1호선,제기동,272728,319290,592018
201609,2016,1호선,청량리(지하),535725,346268,881993
201609,2016,1호선,종로5가,506941,246578,753519
201609,2016,2호선,시청,629480,56094,685574
201609,2016,2호선,용두,44339,22600,66939
201609,2016,2호선,을지로3가,479597,84640,564237
201609,2016,2호선,을지로4가,272330,90241,362571
201609,2016,2호선,동대문역사문화공원,489474,53153,542627
201609,2016,2호선,신당,334327,104087,438414
201609,2016,2호선,상왕십리,252201,55155,307356
201609,2016,2호선,왕십리(성동구청),538418,57457,595875
201609,2016,2호선,한양대,354190,14428,368618
201609,2016,2호선,뚝섬,400669,61737,462406
201609,2016,2호선,성수,615403,92249,707652
201609,2016,2호선,건대입구,1225337,89918,1315255
201609,2016,2호선,구의,592709,102023,694732
201609,2016,2호선,강변,1331667,140790,1472457
201609,2016,2호선,잠실나루,429507,83249,512756
201609,2016,2호선,잠실,2334535,196525,2531060
201609,2016,2호선,신천,650287,109442,759729
201609,2016,2호선,종합운동장,475185,58517,533702
201609,2016,2호선,삼성,1368684,112025,1480709
201609,2016,2호선,선릉,1313259,179863,1493122
201609,2016,2호선,역삼,1087104,139616,1226720
201609,2016,2호선,강남,2563708,148230,2711938
201609,2016,2호선,교대,919298,151632,1070930
201609,2016,2호선,서초,563775,76542,640317
201609,2016,2호선,방배,546306,76214,622520
201609,2016,2호선,사당,1019242,181787,1201029
201609,2016,2호선,낙성대,785601,104397,889998
201609,2016,2호선,서울대입구,1331261,196708,1527969
201609,2016,2호선,봉천,536247,139303,675550
201609,2016,2호선,신림,1832289,227300,2059589
201609,2016,2호선,신대방,703968,124036,828004
201609,2016,2호선,구로디지털단지,1641680,154345,1796025
201609,2016,2호선,대림,815680,111145,926825
201609,2016,2호선,신도림,1603961,190616,1794577
201609,2016,2호선,문래,456242,78869,535111
201609,2016,2호선,영등포구청,509934,97266,607200
201609,2016,2호선,당산,554591,61883,616474
201609,2016,2호선,합정,875092,71695,946787
201609,2016,2호선,홍대입구,2056949,112897,2169846
201609,2016,2호선,신촌,1332698,132627,1465325
201609,2016,2호선,이대,569608,69018,638626
201609,2016,2호선,아현,236554,60492,297046
201609,2016,2호선,충정로,278943,51143,330086
201609,2016,2호선,용답,59078,16240,75318
201609,2016,2호선,신답,29121,10574,39695
201609,2016,2호선,신설동,80648,31227,111875
201609,2016,2호선,도림천,23274,5466,28740
201609,2016,2호선,양천구청,161840,43665,205505
201609,2016,2호선,신정네거리,246735,63477,310212
201609,2016,2호선,을지로입구,1341893,107529,1449422
201609,2016,3호선,지축,28829,11832,40661
201609,2016,3호선,오금,171395,24970,196365
201609,2016,3호선,연신내,990214,247885,1238099
201609,2016,3호선,불광,436732,144021,580753
201609,2016,3호선,녹번,320737,67688,388425
201609,2016,3호선,홍제,448345,145230,593575
201609,2016,3호선,무악재,90499,31569,122068
201609,2016,3호선,독립문,154938,68582,223520
201609,2016,3호선,경복궁,643649,88241,731890
201609,2016,3호선,안국,643355,108113,751468
201609,2016,3호선,종로3가,174915,61819,236734
201609,2016,3호선,을지로3가,193279,54258,247537
201609,2016,3호선,충무로,36,0,36
201609,2016,3호선,동대입구,309943,38814,348757
201609,2016,3호선,약수,333452,82455,415907
201609,2016,3호선,금호,177836,49555,227391
201609,2016,3호선,옥수,239270,56327,295597
201609,2016,3호선,압구정,834373,140288,974661
201609,2016,3호선,신사,802422,66686,869108
201609,2016,3호선,잠원,138587,32423,171010
201609,2016,3호선,고속터미널,1471044,166567,1637611
201609,2016,3호선,교대,340498,61533,402031
201609,2016,3호선,남부터미널,898519,122594,1021113
201609,2016,3호선,양재,996895,145348,1142243
201609,2016,3호선,매봉,274606,51936,326542
201609,2016,3호선,도곡,169372,26856,196228
201609,2016,3호선,대치,304067,61726,365793
201609,2016,3호선,학여울,65653,14142,79795
201609,2016,3호선,대청,248889,47960,296849
201609,2016,3호선,일원,211234,58300,269534
201609,2016,3호선,수서,261988,79945,341933
201609,2016,3호선,가락시장,205007,65430,270437
201609,2016,3호선,경찰병원,179086,35878,214964
201609,2016,3호선,구파발,433230,84958,518188
201609,2016,4호선,당고개,315489,90543,406032
201609,2016,4호선,남태령,52532,8733,61265
201609,2016,4호선,노원,594665,86552,681217
201609,2016,4호선,창동,712106,179370,891476
201609,2016,4호선,쌍문,829673,158180,987853
201609,2016,4호선,수유(강북구청),1118845,238961,1357806
201609,2016,4호선,미아,446063,126711,572774
201609,2016,4호선,미아사거리,789983,177548,967531
201609,2016,4호선,길음,696990,141343,838333
201609,2016,4호선,성신여대입구,706531,99595,806126
201609,2016,4호선,한성대입구,432410,75200,507610
201609,2016,4호선,혜화,1067482,125674,1193156
201609,2016,4호선,동대문,601768,138931,740699
201609,2016,4호선,동대문역사문화공원,624847,59684,684531
201609,2016,4호선,충무로,838551,123913,962464
201609,2016,4호선,명동,1128302,68198,1196500
201609,2016,4호선,회현,671586,179316,850902
201609,2016,4호선,서울역,314619,36990,351609
201609,2016,4호선,숙대입구,462389,56934,519323
201609,2016,4호선,삼각지,110910,29072,139982
201609,2016,4호선,신용산,327667,49527,377194
201609,2016,4호선,이촌,219199,43522,262721
201609,2016,4호선,동작,61401,20110,81511
201609,2016,4호선,총신대입구,510999,133794,644793
201609,2016,4호선,사당,803566,87515,891081
201609,2016,4호선,상계,539600,112455,652055
201609,2016,5호선,방화,174211,44267,218478
201609,2016,5호선,마천,108729,46012,154741
201609,2016,5호선,김포공항,194237,26119,220356
201609,2016,5호선,송정,225153,60656,285809
201609,2016,5호선,마곡,105592,16559,122151
201609,2016,5호선,발산,296762,53093,349855
201609,2016,5호선,우장산,387833,73246,461079
201609,2016,5호선,화곡,712432,129099,841531
201609,2016,5호선,까치산,724164,141890,866054
201609,2016,5호선,신정,364611,54711,419322
201609,2016,5호선,목동,458862,78001,536863
201609,2016,5호선,오목교,645406,76999,722405
201609,2016,5호선,양평,147937,26295,174232
201609,2016,5호선,영등포구청,77039,18893,95932
201609,2016,5호선,영등포시장,162506,67883,230389
201609,2016,5호선,신길,78752,11284,90036
201609,2016,5호선,여의도,578049,49632,627681
201609,2016,5호선,여의나루,382105,30130,412235
201609,2016,5호선,마포,344501,60121,404622
201609,2016,5호선,공덕,314696,42144,356840
201609,2016,5호선,애오개,158597,38010,196607
201609,2016,5호선,충정로,113874,15857,129731
201609,2016,5호선,서대문,423919,64635,488554
201609,2016,5호선,광화문,936989,81148,1018137
201609,2016,5호선,종로3가,272584,114260,386844
201609,2016,5호선,을지로4가,101712,39365,141077
201609,2016,5호선,동대문역사문화공원,70426,9951,80377
201609,2016,5호선,청구,95413,25056,120469
201609,2016,5호선,신금호,135879,34477,170356
201609,2016,5호선,행당,198233,45684,243917
201609,2016,5호선,왕십리(성동구청),120522,24062,144584
201609,2016,5호선,마장,145026,43063,188089
201609,2016,5호선,답십리,385183,78023,463206
201609,2016,5호선,장한평,431145,90998,522143
201609,2016,5호선,군자,276494,34333,310827
201609,2016,5호선,아차산,351910,84818,436728
201609,2016,5호선,광나루,362137,62645,424782
201609,2016,5호선,천호,459431,136157,595588
201609,2016,5호선,강동,471423,87193,558616
201609,2016,5호선,길동,162080,53697,215777
201609,2016,5호선,굽은다리,223695,59966,283661
201609,2016,5호선,명일,179725,57966,237691
201609,2016,5호선,고덕,191102,55643,246745
201609,2016,5호선,상일동,257180,57988,315168
201609,2016,5호선,둔촌동,302908,72683,375591
201609,2016,5호선,올림픽공원,196525,33578,230103
201609,2016,5호선,방이,168310,37802,206112
201609,2016,5호선,오금,90931,16843,107774
201609,2016,5호선,개롱,159685,40017,199702
201609,2016,5호선,거여,154931,45729,200660
201609,2016,5호선,개화산,140122,32574,172696
201609,2016,6호선,응암,415715,102837,518552
201609,2016,6호선,봉화산(서울의료원),221091,48752,269843
201609,2016,6호선,불광,127061,37522,164583
201609,2016,6호선,독바위,66577,20036,86613
201609,2016,6호선,연신내,24,1,25
201609,2016,6호선,구산,189136,52863,241999
201609,2016,6호선,새절,334015,82699,416714
201609,2016,6호선,증산,240114,64804,304918
201609,2016,6호선,디지털미디어시티,366016,57832,423848
201609,2016,6호선,월드컵경기장,213304,61196,274500
201609,2016,6호선,마포구청,321216,76035,397251
201609,2016,6호선,망원,291018,79908,370926
201609,2016,6호선,합정,355922,36503,392425
201609,2016,6호선,상수,293572,21829,315401
201609,2016,6호선,광흥창,215487,57367,272854
201609,2016,6호선,대흥,204269,42480,246749
201609,2016,6호선,공덕,432862,67231,500093
201609,2016,6호선,효창공원앞,171835,39802,211637
201609,2016,6호선,삼각지,197299,18893,216192
201609,2016,6호선,녹사평(용산구청),195409,20566,215975
201609,2016,6호선,이태원,446213,34963,481176
201609,2016,6호선,한강진,166688,12856,179544
201609,2016,6호선,버티고개,59321,13455,72776
201609,2016,6호선,약수,82830,21857,104687
201609,2016,6호선,청구,92981,17681,110662
201609,2016,6호선,신당,201391,33672,235063
201609,2016,6호선,동묘앞,200839,62091,262930
201609,2016,6호선,창신,82928,16371,99299
201609,2016,6호선,보문,214717,36086,250803
201609,2016,6호선,안암,409201,29947,439148
201609,2016,6호선,고려대,272665,34144,306809
201609,2016,6호선,월곡,323972,66004,389976
201609,2016,6호선,상월곡,153456,36135,189591
201609,2016,6호선,돌곶이,225003,57598,282601
201609,2016,6호선,석계,324722,69493,394215
201609,2016,6호선,태릉입구,129322,25007,154329
201609,2016,6호선,화랑대,352746,42553,395299
201609,2016,6호선,역촌,79354,33237,112591
201609,2016,7호선,장암,68315,9200,77515
201609,2016,7호선,도봉산,246203,43281,289484
201609,2016,7호선,수락산,335275,84581,419856
201609,2016,7호선,마들,288530,70236,358766
201609,2016,7호선,노원,501732,102092,603824
201609,2016,7호선,중계,389348,89045,478393
201609,2016,7호선,하계,495123,98013,593136
201609,2016,7호선,공릉,323682,62772,386454
201609,2016,7호선,태릉입구,236779,35870,272649
201609,2016,7호선,먹골,252275,52212,304487
201609,2016,7호선,중화,282322,55783,338105
201609,2016,7호선,상봉,438847,67751,506598
201609,2016,7호선,면목,401407,76222,477629
201609,2016,7호선,사가정,377801,85488,463289
201609,2016,7호선,용마산,152243,33872,186115
201609,2016,7호선,중곡,244544,56591,301135
201609,2016,7호선,군자,351185,72431,423616
201609,2016,7호선,어린이대공원,469734,44522,514256
201609,2016,7호선,건대입구,431106,46814,477920
201609,2016,7호선,뚝섬유원지,274099,42915,317014
201609,2016,7호선,청담,518434,67263,585697
201609,2016,7호선,강남구청,373907,43978,417885
201609,2016,7호선,학동,536977,56669,593646
201609,2016,7호선,논현,497778,46195,543973
201609,2016,7호선,반포,162431,29267,191698
201609,2016,7호선,고속터미널,577974,76961,654935
201609,2016,7호선,내방,342367,58822,401189
201609,2016,7호선,이수,412356,72055,484411
201609,2016,7호선,남성,272069,64712,336781
201609,2016,7호선,숭실대입구,433073,56229,489302
201609,2016,7호선,상도,281796,58381,340177
201609,2016,7호선,장승배기,243422,70826,314248
201609,2016,7호선,신대방삼거리,380087,86957,467044
201609,2016,7호선,보라매,232353,40641,272994
201609,2016,7호선,신풍,271888,61442,333330
201609,2016,7호선,대림,306124,33538,339662
201609,2016,7호선,남구로,416225,55158,471383
201609,2016,7호선,가산디지털단지,1037183,67273,1104456
201609,2016,7호선,철산,609242,91816,701058
201609,2016,7호선,광명사거리,665438,140973,806411
201609,2016,7호선,천왕,198338,41835,240173
201609,2016,7호선,온수,290484,31604,322088
201609,2016,7호선,까치울,168180,22976,191156
201609,2016,7호선,부천종합운동장,139580,16490,156070
201609,2016,7호선,춘의,214866,24698,239564
201609,2016,7호선,신중동,366414,43568,409982
201609,2016,7호선,부천시청,317135,41414,358549
201609,2016,7호선,상동,355117,40394,395511
201609,2016,7호선,삼산체육관,137432,22032,159464
201609,2016,7호선,굴포천,224447,30478,254925
201609,2016,7호선,부평구청,319791,28202,347993
201609,2016,8호선,암사,424312,83186,507498
201609,2016,8호선,모란,88405,48817,137222
201609,2016,8호선,강동구청,233584,56765,290349
201609,2016,8호선,몽촌토성,153746,37866,191612
201609,2016,8호선,잠실,312150,54719,366869
201609,2016,8호선,석촌,198303,54833,253136
201609,2016,8호선,송파,121470,31507,152977
201609,2016,8호선,가락시장,151317,49386,200703
201609,2016,8호선,문정,199193,30632,229825
201609,2016,8호선,장지,354243,52755,406998
201609,2016,8호선,복정,257823,37780,295603
201609,2016,8호선,산성,178786,38772,217558
201609,2016,8호선,남한산성입구,366786,70013,436799
201609,2016,8호선,단대오거리,303496,64235,367731
201609,2016,8호선,신흥,104790,44266,149056
201609,2016,8호선,수진,111432,37666,149098
201609,2016,8호선,천호,449854,84572,534426
201609,2016,9호선,개화,160638,32920,193558
201609,2016,9호선,김포공항,248663,17757,266420
201609,2016,9호선,신논현,773020,45736,818756
201609,2016,9호선,사평,65965,13702,79667
201609,2016,9호선,고속터미널,449716,49912,499628
201609,2016,9호선,신반포,76472,21197,97669
201609,2016,9호선,공항시장,65954,20354,86308
201609,2016,9호선,신방화,194839,40095,234934
201609,2016,9호선,마곡나루,69737,8868,78605
201609,2016,9호선,양천향교,177594,36338,213932
201609,2016,9호선,가양,491133,111216,602349
201609,2016,9호선,증미,163536,39716,203252
201609,2016,9호선,등촌,223114,73443,296557
201609,2016,9호선,염창,397678,54552,452230
201609,2016,9호선,신목동,101078,16411,117489
201609,2016,9호선,선유도,166732,24045,190777
201609,2016,9호선,당산,443144,55895,499039
201609,2016,9호선,국회의사당,370224,48321,418545
201609,2016,9호선,여의도,493450,38570,532020
201609,2016,9호선,샛강,115993,22972,138965
201609,2016,9호선,노량진,730549,79040,809589
201609,2016,9호선,노들,112206,28270,140476
201609,2016,9호선,흑석(중앙대입구),273092,50745,323837
201609,2016,9호선,동작,49699,13744,63443
201609,2016,9호선,구반포,70392,21996,92388
201609,2016,9호선2단계,언주,184562,20483,205045
201609,2016,9호선2단계,봉은사,296189,32037,328226
201609,2016,9호선2단계,삼성중앙,111236,16962,128198
201609,2016,9호선2단계,선정릉,166778,17292,184070
201609,2016,9호선2단계,종합운동장,153027,12491,165518
201609,2016,경강선,판교,13801,3359,17160
201609,2016,경강선,이매,8986,4283,13269
201609,2016,경강선,삼동,5779,1634,7413
201609,2016,경강선,경기광주,19622,4205,23827
201609,2016,경강선,초월,10308,2481,12789
201609,2016,경강선,여주,13935,10819,24754
201609,2016,경강선,신둔도예촌,5477,1305,6782
201609,2016,경강선,이천,10181,3310,13491
201609,2016,경강선,부발,7215,1709,8924
201609,2016,경강선,세종대왕릉,1587,1648,3235
201609,2016,경강선,곤지암,10233,3428,13661
201609,2016,경부선,구로,537593,86175,623768
201609,2016,경부선,신길,267878,44774,312652
201609,2016,경부선,금천구청,268443,71930,340373
201609,2016,경부선,석수,306081,45186,351267
201609,2016,경부선,관악,212004,52038,264042
201609,2016,경부선,안양,763796,109662,873458
201609,2016,경부선,명학,265093,39188,304281
201609,2016,경부선,금정,737539,100414,837953
201609,2016,경부선,군포,186822,33019,219841
201609,2016,경부선,의왕,219489,37000,256489
201609,2016,경부선,성균관대,444960,48332,493292
201609,2016,경부선,화서,216633,40874,257507
201609,2016,경부선,수원,1269655,139373,1409028
201609,2016,경부선,독산,404123,62942,467065
201609,2016,경부선,세류,109916,17456,127372
201609,2016,경부선,병점,434392,53584,487976
201609,2016,경부선,세마,67124,12500,79624
201609,2016,경부선,오산대,82198,12092,94290
201609,2016,경부선,오산,282443,40157,322600
201609,2016,경부선,진위,44789,7593,52382
201609,2016,경부선,송탄,131862,24336,156198
201609,2016,경부선,서정리,145619,25159,170778
201609,2016,경부선,지제,27235,4150,31385
201609,2016,경부선,평택,393830,67300,461130
201609,2016,경부선,성환,151353,20301,171654
201609,2016,경부선,직산,26174,5666,31840
201609,2016,경부선,두정,181783,21138,202921
201609,2016,경부선,천안,244040,61942,305982
201609,2016,경부선,당정,200292,28829,229121
201609,2016,경부선,서동탄,40187,8333,48520
201609,2016,경부선,광명,23587,1333,24920
201609,2016,경부선,서울역,19,0,19
201609,2016,경부선,남영,310636,39125,349761
201609,2016,경부선,용산,1030187,135258,1165445
201609,2016,경부선,노량진,476469,54167,530636
201609,2016,경부선,대방,388231,70745,458976
201609,2016,경부선,영등포,1222224,256474,1478698
201609,2016,경부선,신도림,100201,20943,121144
201609,2016,경부선,가산디지털단지,428653,28721,457374
201609,2016,경원선,방학,207962,99761,307723
201609,2016,경원선,창동,6,0,6
201609,2016,경원선,도봉산,154067,82571,236638
201609,2016,경원선,망월사,208934,65498,274432
201609,2016,경원선,회룡,267670,133252,400922
201609,2016,경원선,의정부,564153,119681,683834
201609,2016,경원선,가능,170091,61715,231806
201609,2016,경원선,녹양,121810,32986,154796
201609,2016,경원선,양주,233550,56265,289815
201609,2016,경원선,덕계,50528,16333,66861
201609,2016,경원선,덕정,189866,35065,224931
201609,2016,경원선,지행,184498,44138,228636
201609,2016,경원선,동두천 중앙,83784,38464,122248
201609,2016,경원선,보산,47252,14707,61959
201609,2016,경원선,동두천,51203,18964,70167
201609,2016,경원선,소요산,67017,83265,150282
201609,2016,경원선,이촌,111158,29204,140362
201609,2016,경원선,서빙고,51884,16112,67996
201609,2016,경원선,한남,100209,29819,130028
201609,2016,경원선,옥수,1892,129,2021
201609,2016,경원선,응봉,43189,18232,61421
201609,2016,경원선,왕십리,452932,58980,511912
201609,2016,경원선,청량리(지상),325233,137354,462587
201609,2016,경원선,외대앞,332626,55068,387694
201609,2016,경원선,신이문,228239,63729,291968
201609,2016,경원선,석계,278445,64162,342607
201609,2016,경원선,광운대,268529,53054,321583
201609,2016,경원선,월계,139606,50586,190192
201609,2016,경원선,녹천,119976,38864,158840
201609,2016,경원선,도봉,131605,67510,199115
201609,2016,경의선,서울역,70599,9968,80567
201609,2016,경의선,검암,1,0,1
201609,2016,경의선,효창공원앞,46691,10430,57121
201609,2016,경의선,공덕,52915,9245,62160
201609,2016,경의선,서강대,61282,8746,70028
201609,2016,경의선,홍대입구,42466,4548,47014
201609,2016,경의선,가좌,92636,41525,134161
201609,2016,경의선,디지털미디어시티,61109,9958,71067
201609,2016,경의선,수색,49819,17235,67054
201609,2016,경의선,화전,79152,8030,87182
201609,2016,경의선,강매,59595,14841,74436
201609,2016,경의선,행신,193803,33037,226840
201609,2016,경의선,능곡,85317,29112,114429
201609,2016,경의선,곡산,12294,4984,17278
201609,2016,경의선,백마,169002,30632,199634
201609,2016,경의선,풍산,112201,27405,139606
201609,2016,경의선,일산,230522,55289,285811
201609,2016,경의선,탄현,194837,36389,231226
201609,2016,경의선,야당,76181,18831,95012
201609,2016,경의선,운정,117807,27853,145660
201609,2016,경의선,금릉,122837,24318,147155
201609,2016,경의선,금촌,181438,43078,224516
201609,2016,경의선,월롱,64863,8323,73186
201609,2016,경의선,파주,46350,8263,54613
201609,2016,경의선,문산,148928,47612,196540
201609,2016,경의선,신촌,22847,3498,26345
201609,2016,경인선,인천,118878,46725,165603
201609,2016,경인선,구일,202091,33626,235717
201609,2016,경인선,소사,316743,83575,400318
201609,2016,경인선,부개,256546,62418,318964
201609,2016,경인선,간석,161481,44046,205527
201609,2016,경인선,도원,99100,34143,133243
201609,2016,경인선,온수,186409,44613,231022
201609,2016,경인선,중동,240758,62992,303750
201609,2016,경인선,도화,84164,34436,118600
201609,2016,경인선,개봉,565016,147596,712612
201609,2016,경인선,오류동,273661,80091,353752
201609,2016,경인선,역곡,788656,131735,920391
201609,2016,경인선,부천,1061952,200248,1262200
201609,2016,경인선,송내,869245,109917,979162
201609,2016,경인선,부평,1023456,134152,1157608
201609,2016,경인선,백운,221726,62482,284208
201609,2016,경인선,동암,544998,112189,657187
201609,2016,경인선,주안,719825,105449,825274
201609,2016,경인선,제물포,271300,51232,322532
201609,2016,경인선,동인천,448219,120049,568268
201609,2016,경춘선,평내호평,134183,39089,173272
201609,2016,경춘선,상천,10500,6797,17297
201609,2016,경춘선,사릉,92613,18216,110829
201609,2016,경춘선,퇴계원,81277,22872,104149
201609,2016,경춘선,별내,56834,15181,72015
201609,2016,경춘선,갈매,26161,10113,36274
201609,2016,경춘선,신내,15697,6499,22196
201609,2016,경춘선,천마산,27371,13452,40823
201609,2016,경춘선,마석,84468,30716,115184
201609,2016,경춘선,대성리,22425,5858,28283
201609,2016,경춘선,청평,54517,16796,71313
201609,2016,경춘선,강촌,24442,4864,29306
201609,2016,경춘선,김유정,13428,3905,17333
201609,2016,경춘선,남춘천,79502,22615,102117
201609,2016,경춘선,춘천,62560,19498,82058
201609,2016,경춘선,백양리,3782,1223,5005
201609,2016,경춘선,굴봉산,5901,2358,8259
201609,2016,경춘선,가평,64463,15541,80004
201609,2016,경춘선,금곡,31977,14671,46648
201609,2016,공항철도 1호선,영종,34570,9804,44374
201609,2016,공항철도 1호선,인천국제공항,390933,42413,433346
201609,2016,공항철도 1호선,공항화물청사,66219,7207,73426
201609,2016,공항철도 1호선,운서,134448,23545,157993
201609,2016,공항철도 1호선,청라국제도시,130040,8510,138550
201609,2016,공항철도 1호선,검암,270248,26305,296553
201609,2016,공항철도 1호선,계양,288060,28752,316812
201609,2016,공항철도 1호선,김포공항,287874,17298,305172
201609,2016,공항철도 1호선,디지털미디어시티,307768,19524,327292
201609,2016,공항철도 1호선,홍대입구,246667,16389,263056
201609,2016,공항철도 1호선,서울역,276471,29067,305538
201609,2016,공항철도 1호선,공덕,38291,5772,44063
201609,2016,과천선,평촌,405522,58443,463965
201609,2016,과천선,인덕원,654770,96023,750793
201609,2016,과천선,정부과천청사,297062,61357,358419
201609,2016,과천선,과천,129050,34288,163338
201609,2016,과천선,대공원,147389,50560,197949
201609,2016,과천선,경마공원,151424,56713,208137
201609,2016,과천선,선바위,232914,31800,264714
201609,2016,과천선,범계,781092,99966,881058
201609,2016,분당선,선릉,205814,23432,229246
201609,2016,분당선,매교,65154,16464,81618
201609,2016,분당선,도곡,148208,35838,184046
201609,2016,분당선,구룡,44986,17124,62110
201609,2016,분당선,개포동,84684,20714,105398
201609,2016,분당선,대모산입구,77163,28008,105171
201609,2016,분당선,수서,193419,45172,238591
201609,2016,분당선,복정,1,0,1
201609,2016,분당선,수원,275992,25187,301179
201609,2016,분당선,서울숲,173904,22512,196416
201609,2016,분당선,압구정로데오,364042,35992,400034
201609,2016,분당선,강남구청,202110,34777,236887
201609,2016,분당선,선정릉,180586,35775,216361
201609,2016,분당선,가천대,285431,22489,307920
201609,2016,분당선,태평,347376,82569,429945
201609,2016,분당선,모란,568653,159837,728490
201609,2016,분당선,야탑,663886,145576,809462
201609,2016,분당선,서현,624088,119580,743668
201609,2016,분당선,수내,312356,73737,386093
201609,2016,분당선,정자,392666,75579,468245
201609,2016,분당선,미금,444774,115298,560072
201609,2016,분당선,오리,331557,89731,421288
201609,2016,분당선,이매,152145,41268,193413
201609,2016,분당선,보정,58251,24060,82311
201609,2016,분당선,죽전,420634,79626,500260
201609,2016,분당선,구성,111061,37136,148197
201609,2016,분당선,신갈,103952,28804,132756
201609,2016,분당선,기흥,211368,29041,240409
201609,2016,분당선,상갈,124734,28964,153698
201609,2016,분당선,청명,106570,15193,121763
201609,2016,분당선,영통,237528,25041,262569
201609,2016,분당선,망포,325840,27214,353054
201609,2016,분당선,매탄권선,115507,13316,128823
201609,2016,분당선,수원시청,267243,31034,298277
201609,2016,분당선,한티,347780,61612,409392
201609,2016,수인선,달월,2206,1245,3451
201609,2016,수인선,월곶,71171,13607,84778
201609,2016,수인선,소래포구,126283,62179,188462
201609,2016,수인선,인천논현,155202,28471,183673
201609,2016,수인선,호구포,88424,15912,104336
201609,2016,수인선,남동인더스파크,57211,4476,61687
201609,2016,수인선,인천,23846,9726,33572
201609,2016,수인선,연수,127530,24205,151735
201609,2016,수인선,송도,74414,20017,94431
201609,2016,수인선,인하대,150269,18556,168825
201609,2016,수인선,숭의,63999,21631,85630
201609,2016,수인선,신포,41958,10857,52815
201609,2016,수인선,원인재,124534,26324,150858
201609,2016,안산선,산본,441703,96029,537732
201609,2016,안산선,대야미,99204,23472,122676
201609,2016,안산선,반월,127982,28205,156187
201609,2016,안산선,상록수,565844,81608,647452
201609,2016,안산선,한대앞,258219,38911,297130
201609,2016,안산선,중앙,463868,54942,518810
201609,2016,안산선,수리산,106798,31421,138219
201609,2016,안산선,초지,123098,15338,138436
201609,2016,안산선,안산,500313,43303,543616
201609,2016,안산선,신길온천,44976,9366,54342
201609,2016,안산선,정왕,275662,23157,298819
201609,2016,안산선,오이도,228302,31797,260099
201609,2016,안산선,고잔,235772,34236,270008
201609,2016,일산선,삼송,319950,76792,396742
201609,2016,일산선,주엽,184344,92702,277046
201609,2016,일산선,정발산,202924,58983,261907
201609,2016,일산선,마두,165257,73470,238727
201609,2016,일산선,백석,260458,74002,334460
201609,2016,일산선,대곡,35278,11415,46693
201609,2016,일산선,원흥,147929,36078,184007
201609,2016,일산선,대화,345595,88585,434180
201609,2016,일산선,원당,281645,83013,364658
201609,2016,일산선,화정,448828,126037,574865
201609,2016,장항선,신창,76984,8433,85417
201609,2016,장항선,온양온천,96059,55882,151941
201609,2016,장항선,배방,24427,7113,31540
201609,2016,장항선,아산,76476,8054,84530
201609,2016,장항선,쌍용동,74275,15224,89499
201609,2016,장항선,봉명,28499,13343,41842
201609,2016,중앙선,회기,788766,124390,913156
201609,2016,중앙선,용문,55800,48841,104641
201609,2016,중앙선,상봉,137456,36848,174304
201609,2016,중앙선,망우,189225,66238,255463
201609,2016,중앙선,양원,43045,16752,59797
201609,2016,중앙선,구리,334529,82832,417361
201609,2016,중앙선,도농,219102,55291,274393
201609,2016,중앙선,양정,18541,8711,27252
201609,2016,중앙선,덕소,148555,50210,198765
201609,2016,중앙선,도심,60886,20611,81497
201609,2016,중앙선,팔당,25575,7645,33220
201609,2016,중앙선,운길산,30085,11506,41591
201609,2016,중앙선,양수,49080,20089,69169
201609,2016,중앙선,신원,5879,4267,10146
201609,2016,중앙선,국수,20085,9224,29309
201609,2016,중앙선,아신,22904,7088,29992
201609,2016,중앙선,오빈,6777,3902,10679
201609,2016,중앙선,양평,88819,35783,124602
201609,2016,중앙선,원덕,8260,5933,14193
201609,2016,중앙선,중랑,131555,50522,182077
201608,2016,2호선,충정로,290621,50502,341123
201608,2016,2호선,아현,234119,62609,296728
201608,2016,2호선,이대,527125,66975,594100
201608,2016,2호선,신촌,1384197,136922,1521119
201608,2016,2호선,홍대입구,2293940,114356,2408296
201608,2016,2호선,합정,933142,69005,1002147
201608,2016,2호선,당산,554383,61033,615416
201608,2016,2호선,영등포구청,529095,99903,628998
201608,2016,2호선,문래,483599,80418,564017
201608,2016,2호선,신도림,1668673,201195,1869868
201608,2016,2호선,대림,834784,110616,945400
201608,2016,2호선,구로디지털단지,1732324,158562,1890886
201608,2016,2호선,신대방,726677,125256,851933
201608,2016,2호선,신림,1928642,231391,2160033
201608,2016,2호선,봉천,558851,147585,706436
201608,2016,2호선,서울대입구,1363548,207531,1571079
201608,2016,2호선,낙성대,816494,105657,922151
201608,2016,2호선,사당,1056190,177829,1234019
201608,2016,2호선,방배,524702,74735,599437
201608,2016,2호선,서초,597331,74936,672267
201608,2016,2호선,교대,981298,148501,1129799
201608,2016,2호선,강남,3015965,154452,3170417
201608,2016,2호선,역삼,1216010,143124,1359134
201608,2016,2호선,선릉,1454459,188406,1642865
201608,2016,2호선,삼성,1652255,126545,1778800
201608,2016,2호선,종합운동장,460545,52576,513121
201608,2016,2호선,신천,692013,109767,801780
201608,2016,2호선,잠실,2408243,215737,2623980
201608,2016,2호선,잠실나루,445674,84083,529757
201608,2016,2호선,강변,1399612,140212,1539824
201608,2016,2호선,구의,616804,104623,721427
201608,2016,2호선,건대입구,1256670,89355,1346025
201608,2016,2호선,성수,668155,92182,760337
201608,2016,2호선,뚝섬,406882,62720,469602
201608,2016,2호선,한양대,239888,14078,253966
201608,2016,2호선,왕십리(성동구청),527929,59409,587338
201608,2016,2호선,상왕십리,259998,57896,317894
201608,2016,2호선,신당,339067,103743,442810
201608,2016,2호선,동대문역사문화공원,515078,55939,571017
201608,2016,2호선,을지로4가,290327,89344,379671
201608,2016,2호선,을지로3가,519535,84321,603856
201608,2016,2호선,용두,47364,21830,69194
201608,2016,2호선,시청,697304,55753,753057
201608,2016,7호선,마들,291461,71088,362549
201608,2016,7호선,수락산,340007,88530,428537
201608,2016,7호선,도봉산,235458,45388,280846
201608,2016,7호선,장암,74782,12708,87490
201608,2016,6호선,역촌,84421,36019,120440
201608,2016,6호선,화랑대,326135,44010,370145
201608,2016,6호선,태릉입구,125084,25634,150718
201608,2016,6호선,석계,313287,71069,384356
201608,2016,6호선,돌곶이,221684,61873,283557
201608,2016,6호선,상월곡,142137,36508,178645
201608,2016,6호선,월곡,281854,67196,349050
201608,2016,6호선,고려대,235214,33434,268648
201608,2016,6호선,안암,316649,30995,347644
201608,2016,6호선,보문,211913,36332,248245
201608,2016,6호선,창신,79851,16985,96836
201608,2016,6호선,동묘앞,195790,60299,256089
201608,2016,6호선,신당,191726,34444,226170
201608,2016,6호선,청구,94184,18368,112552
201608,2016,6호선,약수,85148,23031,108179
201608,2016,6호선,버티고개,56838,13968,70806
201608,2016,6호선,한강진,186925,12903,199828
201608,2016,6호선,이태원,467847,33829,501676
201608,2016,6호선,녹사평(용산구청),196649,19734,216383
201608,2016,6호선,삼각지,188881,17724,206605
201608,2016,6호선,효창공원앞,163143,39930,203073
201608,2016,6호선,공덕,448779,66896,515675
201608,2016,6호선,대흥,193163,42219,235382
201608,2016,6호선,광흥창,226765,57446,284211
201608,2016,6호선,상수,311994,22272,334266
201608,2016,6호선,합정,371662,35819,407481
201608,2016,6호선,망원,298489,78418,376907
201608,2016,6호선,마포구청,329081,76389,405470
201608,2016,6호선,월드컵경기장,200000,56426,256426
201608,2016,6호선,디지털미디어시티,376143,57539,433682
201608,2016,6호선,증산,240981,66577,307558
201608,2016,6호선,새절,311047,82424,393471
201608,2016,6호선,구산,191385,54943,246328
201608,2016,6호선,연신내,12,3,15
201608,2016,6호선,독바위,67511,20930,88441
201608,2016,6호선,불광,141737,42838,184575
201608,2016,6호선,봉화산(서울의료원),224283,53088,277371
201608,2016,6호선,응암,420532,103250,523782
201608,2016,5호선,개화산,146398,34042,180440
201608,2016,5호선,거여,157012,46757,203769
201608,2016,5호선,개롱,163562,40200,203762
201608,2016,5호선,오금,93046,16385,109431
201608,2016,5호선,방이,168034,38678,206712
201608,2016,5호선,올림픽공원,166546,31148,197694
201608,2016,5호선,둔촌동,305466,73737,379203
201608,2016,5호선,상일동,254957,56501,311458
201608,2016,5호선,고덕,194445,57987,252432
201608,2016,5호선,명일,183286,57493,240779
201608,2016,5호선,굽은다리,237843,63770,301613
201608,2016,5호선,길동,170428,55529,225957
201608,2016,5호선,강동,477355,89331,566686
201608,2016,5호선,천호,488055,145132,633187
201608,2016,5호선,광나루,352056,57647,409703
201608,2016,5호선,아차산,345611,82865,428476
201608,2016,5호선,군자,284997,34817,319814
201608,2016,5호선,장한평,453441,94159,547600
201608,2016,5호선,답십리,396425,80359,476784
201608,2016,5호선,마장,138377,42643,181020
201608,2016,5호선,왕십리(성동구청),127955,24640,152595
201608,2016,5호선,행당,202547,46735,249282
201608,2016,분당선,이매,121408,32268,153676
201608,2016,경의선,야당,73297,17498,90795
201608,2016,경의선,운정,115992,27112,143104
201608,2016,경의선,금릉,120875,23799,144674
201608,2016,경의선,금촌,176366,42446,218812
201608,2016,경의선,월롱,54641,8309,62950
201608,2016,경의선,파주,30245,8151,38396
201608,2016,경의선,문산,150068,58850,208918
201608,2016,경인선,개봉,556529,150021,706550
201608,2016,경인선,역곡,729137,128633,857770
201608,2016,경인선,온수,168134,42596,210730
201608,2016,경인선,도원,97644,33232,130876
201608,2016,경인선,간석,160900,44373,205273
201608,2016,경인선,부개,251628,61622,313250
201608,2016,경인선,소사,301120,82625,383745
201608,2016,경인선,구일,182757,32019,214776
201608,2016,경인선,인천,121822,55261,177083
201608,2016,경인선,동인천,446681,125839,572520
201608,2016,경인선,제물포,231496,49956,281452
201608,2016,경인선,주안,705621,113163,818784
201608,2016,경인선,도화,83440,34449,117889
201608,2016,경인선,중동,237576,63029,300605
201608,2016,경인선,동암,552906,115142,668048
201608,2016,경인선,백운,211539,62326,273865
201608,2016,경인선,부평,1044983,139626,1184609
201608,2016,경인선,송내,862787,111241,974028
201608,2016,경인선,부천,1045799,206636,1252435
201608,2016,경인선,오류동,276260,79032,355292
201608,2016,경춘선,춘천,56139,31295,87434
201608,2016,경춘선,남춘천,71295,26956,98251
201608,2016,경춘선,강촌,26165,5772,31937
201608,2016,경춘선,김유정,14859,3584,18443
201608,2016,경춘선,백양리,4390,1557,5947
201608,2016,경춘선,굴봉산,13536,2433,15969
201608,2016,경춘선,가평,113906,15733,129639
201608,2016,경춘선,상천,11545,5687,17232
201608,2016,경춘선,청평,90908,17387,108295
201608,2016,9호선,신방화,198967,41925,240892
201608,2016,9호선,공항시장,69981,21727,91708
201608,2016,9호선,신반포,77463,19636,97099
201608,2016,9호선,고속터미널,495000,53799,548799
201608,2016,9호선,사평,70261,14042,84303
201608,2016,9호선,신논현,858710,46590,905300
201608,2016,9호선,김포공항,272370,24344,296714
201608,2016,경부선,진위,40408,7312,47720
201608,2016,경부선,오산,255891,39279,295170
201608,2016,경부선,오산대,61472,11330,72802
201608,2016,경부선,세마,64831,12031,76862
201608,2016,경부선,병점,370574,55247,425821
201608,2016,경부선,세류,103229,18155,121384
201608,2016,경부선,독산,408511,62225,470736
201608,2016,경부선,수원,1174098,143883,1317981
201608,2016,경부선,화서,203373,39706,243079
201608,2016,경부선,성균관대,396046,46742,442788
201608,2016,경부선,의왕,209246,36244,245490
201608,2016,경부선,군포,184679,32602,217281
201608,2016,경부선,금정,729260,97841,827101
201608,2016,경부선,명학,239686,38866,278552
201608,2016,경부선,안양,681423,112215,793638
201608,2016,경부선,관악,204780,51061,255841
201608,2016,경부선,석수,289040,42700,331740
201608,2016,8호선,잠실,334729,65602,400331
201608,2016,중앙선,중랑,135233,52131,187364
201608,2016,중앙선,원덕,7829,6062,13891
201608,2016,중앙선,양평,89728,35186,124914
201608,2016,중앙선,오빈,7602,3894,11496
201608,2016,경부선,금천구청,258360,68384,326744
201608,2016,경부선,신길,268207,43640,311847
201608,2016,경부선,구로,547751,87284,635035
201608,2016,9호선2단계,종합운동장,156639,13197,169836
201608,2016,9호선2단계,선정릉,179961,18380,198341
201608,2016,9호선2단계,삼성중앙,121586,17938,139524
201608,2016,9호선2단계,봉은사,357937,38159,396096
201608,2016,9호선2단계,언주,207969,20933,228902
201608,2016,9호선,구반포,74480,22440,96920
201608,2016,9호선,동작,43229,11483,54712
201608,2016,9호선,흑석(중앙대입구),222096,51125,273221
201608,2016,9호선,노들,117100,29544,146644
201608,2016,9호선,노량진,773224,77576,850800
201608,2016,9호선,샛강,128333,23385,151718
201608,2016,9호선,여의도,534039,40216,574255
201608,2016,9호선,국회의사당,403020,49310,452330
201608,2016,9호선,당산,470317,58752,529069
201608,2016,9호선,선유도,176605,24462,201067
201608,2016,9호선,신목동,101126,15597,116723
201608,2016,9호선,염창,406132,54636,460768
201608,2016,9호선,등촌,234337,76238,310575
201608,2016,9호선,증미,174976,41415,216391
201608,2016,9호선,가양,505077,113138,618215
201608,2016,9호선,양천향교,182511,37525,220036
201608,2016,9호선,마곡나루,69376,8879,78255
201608,2016,7호선,온수,276985,32645,309630
201608,2016,7호선,천왕,202666,41692,244358
201608,2016,7호선,광명사거리,674639,145649,820288
201608,2016,중앙선,아신,21693,6831,28524
201608,2016,중앙선,국수,18336,8283,26619
201608,2016,중앙선,신원,5047,2971,8018
201608,2016,중앙선,양수,48203,18211,66414
201608,2016,중앙선,운길산,26534,11027,37561
201608,2016,중앙선,팔당,18329,6438,24767
201608,2016,중앙선,도심,59494,20347,79841
201608,2016,중앙선,덕소,146357,51532,197889
201608,2016,중앙선,양정,18715,8593,27308
201608,2016,중앙선,도농,217681,54163,271844
201608,2016,중앙선,구리,335298,79588,414886
201608,2016,중앙선,양원,41180,16321,57501
201608,2016,중앙선,망우,193944,65438,259382
201608,2016,중앙선,상봉,151031,37529,188560
201608,2016,중앙선,용문,70739,81409,152148
201608,2016,중앙선,회기,719665,122160,841825
201608,2016,장항선,봉명,27307,13415,40722
201608,2016,장항선,쌍용동,53367,13448,66815
201608,2016,장항선,아산,62734,7479,70213
201608,2016,장항선,배방,22325,6741,29066
201608,2016,장항선,온양온천,88423,60107,148530
201608,2016,장항선,신창,37511,10952,48463
201608,2016,일산선,화정,467044,129993,597037
201608,2016,일산선,원당,280171,81588,361759
201608,2016,일산선,대화,349168,98642,447810
201608,2016,일산선,지축,1,0,1
201608,2016,일산선,원흥,147637,34354,181991
201608,2016,일산선,대곡,34391,11271,45662
201608,2016,일산선,백석,274894,75499,350393
201608,2016,일산선,마두,172759,75269,248028
201608,2016,일산선,정발산,217100,60303,277403
201608,2016,일산선,주엽,198878,97724,296602
201608,2016,일산선,삼송,307988,73387,381375
201608,2016,안산선,고잔,234010,32450,266460
201608,2016,안산선,오이도,224213,39395,263608
201608,2016,안산선,정왕,228288,23594,251882
201608,2016,안산선,신길온천,43169,8989,52158
201608,2016,안산선,안산,497700,45532,543232
201608,2016,안산선,초지,100980,14363,115343
201608,2016,안산선,수리산,105379,30945,136324
201608,2016,안산선,중앙,459792,55406,515198
201608,2016,안산선,한대앞,233346,37466,270812
201608,2016,안산선,상록수,540381,79617,619998
201608,2016,안산선,반월,126151,27540,153691
201608,2016,안산선,대야미,98345,21709,120054
201608,2016,안산선,산본,451558,96747,548305
201608,2016,수인선,원인재,119785,26139,145924
201608,2016,수인선,신포,37478,11225,48703
201608,2016,수인선,숭의,62208,21710,83918
201608,2016,수인선,인하대,119148,18014,137162
201608,2016,수인선,송도,71305,19748,91053
201608,2016,경원선,창동,3,0,3
201608,2016,경원선,의정부,564451,128270,692721
201608,2016,경원선,가능,167609,62298,229907
201608,2016,경원선,녹양,117975,31781,149756
201608,2016,경원선,양주,222932,53863,276795
201608,2016,경원선,덕계,49038,15755,64793
201608,2016,경원선,덕정,163089,34307,197396
201608,2016,경원선,지행,171339,43255,214594
201608,2016,경원선,동두천 중앙,82801,38243,121044
201608,2016,경원선,보산,43790,14606,58396
201608,2016,경원선,동두천,47145,19610,66755
201608,2016,경원선,소요산,68968,109305,178273
201608,2016,경원선,방학,204423,98985,303408
201608,2016,경원선,도봉,131417,67311,198728
201608,2016,경원선,도봉산,145816,78701,224517
201608,2016,경원선,이촌,113096,28635,141731
201608,2016,경원선,서빙고,51363,15341,66704
201608,2016,경원선,한남,103134,30988,134122
201608,2016,경원선,옥수,1671,109,1780
201608,2016,경원선,응봉,41465,17746,59211
201608,2016,경원선,왕십리,460999,64290,525289
201608,2016,경원선,청량리(지상),343535,143656,487191
201608,2016,경원선,외대앞,292337,55630,347967
201608,2016,경원선,신이문,229134,63934,293068
201608,2016,경원선,석계,261419,62155,323574
201608,2016,경원선,광운대,225887,52117,278004
201608,2016,5호선,광화문,1016071,78374,1094445
201608,2016,경원선,월계,99969,48124,148093
201608,2016,경원선,녹천,117062,37900,154962
201608,2016,경원선,회룡,265991,132190,398181
201608,2016,경의선,서울역,67542,9514,77056
201608,2016,경의선,신촌,22989,3549,26538
201608,2016,경의선,효창공원앞,41524,10599,52123
201608,2016,경의선,공덕,54980,9991,64971
201608,2016,경의선,서강대,59211,9097,68308
201608,2016,경의선,홍대입구,41886,4998,46884
201608,2016,경의선,가좌,88243,42471,130714
201608,2016,경의선,디지털미디어시티,58849,10239,69088
201608,2016,경의선,수색,52322,17124,69446
201608,2016,경의선,화전,46006,7814,53820
201608,2016,경의선,강매,57817,14120,71937
201608,2016,경의선,행신,189659,32668,222327
201608,2016,경의선,능곡,83810,28962,112772
201608,2016,경의선,곡산,11863,4958,16821
201608,2016,경의선,백마,165308,29401,194709
201608,2016,경의선,풍산,109767,26781,136548
201608,2016,경의선,일산,221863,52948,274811
201608,2016,경의선,탄현,192903,35555,228458
201608,2016,수인선,연수,126517,24289,150806
201608,2016,수인선,인천,25412,15389,40801
201608,2016,수인선,남동인더스파크,55572,4457,60029
201608,2016,수인선,호구포,89196,16422,105618
201608,2016,수인선,인천논현,154900,28606,183506
201608,2016,수인선,소래포구,108644,52953,161597
201608,2016,수인선,월곶,68079,13841,81920
201608,2016,수인선,달월,2309,1319,3628
201608,2016,분당선,한티,378011,63065,441076
201608,2016,분당선,수원시청,276646,31385,308031
201608,2016,분당선,매탄권선,111783,13235,125018
201608,2016,분당선,망포,326259,27238,353497
201608,2016,분당선,영통,230154,25639,255793
201608,2016,분당선,청명,108153,15433,123586
201608,2016,분당선,상갈,125918,28320,154238
201608,2016,분당선,기흥,188944,28779,217723
201608,2016,분당선,신갈,111290,28893,140183
201608,2016,분당선,구성,111767,35583,147350
201608,2016,분당선,죽전,397367,82693,480060
201608,2016,분당선,보정,60385,23624,84009
201608,2016,8호선,몽촌토성,145526,34447,179973
201608,2016,8호선,강동구청,245340,57858,303198
201608,2016,8호선,모란,88295,48298,136593
201608,2016,8호선,암사,435356,86571,521927
201608,2016,7호선,부평구청,324335,30857,355192
201608,2016,7호선,굴포천,231526,31625,263151
201608,2016,7호선,삼산체육관,142097,22811,164908
201608,2016,7호선,상동,379232,41293,420525
201608,2016,7호선,부천시청,336518,43926,380444
201608,2016,7호선,신중동,381326,45757,427083
201608,2016,7호선,춘의,219915,25307,245222
201608,2016,7호선,부천종합운동장,140476,16149,156625
201608,2016,7호선,까치울,165783,21936,187719
201608,2016,분당선,오리,351292,89551,440843
201608,2016,분당선,미금,472162,115178,587340
201608,2016,분당선,정자,423085,73053,496138
201608,2016,분당선,수내,339767,76314,416081
201608,2016,공항철도 1호선,청라국제도시,136657,8293,144950
201608,2016,공항철도 1호선,운서,145797,23387,169184
201608,2016,공항철도 1호선,공항화물청사,69657,7798,77455
201608,2016,공항철도 1호선,인천국제공항,467449,81338,548787
201608,2016,공항철도 1호선,영종,36352,9650,46002
201608,2016,공항철도 1호선,공덕,40505,6450,46955
201608,2016,공항철도 1호선,홍대입구,260238,16971,277209
201608,2016,경춘선,신내,15062,6316,21378
201608,2016,경춘선,갈매,23912,8405,32317
201608,2016,경춘선,별내,54933,14625,69558
201608,2016,경춘선,퇴계원,79870,22160,102030
201608,2016,9호선,개화,160645,32008,192653
201608,2016,8호선,천호,470066,88120,558186
201608,2016,8호선,수진,117025,40421,157446
201608,2016,8호선,신흥,112389,48351,160740
201608,2016,8호선,단대오거리,293849,65991,359840
201608,2016,8호선,남한산성입구,338855,70066,408921
201608,2016,8호선,산성,183682,39997,223679
201608,2016,8호선,복정,236193,36423,272616
201608,2016,8호선,장지,379065,55372,434437
201608,2016,8호선,문정,207916,30156,238072
201608,2016,8호선,가락시장,157404,44422,201826
201608,2016,8호선,송파,122866,31489,154355
201608,2016,8호선,석촌,213172,55630,268802
201608,2016,1호선,종로5가,529525,246914,776439
201608,2016,1호선,청량리(지하),525005,342211,867216
201608,2016,1호선,제기동,266043,279978,546021
201608,2016,1호선,신설동,363166,114640,477806
201608,2016,1호선,동대문,323799,126478,450277
201608,2016,1호선,동묘앞,153884,123520,277404
201608,2016,1호선,종로3가,711034,335434,1046468
201608,2016,1호선,종각,1239435,146459,1385894
201608,2016,1호선,시청,648583,97067,745650
201608,2016,1호선,서울역,1672795,214384,1887179
201608,2016,경춘선,대성리,36159,5793,41952
201608,2016,경춘선,마석,83038,29416,112454
201608,2016,경춘선,천마산,24807,12537,37344
201608,2016,경춘선,평내호평,135125,38481,173606
201608,2016,경춘선,금곡,30508,13461,43969
201608,2016,경춘선,사릉,87911,16807,104718
201608,2016,분당선,서현,680606,124160,804766
201608,2016,분당선,야탑,688390,143961,832351
201608,2016,분당선,모란,584212,155670,739882
201608,2016,분당선,태평,357557,85020,442577
201608,2016,분당선,가천대,166927,22254,189181
201608,2016,분당선,선정릉,197445,38047,235492
201608,2016,분당선,강남구청,215555,34984,250539
201608,2016,분당선,압구정로데오,404291,36461,440752
201608,2016,분당선,서울숲,165365,21208,186573
201608,2016,분당선,수원,263031,26986,290017
201608,2016,7호선,철산,632880,97698,730578
201608,2016,분당선,복정,7,0,7
201608,2016,분당선,수서,198227,44979,243206
201608,2016,분당선,대모산입구,78648,29114,107762
201608,2016,분당선,개포동,86332,20809,107141
201608,2016,분당선,구룡,41063,16761,57824
201608,2016,분당선,도곡,155174,35361,190535
201608,2016,분당선,매교,63651,16634,80285
201608,2016,분당선,선릉,227906,24422,252328
201608,2016,과천선,범계,801774,103866,905640
201608,2016,과천선,정부과천청사,306960,61665,368625
201608,2016,과천선,인덕원,642579,94542,737121
201608,2016,과천선,평촌,410963,58279,469242
201608,2016,과천선,선바위,228376,29905,258281
201608,2016,과천선,경마공원,160525,56529,217054
201608,2016,과천선,대공원,124182,34568,158750
201608,2016,과천선,과천,126157,34695,160852
201608,2016,공항철도 1호선,김포공항,300243,20583,320826
201608,2016,공항철도 1호선,디지털미디어시티,319850,19092,338942
201608,2016,공항철도 1호선,서울역,289783,31976,321759
201608,2016,공항철도 1호선,계양,290658,29388,320046
201608,2016,공항철도 1호선,검암,297388,30063,327451
201608,2016,7호선,가산디지털단지,1106319,69916,1176235
201608,2016,7호선,남구로,429441,57726,487167
201608,2016,7호선,대림,312175,34960,347135
201608,2016,7호선,신풍,279226,63454,342680
201608,2016,7호선,보라매,234789,40996,275785
201608,2016,7호선,신대방삼거리,388028,91168,479196
201608,2016,7호선,장승배기,249953,73897,323850
201608,2016,7호선,상도,262366,60303,322669
201608,2016,7호선,숭실대입구,341137,55392,396529
201608,2016,7호선,남성,273115,67469,340584
201608,2016,7호선,이수,438470,74653,513123
201608,2016,7호선,내방,354579,59630,414209
201608,2016,7호선,고속터미널,618896,78146,697042
201608,2016,7호선,반포,160696,29474,190170
201608,2016,7호선,논현,530429,47589,578018
201608,2016,7호선,학동,571427,56648,628075
201608,2016,7호선,강남구청,400006,43911,443917
201608,2016,7호선,청담,554931,68165,623096
201608,2016,7호선,뚝섬유원지,276496,47123,323619
201608,2016,7호선,건대입구,449816,51173,500989
201608,2016,7호선,어린이대공원,390043,42860,432903
201608,2016,7호선,군자,371414,77052,448466
201608,2016,7호선,중곡,244388,57340,301728
201608,2016,7호선,용마산,154427,35331,189758
201608,2016,7호선,사가정,385069,86843,471912
201608,2016,7호선,면목,376907,78990,455897
201608,2016,7호선,상봉,443439,66818,510257
201608,2016,7호선,중화,287351,56672,344023
201608,2016,7호선,먹골,259756,54447,314203
201608,2016,4호선,수유(강북구청),1103241,246520,1349761
201608,2016,4호선,쌍문,839461,162119,1001580
201608,2016,4호선,창동,710796,177969,888765
201608,2016,4호선,노원,610629,88101,698730
201608,2016,4호선,남태령,40415,8040,48455
201608,2016,4호선,당고개,320461,96466,416927
201608,2016,3호선,구파발,432807,83644,516451
201608,2016,3호선,경찰병원,190016,36976,226992
201608,2016,3호선,가락시장,211708,63839,275547
201608,2016,3호선,수서,268599,79940,348539
201608,2016,3호선,일원,215861,57449,273310
201608,2016,3호선,대청,255343,48034,303377
201608,2016,3호선,학여울,70881,17531,88412
201608,2016,3호선,대치,316427,60259,376686
201608,2016,3호선,도곡,174110,25594,199704
201608,2016,3호선,매봉,290593,51805,342398
201608,2016,3호선,양재,1023953,140697,1164650
201608,2016,3호선,남부터미널,977022,121599,1098621
201608,2016,3호선,교대,351758,60698,412456
201608,2016,3호선,고속터미널,1600439,181773,1782212
201608,2016,3호선,잠원,137044,30479,167523
201608,2016,3호선,신사,888326,67060,955386
201608,2016,3호선,압구정,915700,132760,1048460
201608,2016,3호선,옥수,243310,55875,299185
201608,2016,3호선,금호,180981,49820,230801
201608,2016,3호선,약수,344997,83795,428792
201608,2016,3호선,동대입구,265777,33837,299614
201608,2016,3호선,충무로,33,1,34
201608,2016,3호선,을지로3가,211005,57151,268156
201608,2016,3호선,종로3가,183441,67314,250755
201608,2016,3호선,안국,652488,106689,759177
201608,2016,3호선,경복궁,627145,80136,707281
201608,2016,3호선,독립문,165128,66070,231198
201608,2016,3호선,무악재,93635,31897,125532
201608,2016,3호선,홍제,442904,146579,589483
201608,2016,3호선,녹번,327738,66692,394430
201608,2016,3호선,불광,440735,149633,590368
201608,2016,3호선,연신내,1010446,252681,1263127
201608,2016,3호선,오금,175959,25573,201532
201608,2016,3호선,지축,29994,12480,42474
201608,2016,2호선,을지로입구,1451357,112146,1563503
201608,2016,2호선,신정네거리,251725,65260,316985
201608,2016,2호선,양천구청,162492,42048,204540
201608,2016,2호선,도림천,25613,6059,31672
201608,2016,2호선,신설동,85029,31876,116905
201608,2016,7호선,태릉입구,214538,37158,251696
201608,2016,7호선,공릉,297103,62711,359814
201608,2016,7호선,하계,493414,100798,594212
201608,2016,7호선,중계,383700,88071,471771
201608,2016,7호선,노원,543156,111749,654905
201608,2016,5호선,송정,226341,59696,286037
201608,2016,5호선,김포공항,220103,39806,259909
201608,2016,5호선,마천,107273,46678,153951
201608,2016,5호선,방화,178765,47524,226289
201608,2016,4호선,상계,538209,111760,649969
201608,2016,4호선,사당,825441,88731,914172
201608,2016,4호선,총신대입구,520913,132820,653733
201608,2016,4호선,동작,54308,17733,72041
201608,2016,4호선,이촌,255261,43101,298362
201608,2016,4호선,신용산,347887,50044,397931
201608,2016,4호선,삼각지,112870,28768,141638
201608,2016,4호선,숙대입구,415748,57714,473462
201608,2016,4호선,서울역,320554,38141,358695
201608,2016,4호선,회현,688334,193004,881338
201608,2016,4호선,명동,1173788,64782,1238570
201608,2016,4호선,충무로,805683,125266,930949
201608,2016,4호선,동대문역사문화공원,681429,62932,744361
201608,2016,4호선,동대문,609593,141724,751317
201608,2016,4호선,혜화,1128697,126759,1255456
201608,2016,4호선,한성대입구,388965,75554,464519
201608,2016,4호선,성신여대입구,669504,103066,772570
201608,2016,4호선,길음,647352,143484,790836
201608,2016,4호선,미아사거리,804642,188421,993063
201608,2016,4호선,미아,431527,127273,558800
201608,2016,5호선,종로3가,292335,124303,416638
201608,2016,5호선,을지로4가,104389,38951,143340
201608,2016,5호선,동대문역사문화공원,80330,11008,91338
201608,2016,5호선,청구,95288,25516,120804
201608,2016,5호선,신금호,133910,34482,168392
201608,2016,5호선,서대문,424477,66874,491351
201608,2016,5호선,충정로,112689,16341,129030
201608,2016,5호선,애오개,166549,38390,204939
201608,2016,5호선,공덕,331157,41917,373074
201608,2016,5호선,마포,366288,61298,427586
201608,2016,5호선,여의나루,378477,32310,410787
201608,2016,5호선,여의도,624565,51534,676099
201608,2016,5호선,신길,83188,11296,94484
201608,2016,5호선,영등포시장,171947,70052,241999
201608,2016,5호선,영등포구청,77287,18505,95792
201608,2016,5호선,양평,155887,26679,182566
201608,2016,5호선,오목교,668073,80887,748960
201608,2016,5호선,목동,468148,77696,545844
201608,2016,5호선,신정,373707,55527,429234
201608,2016,5호선,까치산,745732,144267,889999
201608,2016,5호선,화곡,734873,131350,866223
201608,2016,5호선,우장산,392002,72459,464461
201608,2016,5호선,발산,296154,52732,348886
201608,2016,5호선,마곡,99707,15069,114776
201608,2016,경원선,망월사,167061,65786,232847
201608,2016,경부선,가산디지털단지,436894,27715,464609
201608,2016,경부선,신도림,93949,18980,112929
201608,2016,경부선,영등포,1303151,275752,1578903
201608,2016,경부선,대방,388046,70943,458989
201608,2016,경부선,노량진,457578,43629,501207
201608,2016,경부선,용산,1089975,143887,1233862
201608,2016,경부선,남영,286683,38883,325566
201608,2016,경부선,서울역,29,3,32
201608,2016,경부선,광명,25236,1495,26731
201608,2016,경부선,서동탄,39765,9284,49049
201608,2016,경부선,당정,179917,28276,208193
201608,2016,경부선,천안,174185,67045,241230
201608,2016,경부선,두정,138588,21389,159977
201608,2016,경부선,직산,24652,5609,30261
201608,2016,경부선,성환,94209,20361,114570
201608,2016,경부선,평택,343607,69076,412683
201608,2016,경부선,지제,25313,3929,29242
201608,2016,경부선,서정리,116833,27670,144503
201608,2016,경부선,송탄,117618,24469,142087
201608,2016,2호선,신답,29134,10547,39681
201608,2016,2호선,용답,58987,16476,75463
201607,2016,과천선,경마공원,204835,69816,274651
201607,2016,중앙선,중랑,139676,52039,191715
201607,2016,중앙선,원덕,7806,6160,13966
201607,2016,중앙선,양평,87802,33691,121493
201607,2016,중앙선,오빈,7231,3721,10952
201607,2016,중앙선,아신,19648,6887,26535
201607,2016,중앙선,국수,18586,8224,26810
201607,2016,중앙선,신원,5198,3113,8311
201607,2016,중앙선,양수,58838,27966,86804
201607,2016,중앙선,운길산,28224,11174,39398
201607,2016,중앙선,팔당,19317,6526,25843
201607,2016,중앙선,도심,61173,20663,81836
201607,2016,중앙선,덕소,149412,49747,199159
201607,2016,중앙선,양정,19150,8695,27845
201607,2016,중앙선,도농,226629,55422,282051
201607,2016,중앙선,구리,340646,80784,421430
201607,2016,중앙선,양원,45388,16960,62348
201607,2016,중앙선,망우,196880,67214,264094
201607,2016,중앙선,상봉,149105,37188,186293
201607,2016,중앙선,용문,60435,51792,112227
201607,2016,중앙선,회기,744730,124608,869338
201607,2016,장항선,봉명,27637,13603,41240
201607,2016,장항선,쌍용동,52582,13945,66527
201607,2016,장항선,아산,61066,7557,68623
201607,2016,장항선,배방,23364,7317,30681
201607,2016,장항선,온양온천,87691,52119,139810
201607,2016,장항선,신창,30304,8057,38361
201607,2016,일산선,화정,482155,131711,613866
201607,2016,일산선,원당,289035,84316,373351
201607,2016,일산선,대화,347524,90675,438199
201607,2016,일산선,원흥,154505,36599,191104
201607,2016,일산선,대곡,35127,11886,47013
201607,2016,일산선,백석,273421,74688,348109
201607,2016,일산선,마두,177598,76829,254427
201607,2016,일산선,정발산,225854,58909,284763
201607,2016,일산선,주엽,198131,95663,293794
201607,2016,일산선,삼송,310254,73979,384233
201607,2016,안산선,고잔,247814,33997,281811
201607,2016,안산선,오이도,224907,31996,256903
201607,2016,안산선,정왕,238307,24839,263146
201607,2016,안산선,신길온천,44543,9164,53707
201607,2016,안산선,안산,519514,45489,565003
201607,2016,안산선,초지,100223,15037,115260
201607,2016,안산선,수리산,109927,32059,141986
201607,2016,안산선,중앙,464915,54597,519512
201607,2016,2호선,상왕십리,270082,59027,329109
201607,2016,2호선,신당,351309,105974,457283
201607,2016,2호선,동대문역사문화공원,537592,57829,595421
201607,2016,2호선,을지로4가,303609,93458,397067
201607,2016,2호선,을지로3가,533173,88359,621532
201607,2016,2호선,용두,48700,22034,70734
201607,2016,2호선,시청,722291,56541,778832
201607,2016,1호선,종로5가,555739,255191,810930
201607,2016,1호선,청량리(지하),536539,339904,876443
201607,2016,1호선,제기동,279077,284607,563684
201607,2016,1호선,신설동,372618,118903,491521
201607,2016,1호선,동대문,344612,133246,477858
201607,2016,1호선,동묘앞,163028,130130,293158
201607,2016,1호선,종로3가,770598,341563,1112161
201607,2016,1호선,종각,1266444,146243,1412687
201607,2016,1호선,시청,660196,88478,748674
201607,2016,1호선,서울역,1673686,212894,1886580
201607,2016,7호선,군자,383280,78870,462150
201607,2016,7호선,중곡,256027,59292,315319
201607,2016,7호선,용마산,164669,35523,200192
201607,2016,7호선,사가정,401425,88921,490346
201607,2016,7호선,면목,383181,79949,463130
201607,2016,7호선,상봉,459450,70198,529648
201607,2016,7호선,중화,298667,58434,357101
201607,2016,7호선,먹골,266958,55659,322617
201607,2016,7호선,태릉입구,219162,38246,257408
201607,2016,7호선,공릉,316502,66479,382981
201607,2016,7호선,하계,515751,103117,618868
201607,2016,7호선,중계,402672,91567,494239
201607,2016,7호선,노원,555156,111919,667075
201607,2016,7호선,마들,303671,71733,375404
201607,2016,7호선,수락산,352338,89681,442019
201607,2016,7호선,도봉산,243829,49400,293229
201607,2016,7호선,장암,77956,12183,90139
201607,2016,6호선,역촌,85259,35207,120466
201607,2016,6호선,화랑대,336239,44177,380416
201607,2016,6호선,태릉입구,128656,25969,154625
201607,2016,6호선,석계,322601,72379,394980
201607,2016,6호선,돌곶이,228896,62552,291448
201607,2016,6호선,상월곡,148397,36891,185288
201607,2016,6호선,월곡,291962,68254,360216
201607,2016,6호선,고려대,245211,33640,278851
201607,2016,6호선,안암,347024,31334,378358
201607,2016,6호선,보문,223421,36679,260100
201607,2016,6호선,창신,82359,17224,99583
201607,2016,9호선,노들,121415,29908,151323
201607,2016,9호선,흑석(중앙대입구),234768,53791,288559
201607,2016,9호선,동작,44896,12146,57042
201607,2016,9호선,구반포,76061,22786,98847
201607,2016,9호선2단계,언주,204781,21031,225812
201607,2016,9호선2단계,봉은사,362103,34135,396238
201607,2016,9호선2단계,삼성중앙,122187,17498,139685
201607,2016,9호선2단계,선정릉,180382,18535,198917
201607,2016,9호선2단계,종합운동장,160165,12745,172910
201607,2016,경부선,구로,571657,88606,660263
201607,2016,경부선,신길,278915,45451,324366
201607,2016,경부선,금천구청,271493,71099,342592
201607,2016,경부선,석수,298944,45132,344076
201607,2016,경부선,관악,215796,53328,269124
201607,2016,경부선,안양,682020,114055,796075
201607,2016,경부선,명학,250308,39832,290140
201607,2016,경부선,금정,758741,101081,859822
201607,2016,경부선,군포,192794,33189,225983
201607,2016,경부선,의왕,217858,37758,255616
201607,2016,경부선,성균관대,405417,48435,453852
201607,2016,경부선,화서,213275,40788,254063
201607,2016,경부선,수원,1162727,140602,1303329
201607,2016,경부선,독산,423009,63549,486558
201607,2016,경부선,세류,108150,18163,126313
201607,2016,경부선,병점,375945,55003,430948
201607,2016,경부선,세마,67815,12625,80440
201607,2016,경부선,오산대,62393,12142,74535
201607,2016,경부선,오산,260947,39540,300487
201607,2016,경부선,진위,43094,7710,50804
201607,2016,경부선,송탄,123124,24424,147548
201607,2016,6호선,동묘앞,207718,63325,271043
201607,2016,6호선,신당,200700,36013,236713
201607,2016,6호선,청구,98701,18862,117563
201607,2016,6호선,약수,87980,22804,110784
201607,2016,6호선,버티고개,58908,14303,73211
201607,2016,6호선,한강진,175298,13289,188587
201607,2016,6호선,이태원,465213,35679,500892
201607,2016,6호선,녹사평(용산구청),203625,20800,224425
201607,2016,5호선,발산,297708,54561,352269
201607,2016,5호선,우장산,402137,73157,475294
201607,2016,5호선,화곡,753598,134120,887718
201607,2016,5호선,까치산,766205,146744,912949
201607,2016,5호선,신정,385364,56559,441923
201607,2016,5호선,목동,480612,79521,560133
201607,2016,5호선,오목교,682404,81918,764322
201607,2016,5호선,양평,160216,27084,187300
201607,2016,5호선,영등포구청,79671,18351,98022
201607,2016,5호선,영등포시장,179031,71461,250492
201607,2016,5호선,신길,84030,11246,95276
201607,2016,5호선,여의도,638740,52785,691525
201607,2016,5호선,여의나루,353419,31584,385003
201607,2016,5호선,마포,379691,62928,442619
201607,2016,5호선,공덕,344406,44167,388573
201607,2016,5호선,애오개,172091,38839,210930
201607,2016,5호선,충정로,119965,16641,136606
201607,2016,5호선,서대문,432740,65974,498714
201607,2016,5호선,광화문,1016284,78190,1094474
201607,2016,5호선,종로3가,309384,120813,430197
201607,2016,5호선,을지로4가,106808,39647,146455
201607,2016,5호선,동대문역사문화공원,81908,11428,93336
201607,2016,5호선,청구,98442,26031,124473
201607,2016,5호선,신금호,140985,35351,176336
201607,2016,5호선,행당,210868,47610,258478
201607,2016,5호선,왕십리(성동구청),130728,24609,155337
201607,2016,5호선,마장,144725,41801,186526
201607,2016,5호선,답십리,413030,82026,495056
201607,2016,5호선,장한평,468737,96692,565429
201607,2016,5호선,군자,295207,35797,331004
201607,2016,5호선,아차산,357041,86170,443211
201607,2016,5호선,광나루,361814,61263,423077
201607,2016,5호선,천호,500975,143818,644793
201607,2016,5호선,강동,485452,89869,575321
201607,2016,5호선,길동,176819,56479,233298
201607,2016,5호선,굽은다리,245644,64175,309819
201607,2016,5호선,명일,194210,59613,253823
201607,2016,5호선,고덕,199632,54729,254361
201607,2016,5호선,상일동,258521,56822,315343
201607,2016,5호선,둔촌동,317537,75923,393460
201607,2016,5호선,올림픽공원,208044,33054,241098
201607,2016,5호선,방이,176858,39538,216396
201607,2016,5호선,오금,97097,16973,114070
201607,2016,5호선,개롱,169095,42297,211392
201607,2016,5호선,거여,163486,46841,210327
201607,2016,5호선,개화산,149568,33916,183484
201607,2016,6호선,응암,430371,105242,535613
201607,2016,6호선,봉화산(서울의료원),230154,50775,280929
201607,2016,6호선,불광,142741,40787,183528
201607,2016,6호선,독바위,69069,20581,89650
201607,2016,6호선,연신내,29,0,29
201607,2016,6호선,구산,198881,54221,253102
201607,2016,6호선,새절,319040,83351,402391
201607,2016,6호선,증산,249044,67577,316621
201607,2016,6호선,디지털미디어시티,384381,59822,444203
201607,2016,6호선,월드컵경기장,156598,51568,208166
201607,2016,6호선,마포구청,335160,78821,413981
201607,2016,6호선,망원,306102,81315,387417
201607,2016,6호선,합정,372440,36156,408596
201607,2016,6호선,상수,310404,22443,332847
201607,2016,6호선,광흥창,233288,59497,292785
201607,2016,6호선,대흥,200578,44658,245236
201607,2016,6호선,공덕,462224,69398,531622
201607,2016,6호선,효창공원앞,176317,41101,217418
201607,2016,6호선,삼각지,194479,18515,212994
201607,2016,경부선,서정리,116901,28505,145406
201607,2016,경부선,지제,25572,4019,29591
201607,2016,경부선,평택,346667,68454,415121
201607,2016,경부선,성환,88827,20449,109276
201607,2016,경부선,직산,25642,5741,31383
201607,2016,경부선,두정,142180,22009,164189
201607,2016,경부선,천안,166083,60487,226570
201607,2016,경부선,당정,183988,29713,213701
201607,2016,경부선,서동탄,41557,8621,50178
201607,2016,경부선,광명,25147,1399,26546
201607,2016,경부선,서울역,31,0,31
201607,2016,경부선,남영,299789,40180,339969
201607,2016,경부선,용산,1083912,137293,1221205
201607,2016,경부선,노량진,478318,44376,522694
201607,2016,경부선,대방,402003,73387,475390
201607,2016,경부선,영등포,1329789,274986,1604775
201607,2016,경부선,신도림,98024,20499,118523
201607,2016,경부선,가산디지털단지,458138,29587,487725
201607,2016,경원선,망월사,177081,66757,243838
201607,2016,경원선,창동,6,1,7
201607,2016,경원선,의정부,579745,126191,705936
201607,2016,경원선,가능,173462,63667,237129
201607,2016,경원선,녹양,123119,32700,155819
201607,2016,경원선,양주,229175,52824,281999
201607,2016,경원선,덕계,50988,16470,67458
201607,2016,경원선,덕정,166777,35560,202337
201607,2016,경원선,지행,178740,44305,223045
201607,2016,경원선,동두천 중앙,85267,37691,122958
201607,2016,경원선,보산,46716,14819,61535
201607,2016,경원선,동두천,51990,18950,70940
201607,2016,경원선,소요산,66182,88939,155121
201607,2016,경원선,방학,213344,101582,314926
201607,2016,경원선,도봉,136765,68743,205508
201607,2016,경원선,도봉산,142690,77141,219831
201607,2016,경원선,이촌,120356,29615,149971
201607,2016,경원선,서빙고,55455,15989,71444
201607,2016,경원선,한남,105034,33482,138516
201607,2016,경원선,옥수,1668,161,1829
201607,2016,경원선,응봉,43697,18474,62171
201607,2016,경원선,왕십리,460575,59870,520445
201607,2016,경원선,청량리(지상),344837,138361,483198
201607,2016,경원선,외대앞,301396,56191,357587
201607,2016,경원선,신이문,238012,64317,302329
201607,2016,경원선,석계,267816,62633,330449
201607,2016,경원선,광운대,228199,53017,281216
201607,2016,경원선,월계,105552,49650,155202
201607,2016,경원선,녹천,122538,38306,160844
201607,2016,경원선,회룡,275234,134809,410043
201607,2016,경의선,서울역,31042,4473,35515
201607,2016,경의선,신촌,24409,3685,28094
201607,2016,경의선,효창공원앞,41572,10185,51757
201607,2016,경의선,공덕,55161,9504,64665
201607,2016,경의선,서강대,59793,8731,68524
201607,2016,경의선,홍대입구,42128,4709,46837
201607,2016,경의선,가좌,91369,42009,133378
201607,2016,경의선,디지털미디어시티,59177,10243,69420
201607,2016,경의선,수색,53438,17197,70635
201607,2016,경의선,화전,47562,8139,55701
201607,2016,경의선,강매,60331,14835,75166
201607,2016,경의선,행신,193411,33215,226626
201607,2016,경의선,능곡,85851,29045,114896
201607,2016,경의선,곡산,12313,5090,17403
201607,2016,경의선,백마,171214,30761,201975
201607,2016,경의선,풍산,113670,27470,141140
201607,2016,경의선,일산,229025,55153,284178
201607,2016,경의선,탄현,198084,36517,234601
201607,2016,경의선,야당,73433,17809,91242
201607,2016,경의선,운정,119022,28286,147308
201607,2016,경의선,금릉,124213,24293,148506
201607,2016,경의선,금촌,179092,43431,222523
201607,2016,경의선,월롱,53781,8216,61997
201607,2016,경의선,파주,30762,7769,38531
201607,2016,경의선,문산,150780,47143,197923
201607,2016,경인선,개봉,571362,151158,722520
201607,2016,경인선,역곡,739555,132464,872019
201607,2016,경인선,온수,174988,44005,218993
201607,2016,경인선,도원,99367,33832,133199
201607,2016,경인선,간석,166094,46788,212882
201607,2016,경인선,부개,264556,62973,327529
201607,2016,경인선,소사,311190,85548,396738
201607,2016,경인선,구일,205682,34682,240364
201607,2016,경인선,인천,110320,44040,154360
201607,2016,경인선,동인천,456373,120304,576677
201607,2016,경인선,제물포,227153,48244,275397
201607,2016,경인선,주안,739600,123397,862997
201607,2016,경인선,도화,83660,33151,116811
201607,2016,경인선,중동,249740,64862,314602
201607,2016,경인선,동암,626358,134172,760530
201607,2016,경인선,백운,214809,62748,277557
201607,2016,경인선,부평,1077200,139188,1216388
201607,2016,경인선,송내,887351,117196,1004547
201607,2016,경인선,부천,1063600,206212,1269812
201607,2016,경인선,오류동,288117,83140,371257
201607,2016,경춘선,춘천,46004,24664,70668
201607,2016,경춘선,남춘천,66897,23183,90080
201607,2016,경춘선,강촌,20590,4811,25401
201607,2016,경춘선,김유정,12977,3385,16362
201607,2016,경춘선,백양리,4842,1121,5963
201607,2016,경춘선,굴봉산,8690,2048,10738
201607,2016,경춘선,가평,93432,14388,107820
201607,2016,경춘선,상천,10365,5126,15491
201607,2016,경춘선,청평,76929,16988,93917
201607,2016,경춘선,대성리,30855,5423,36278
201607,2016,경춘선,마석,83093,29926,113019
201607,2016,경춘선,천마산,24700,12415,37115
201607,2016,경춘선,평내호평,133707,39267,172974
201607,2016,경춘선,금곡,30976,13936,44912
201607,2016,경춘선,사릉,90226,17725,107951
201607,2016,경춘선,퇴계원,82008,22901,104909
201607,2016,경춘선,별내,56959,15250,72209
201607,2016,경춘선,갈매,18313,6167,24480
201607,2016,경춘선,신내,15763,6872,22635
201607,2016,공항철도 1호선,홍대입구,255010,17047,272057
201607,2016,공항철도 1호선,공덕,40083,5879,45962
201607,2016,공항철도 1호선,영종,37433,9837,47270
201607,2016,공항철도 1호선,인천국제공항,416615,47189,463804
201607,2016,공항철도 1호선,공항화물청사,68457,7561,76018
201607,2016,공항철도 1호선,운서,143370,23212,166582
201607,2016,공항철도 1호선,청라국제도시,134757,8187,142944
201607,2016,공항철도 1호선,검암,469670,43703,513373
201607,2016,공항철도 1호선,계양,294522,29901,324423
201607,2016,공항철도 1호선,서울역,288005,29922,317927
201607,2016,공항철도 1호선,디지털미디어시티,322983,19690,342673
201607,2016,공항철도 1호선,김포공항,284321,16832,301153
201607,2016,과천선,과천,129756,35145,164901
201607,2016,과천선,대공원,108322,40223,148545
201607,2016,과천선,선바위,237198,31822,269020
201607,2016,과천선,평촌,418278,59496,477774
201607,2016,과천선,인덕원,665152,97020,762172
201607,2016,과천선,정부과천청사,317730,63382,381112
201607,2016,과천선,범계,821933,105227,927160
201607,2016,분당선,선릉,236342,25798,262140
201607,2016,분당선,매교,66907,17283,84190
201607,2016,분당선,도곡,162911,36833,199744
201607,2016,분당선,구룡,43606,17109,60715
201607,2016,분당선,개포동,89622,20832,110454
201607,2016,분당선,대모산입구,83001,29339,112340
201607,2016,분당선,수서,203520,47067,250587
201607,2016,분당선,복정,4,0,4
201607,2016,분당선,수원,263982,25751,289733
201607,2016,분당선,서울숲,169028,22167,191195
201607,2016,분당선,압구정로데오,416710,37992,454702
201607,2016,분당선,강남구청,220057,35325,255382
201607,2016,분당선,선정릉,201336,39316,240652
201607,2016,분당선,가천대,183556,22797,206353
201607,2016,분당선,태평,366398,84949,451347
201607,2016,분당선,모란,594162,153080,747242
201607,2016,분당선,야탑,705986,145290,851276
201607,2016,분당선,서현,702248,125972,828220
201607,2016,분당선,수내,348829,76947,425776
201607,2016,분당선,정자,438402,75262,513664
201607,2016,분당선,미금,487799,116586,604385
201607,2016,분당선,오리,362033,91535,453568
201607,2016,분당선,이매,127428,33067,160495
201607,2016,분당선,보정,62255,24319,86574
201607,2016,분당선,죽전,411357,80221,491578
201607,2016,분당선,구성,116457,37470,153927
201607,2016,분당선,신갈,113611,29178,142789
201607,2016,분당선,기흥,193684,30136,223820
201607,2016,분당선,상갈,129168,28754,157922
201607,2016,분당선,청명,111860,15947,127807
201607,2016,분당선,영통,237129,26495,263624
201607,2016,분당선,망포,340506,28119,368625
201607,2016,분당선,매탄권선,116053,13735,129788
201607,2016,분당선,수원시청,285165,32146,317311
201607,2016,분당선,한티,400884,65110,465994
201607,2016,수인선,달월,2428,1293,3721
201607,2016,수인선,월곶,68093,13520,81613
201607,2016,수인선,소래포구,107804,46901,154705
201607,2016,수인선,인천논현,155053,28786,183839
201607,2016,수인선,호구포,86258,14287,100545
201607,2016,수인선,남동인더스파크,55403,4563,59966
201607,2016,수인선,인천,22642,11070,33712
201607,2016,수인선,연수,123891,23646,147537
201607,2016,수인선,송도,71416,19095,90511
201607,2016,수인선,인하대,99412,14892,114304
201607,2016,수인선,숭의,58207,19719,77926
201607,2016,수인선,신포,36651,10133,46784
201607,2016,수인선,원인재,118946,24935,143881
201607,2016,안산선,산본,467777,99897,567674
201607,2016,안산선,대야미,103829,22928,126757
201607,2016,안산선,반월,132004,28400,160404
201607,2016,안산선,상록수,549727,82701,632428
201607,2016,안산선,한대앞,241334,39603,280937
201607,2016,7호선,어린이대공원,367147,44816,411963
201607,2016,7호선,건대입구,451893,51381,503274
201607,2016,7호선,뚝섬유원지,272236,45615,317851
201607,2016,7호선,청담,564013,71081,635094
201607,2016,7호선,강남구청,411389,45923,457312
201607,2016,7호선,학동,584556,59040,643596
201607,2016,7호선,논현,543032,49963,592995
201607,2016,7호선,반포,164923,30152,195075
201607,2016,7호선,고속터미널,606720,76258,682978
201607,2016,7호선,내방,364130,61702,425832
201607,2016,7호선,이수,454603,75216,529819
201607,2016,7호선,남성,279447,67985,347432
201607,2016,7호선,숭실대입구,363253,57372,420625
201607,2016,7호선,상도,266569,60818,327387
201607,2016,7호선,장승배기,255530,73653,329183
201607,2016,7호선,신대방삼거리,397364,90713,488077
201607,2016,7호선,보라매,246802,42087,288889
201607,2016,7호선,신풍,292056,66088,358144
201607,2016,7호선,대림,313762,35606,349368
201607,2016,7호선,남구로,440853,58457,499310
201607,2016,7호선,가산디지털단지,1137760,72083,1209843
201607,2016,7호선,철산,649088,97205,746293
201607,2016,7호선,광명사거리,699250,144774,844024
201607,2016,7호선,천왕,210282,42197,252479
201607,2016,7호선,온수,282805,32956,315761
201607,2016,7호선,까치울,171948,22923,194871
201607,2016,7호선,부천종합운동장,143367,16616,159983
201607,2016,7호선,춘의,221245,25674,246919
201607,2016,2호선,잠실,2398868,204839,2603707
201607,2016,2호선,신천,715468,113649,829117
201607,2016,2호선,종합운동장,508693,58476,567169
201607,2016,2호선,삼성,1710919,122393,1833312
201607,2016,2호선,선릉,1503936,193637,1697573
201607,2016,2호선,역삼,1229512,145245,1374757
201607,2016,2호선,강남,3221329,162517,3383846
201607,2016,2호선,교대,1011425,155602,1167027
201607,2016,2호선,서초,618640,78719,697359
201607,2016,2호선,방배,512823,77732,590555
201607,2016,2호선,사당,1113393,188633,1302026
201607,2016,2호선,낙성대,843981,107708,951689
201607,2016,2호선,서울대입구,1408853,209320,1618173
201607,2016,2호선,봉천,573317,147820,721137
201607,2016,2호선,신림,1990766,236845,2227611
201607,2016,2호선,신대방,747813,129847,877660
201607,2016,2호선,구로디지털단지,1783941,162677,1946618
201607,2016,2호선,대림,861773,114750,976523
201607,2016,2호선,신도림,1707455,198341,1905796
201607,2016,2호선,문래,492380,81216,573596
201607,2016,2호선,영등포구청,546662,104665,651327
201607,2016,2호선,당산,579009,65449,644458
201607,2016,2호선,합정,959427,70916,1030343
201607,2016,2호선,홍대입구,2297965,115810,2413775
201607,2016,2호선,신촌,1447297,139555,1586852
201607,2016,2호선,이대,545242,73951,619193
201607,2016,2호선,아현,248569,64615,313184
201607,2016,2호선,충정로,304255,52181,356436
201607,2016,2호선,용답,61933,16559,78492
201607,2016,2호선,신답,31724,10851,42575
201607,2016,2호선,신설동,90906,33783,124689
201607,2016,2호선,도림천,25816,6202,32018
201607,2016,2호선,양천구청,172154,44267,216421
201607,2016,2호선,신정네거리,258707,65289,323996
201607,2016,2호선,을지로입구,1458338,113488,1571826
201607,2016,3호선,지축,29748,12676,42424
201607,2016,3호선,오금,181371,24978,206349
201607,2016,3호선,연신내,1041590,258130,1299720
201607,2016,3호선,불광,452934,150403,603337
201607,2016,3호선,녹번,337238,69522,406760
201607,2016,3호선,홍제,454072,149626,603698
201607,2016,3호선,무악재,96698,32797,129495
201607,2016,3호선,독립문,161743,69371,231114
201607,2016,3호선,경복궁,651520,85362,736882
201607,2016,3호선,안국,666642,122763,789405
201607,2016,3호선,종로3가,194038,65924,259962
201607,2016,3호선,을지로3가,216660,58699,275359
201607,2016,3호선,충무로,43,2,45
201607,2016,3호선,동대입구,289935,36131,326066
201607,2016,3호선,약수,357754,86420,444174
201607,2016,3호선,금호,188095,51591,239686
201607,2016,3호선,옥수,253409,58897,312306
201607,2016,3호선,압구정,978349,139817,1118166
201607,2016,3호선,신사,909752,69212,978964
201607,2016,3호선,잠원,142704,31411,174115
201607,2016,3호선,고속터미널,1609128,173560,1782688
201607,2016,3호선,교대,363136,63941,427077
201607,2016,3호선,남부터미널,984447,125095,1109542
201607,2016,3호선,양재,1064983,148511,1213494
201607,2016,3호선,매봉,302953,53411,356364
201607,2016,3호선,도곡,186451,26950,213401
201607,2016,3호선,대치,323777,58612,382389
201607,2016,3호선,학여울,97398,13027,110425
201607,2016,3호선,대청,267117,49180,316297
201607,2016,3호선,일원,220419,55672,276091
201607,2016,3호선,수서,279759,80246,360005
201607,2016,3호선,가락시장,218211,63451,281662
201607,2016,3호선,경찰병원,193217,37091,230308
201607,2016,3호선,구파발,444864,86585,531449
201607,2016,4호선,당고개,330013,95139,425152
201607,2016,4호선,남태령,37926,8333,46259
201607,2016,4호선,노원,631834,90798,722632
201607,2016,4호선,창동,739499,183133,922632
201607,2016,4호선,쌍문,865278,165387,1030665
201607,2016,4호선,수유(강북구청),1130577,249112,1379689
201607,2016,4호선,미아,454507,129782,584289
201607,2016,4호선,미아사거리,837686,188893,1026579
201607,2016,4호선,길음,669637,147697,817334
201607,2016,4호선,성신여대입구,691081,103311,794392
201607,2016,4호선,한성대입구,398010,77615,475625
201607,2016,4호선,혜화,1145029,128181,1273210
201607,2016,4호선,동대문,655107,156607,811714
201607,2016,4호선,동대문역사문화공원,691820,64687,756507
201607,2016,4호선,충무로,836080,126688,962768
201607,2016,4호선,명동,1158027,69012,1227039
201607,2016,4호선,회현,715266,203466,918732
201607,2016,4호선,서울역,329990,39405,369395
201607,2016,4호선,숙대입구,440630,58980,499610
201607,2016,4호선,삼각지,116056,29637,145693
201607,2016,4호선,신용산,352522,51204,403726
201607,2016,4호선,이촌,240864,44901,285765
201607,2016,4호선,동작,56939,19380,76319
201607,2016,4호선,총신대입구,541782,137150,678932
201607,2016,4호선,사당,856729,91142,947871
201607,2016,4호선,상계,557239,115561,672800
201607,2016,5호선,방화,185037,45940,230977
201607,2016,5호선,마천,114120,47196,161316
201607,2016,5호선,김포공항,207939,27827,235766
201607,2016,5호선,송정,237295,62118,299413
201607,2016,5호선,마곡,99184,15448,114632
201607,2016,7호선,신중동,390767,45883,436650
201607,2016,7호선,부천시청,350061,42623,392684
201607,2016,7호선,상동,387252,41125,428377
201607,2016,7호선,삼산체육관,155419,22396,177815
201607,2016,7호선,굴포천,237193,31129,268322
201607,2016,7호선,부평구청,337577,29392,366969
201607,2016,8호선,암사,446855,85720,532575
201607,2016,8호선,모란,91865,47920,139785
201607,2016,8호선,강동구청,254533,58118,312651
201607,2016,8호선,몽촌토성,148415,35679,184094
201607,2016,8호선,잠실,326878,58026,384904
201607,2016,8호선,석촌,218171,56719,274890
201607,2016,8호선,송파,129501,33150,162651
201607,2016,8호선,가락시장,162862,44182,207044
201607,2016,8호선,문정,212951,31393,244344
201607,2016,8호선,장지,392229,55285,447514
201607,2016,8호선,복정,234305,36219,270524
201607,2016,8호선,산성,187009,40130,227139
201607,2016,8호선,남한산성입구,345137,70712,415849
201607,2016,8호선,단대오거리,305750,67592,373342
201607,2016,8호선,신흥,116944,49658,166602
201607,2016,8호선,수진,120300,39316,159616
201607,2016,8호선,천호,486055,88196,574251
201607,2016,9호선,개화,163989,32806,196795
201607,2016,9호선,김포공항,259288,18278,277566
201607,2016,9호선,신논현,885873,48411,934284
201607,2016,9호선,사평,71850,14140,85990
201607,2016,9호선,고속터미널,503759,52288,556047
201607,2016,9호선,신반포,83797,21112,104909
201607,2016,9호선,공항시장,69744,20972,90716
201607,2016,9호선,신방화,201313,41691,243004
201607,2016,9호선,마곡나루,67973,8839,76812
201607,2016,9호선,양천향교,185632,37553,223185
201607,2016,9호선,가양,519925,114710,634635
201607,2016,9호선,증미,178233,40240,218473
201607,2016,9호선,등촌,240622,76908,317530
201607,2016,9호선,염창,416486,55966,472452
201607,2016,9호선,신목동,107210,16547,123757
201607,2016,9호선,선유도,177937,25086,203023
201607,2016,9호선,당산,480811,59843,540654
201607,2016,9호선,국회의사당,412819,51340,464159
201607,2016,9호선,여의도,545526,40536,586062
201607,2016,9호선,샛강,131737,23877,155614
201607,2016,9호선,노량진,795074,78608,873682
201607,2016,2호선,잠실나루,459108,84793,543901
201607,2016,2호선,강변,1392256,141034,1533290
201607,2016,2호선,구의,636179,106003,742182
201607,2016,2호선,건대입구,1281581,92160,1373741
201607,2016,2호선,성수,672461,96129,768590
201607,2016,2호선,뚝섬,419083,63908,482991
201607,2016,2호선,한양대,258313,14202,272515
201607,2016,2호선,왕십리(성동구청),549540,59595,609135
201606,2016,5호선,애오개,173746,39419,213165
201606,2016,5호선,충정로,125015,16677,141692
201606,2016,5호선,서대문,457597,67928,525525
201606,2016,2호선,잠실나루,467074,88893,555967
201606,2016,2호선,잠실,2273770,210312,2484082
201606,2016,2호선,신천,698992,117764,816756
201606,2016,2호선,종합운동장,499668,58822,558490
201606,2016,2호선,삼성,1560030,126676,1686706
201606,2016,2호선,선릉,1488016,200442,1688458
201606,2016,2호선,역삼,1213359,153759,1367118
201606,2016,2호선,강남,2733657,163571,2897228
201606,2016,2호선,교대,1007595,166770,1174365
201606,2016,2호선,서초,612927,85645,698572
201606,2016,2호선,방배,563847,81645,645492
201606,2016,2호선,사당,1147014,205283,1352297
201606,2016,2호선,낙성대,846438,111164,957602
201606,2016,2호선,서울대입구,1395434,215690,1611124
201606,2016,2호선,봉천,576285,148415,724700
201606,2016,2호선,신림,1992157,246129,2238286
201606,2016,2호선,신대방,747698,135129,882827
201606,2016,2호선,구로디지털단지,1783020,166244,1949264
201606,2016,2호선,대림,863480,117874,981354
201606,2016,경부선,진위,46492,8000,54492
201606,2016,경부선,송탄,126874,25405,152279
201606,2016,경부선,서정리,142578,28247,170825
201606,2016,경부선,지제,25751,4182,29933
201606,2016,경부선,평택,375141,69736,444877
201606,2016,경부선,성환,131725,21041,152766
201606,2016,경부선,직산,25522,6025,31547
201606,2016,경부선,두정,175110,22477,197587
201606,2016,경부선,천안,221996,63774,285770
201606,2016,경부선,당정,204805,31440,236245
201606,2016,경부선,서동탄,42396,8848,51244
201606,2016,경부선,광명,24691,1501,26192
201606,2016,경부선,서울역,32,0,32
201606,2016,경부선,남영,331064,42250,373314
201606,2016,경부선,용산,1042900,142894,1185794
201606,2016,경부선,노량진,487401,50855,538256
201606,2016,경부선,대방,411135,76378,487513
201606,2016,경부선,영등포,1279846,273236,1553082
201606,2016,경부선,신도림,102868,21650,124518
201606,2016,경부선,가산디지털단지,467910,31256,499166
201606,2016,경원선,망월사,209171,68774,277945
201606,2016,경원선,창동,2,0,2
201606,2016,경원선,의정부,575316,127988,703304
201606,2016,경원선,가능,181031,63485,244516
201606,2016,경원선,녹양,127340,34497,161837
201606,2016,경원선,양주,238274,55119,293393
201606,2016,경원선,덕계,53140,17377,70517
201606,2016,경원선,덕정,191156,37290,228446
201606,2016,경원선,지행,184970,45993,230963
201606,2016,경원선,동두천 중앙,85891,39712,125603
201606,2016,경원선,보산,46645,15352,61997
201606,2016,경원선,동두천,53935,19430,73365
201606,2016,경원선,소요산,65301,87009,152310
201606,2016,경원선,방학,218155,104732,322887
201606,2016,경원선,도봉,139429,70806,210235
201606,2016,경원선,도봉산,104365,73484,177849
201606,2016,경원선,이촌,124284,31129,155413
201606,2016,경원선,서빙고,55485,16764,72249
201606,2016,경원선,한남,106519,34054,140573
201606,2016,경원선,옥수,1656,140,1796
201606,2016,경원선,응봉,46307,19302,65609
201606,2016,경원선,왕십리,459064,59198,518262
201606,2016,경원선,청량리(지상),334554,140945,475499
201606,2016,경원선,외대앞,331891,57838,389729
201606,2016,경원선,신이문,240652,65791,306443
201606,2016,경원선,석계,280426,65502,345928
201606,2016,경원선,광운대,262171,53835,316006
201606,2016,경원선,월계,145763,52217,197980
201606,2016,경원선,녹천,123803,39936,163739
201606,2016,경원선,회룡,282881,139648,422529
201606,2016,경의선,서울역,4037,559,4596
201606,2016,경의선,신촌,24745,3905,28650
201606,2016,경의선,효창공원앞,40421,10031,50452
201606,2016,경의선,공덕,54246,9590,63836
201606,2016,경의선,서강대,60991,9526,70517
201606,2016,경의선,홍대입구,41734,4639,46373
201606,2016,경의선,가좌,96771,42795,139566
201606,2016,경의선,디지털미디어시티,63272,10601,73873
201606,2016,경의선,수색,53174,17867,71041
201606,2016,경의선,화전,74257,8456,82713
201606,2016,경의선,강매,63511,15493,79004
201606,2016,경의선,행신,198046,34701,232747
201606,2016,경의선,능곡,88996,30850,119846
201606,2016,경의선,곡산,12101,5042,17143
201606,2016,경의선,백마,175981,32655,208636
201606,2016,경의선,풍산,116180,28683,144863
201606,2016,경의선,일산,242351,57932,300283
201606,2016,경의선,탄현,204174,39114,243288
201606,2016,경의선,야당,74780,18120,92900
201606,2016,경의선,운정,122551,30284,152835
201606,2016,경의선,금릉,127199,25366,152565
201606,2016,경의선,금촌,184397,44778,229175
201606,2016,경의선,월롱,62603,8657,71260
201606,2016,경의선,파주,42845,8128,50973
201606,2016,경의선,문산,149941,47559,197500
201606,2016,경인선,개봉,585463,156722,742185
201606,2016,경인선,역곡,806031,138486,944517
201606,2016,경인선,온수,187451,45959,233410
201606,2016,경인선,도원,104569,35526,140095
201606,2016,경인선,간석,170243,47600,217843
201606,2016,경인선,부개,273689,64789,338478
201606,2016,경인선,소사,322997,89159,412156
201606,2016,경인선,구일,204012,34857,238869
201606,2016,경인선,인천,112863,48800,161663
201606,2016,경인선,동인천,471379,124812,596191
201606,2016,경인선,제물포,259378,50605,309983
201606,2016,경인선,주안,789991,127266,917257
201606,2016,경인선,도화,87216,34314,121530
201606,2016,경인선,중동,254870,67085,321955
201606,2016,경인선,동암,643856,138444,782300
201606,2016,안산선,안산,505538,47280,552818
201606,2016,안산선,초지,123825,16516,140341
201606,2016,안산선,수리산,114174,33756,147930
201606,2016,안산선,중앙,475681,57001,532682
201606,2016,안산선,한대앞,263476,42446,305922
201606,2016,안산선,상록수,583776,86766,670542
201606,2016,안산선,반월,133557,29788,163345
201606,2016,안산선,대야미,104335,24177,128512
201606,2016,안산선,산본,473085,105169,578254
201606,2016,수인선,원인재,113885,24731,138616
201606,2016,수인선,신포,37506,10386,47892
201606,2016,수인선,숭의,56375,19783,76158
201606,2016,수인선,인하대,98277,13462,111739
201606,2016,수인선,송도,74485,20586,95071
201606,2016,수인선,연수,121372,23899,145271
201606,2016,수인선,인천,23386,10023,33409
201606,2016,수인선,남동인더스파크,55394,4860,60254
201606,2016,수인선,호구포,83701,15838,99539
201606,2016,수인선,인천논현,150447,29164,179611
201606,2016,수인선,소래포구,116613,70590,187203
201606,2016,수인선,월곶,69940,14132,84072
201606,2016,수인선,달월,2244,1150,3394
201606,2016,분당선,한티,367574,66470,434044
201606,2016,분당선,수원시청,286500,33436,319936
201606,2016,분당선,매탄권선,120824,13811,134635
201606,2016,분당선,망포,342175,28852,371027
201606,2016,분당선,영통,245854,26900,272754
201606,2016,분당선,청명,113371,16377,129748
201606,2016,분당선,상갈,132080,30224,162304
201606,2016,분당선,기흥,213167,30895,244062
201606,2016,분당선,신갈,109363,30625,139988
201606,2016,분당선,구성,118633,40407,159040
201606,2016,분당선,죽전,437771,83273,521044
201606,2016,분당선,보정,64311,25606,89917
201606,2016,분당선,이매,128816,35692,164508
201606,2016,분당선,오리,360387,95488,455875
201606,2016,분당선,미금,481899,121956,603855
201606,2016,분당선,정자,426736,80964,507700
201606,2016,분당선,수내,337354,79242,416596
201606,2016,분당선,서현,663518,128459,791977
201606,2016,분당선,야탑,705959,153654,859613
201606,2016,분당선,모란,600073,161880,761953
201606,2016,분당선,태평,365283,85638,450921
201606,2016,분당선,가천대,280997,23376,304373
201606,2016,분당선,선정릉,199543,40774,240317
201606,2016,분당선,강남구청,222641,37360,260001
201606,2016,분당선,압구정로데오,405254,39267,444521
201606,2016,분당선,서울숲,178559,24493,203052
201606,2016,분당선,수원,276559,25938,302497
201606,2016,분당선,복정,4,0,4
201606,2016,분당선,수서,208680,48919,257599
201606,2016,분당선,대모산입구,87473,30488,117961
201606,2016,분당선,개포동,90766,21622,112388
201606,2016,분당선,구룡,48697,18280,66977
201606,2016,분당선,도곡,161641,38486,200127
201606,2016,분당선,매교,69129,17898,87027
201606,2016,분당선,선릉,232855,26454,259309
201606,2016,과천선,범계,831836,108600,940436
201606,2016,과천선,정부과천청사,310719,63999,374718
201606,2016,과천선,인덕원,677001,101630,778631
201606,2016,과천선,평촌,420277,60939,481216
201606,2016,과천선,선바위,245696,33889,279585
201606,2016,과천선,경마공원,171750,61723,233473
201606,2016,과천선,대공원,155563,56473,212036
201606,2016,과천선,과천,130274,36476,166750
201606,2016,공항철도 1호선,김포공항,282509,17405,299914
201606,2016,공항철도 1호선,디지털미디어시티,321401,20454,341855
201606,2016,공항철도 1호선,서울역,286860,31701,318561
201606,2016,공항철도 1호선,계양,298565,31492,330057
201606,2016,공항철도 1호선,검암,479335,45292,524627
201606,2016,공항철도 1호선,청라국제도시,134905,8694,143599
201606,2016,공항철도 1호선,운서,136547,25018,161565
201606,2016,공항철도 1호선,공항화물청사,66809,7603,74412
201606,2016,공항철도 1호선,인천국제공항,371254,42354,413608
201606,2016,공항철도 1호선,영종,34908,10137,45045
201606,2016,공항철도 1호선,공덕,40091,5945,46036
201606,2016,공항철도 1호선,홍대입구,247041,17568,264609
201606,2016,경춘선,신내,16166,7106,23272
201606,2016,경춘선,갈매,14503,5169,19672
201606,2016,경춘선,별내,59214,16070,75284
201606,2016,경춘선,퇴계원,85688,23992,109680
201606,2016,경춘선,사릉,96199,18955,115154
201606,2016,경춘선,금곡,33146,15276,48422
201606,2016,경춘선,평내호평,140294,41599,181893
201606,2016,경춘선,천마산,25795,13220,39015
201606,2016,경춘선,마석,88170,31005,119175
201606,2016,경춘선,대성리,29698,6009,35707
201606,2016,경춘선,청평,70995,18614,89609
201606,2016,경춘선,상천,11519,6884,18403
201606,2016,경춘선,가평,78974,16338,95312
201606,2016,경춘선,굴봉산,8478,2684,11162
201606,2016,경춘선,백양리,3669,1322,4991
201606,2016,경춘선,김유정,15007,4095,19102
201606,2016,경춘선,강촌,26090,5776,31866
201606,2016,경춘선,남춘천,76174,24049,100223
201606,2016,경춘선,춘천,57897,22581,80478
201606,2016,7호선,신풍,299409,68000,367409
201606,2016,7호선,보라매,256679,43561,300240
201606,2016,7호선,신대방삼거리,403131,91878,495009
201606,2016,7호선,장승배기,259333,75690,335023
201606,2016,7호선,상도,291158,64543,355701
201606,2016,7호선,숭실대입구,445389,60778,506167
201606,2016,7호선,남성,287649,68918,356567
201606,2016,7호선,이수,455637,78214,533851
201606,2016,7호선,내방,371260,62605,433865
201606,2016,7호선,고속터미널,580631,79257,659888
201606,2016,7호선,반포,167888,30898,198786
201606,2016,7호선,논현,538836,50795,589631
201606,2016,7호선,학동,594684,62646,657330
201606,2016,7호선,강남구청,416442,48330,464772
201606,2016,7호선,청담,572374,73290,645664
201606,2016,7호선,뚝섬유원지,291650,46310,337960
201606,2016,7호선,건대입구,460282,50713,510995
201606,2016,7호선,어린이대공원,453597,46294,499891
201606,2016,7호선,군자,383720,77883,461603
201606,2016,7호선,중곡,260968,60549,321517
201606,2016,7호선,용마산,167389,36027,203416
201606,2016,7호선,사가정,408441,91891,500332
201606,2016,7호선,면목,416866,81251,498117
201606,2016,7호선,상봉,467803,72902,540705
201606,2016,7호선,중화,301395,59702,361097
201606,2016,7호선,먹골,269128,57319,326447
201606,2016,7호선,태릉입구,242472,40013,282485
201606,2016,7호선,공릉,339071,68550,407621
201606,2016,7호선,하계,528838,106041,634879
201606,2016,7호선,중계,411732,93783,505515
201606,2016,7호선,노원,536004,113139,649143
201606,2016,7호선,마들,306782,73914,380696
201606,2016,7호선,수락산,354249,91774,446023
201606,2016,7호선,도봉산,307478,67508,374986
201606,2016,7호선,장암,74199,10083,84282
201606,2016,6호선,역촌,83585,35104,118689
201606,2016,6호선,화랑대,361714,45306,407020
201606,2016,6호선,태릉입구,134783,27042,161825
201606,2016,6호선,석계,337138,73945,411083
201606,2016,6호선,돌곶이,239087,62513,301600
201606,2016,6호선,상월곡,159711,37611,197322
201606,2016,6호선,월곡,326818,69715,396533
201606,2016,6호선,고려대,271198,36026,307224
201606,2016,6호선,안암,383262,32126,415388
201606,2016,6호선,보문,229693,38296,267989
201606,2016,6호선,창신,88123,17492,105615
201606,2016,6호선,동묘앞,214180,66546,280726
201606,2016,6호선,신당,209649,32430,242079
201606,2016,6호선,청구,101587,18864,120451
201606,2016,6호선,약수,88932,23234,112166
201606,2016,6호선,버티고개,63434,14645,78079
201606,2016,6호선,한강진,176880,13715,190595
201606,2016,6호선,이태원,453666,37617,491283
201606,2016,6호선,녹사평(용산구청),210482,22328,232810
201606,2016,6호선,삼각지,214856,22161,237017
201606,2016,6호선,효창공원앞,190586,43201,233787
201606,2016,6호선,공덕,468254,71834,540088
201606,2016,6호선,대흥,218779,45380,264159
201606,2016,6호선,광흥창,238167,60112,298279
201606,2016,6호선,상수,302213,22482,324695
201606,2016,6호선,합정,373533,38293,411826
201606,2016,6호선,망원,306312,83658,389970
201606,2016,6호선,마포구청,342827,81166,423993
201606,2016,6호선,월드컵경기장,193122,55541,248663
201606,2016,6호선,디지털미디어시티,394940,62641,457581
201606,2016,6호선,증산,257207,69895,327102
201606,2016,6호선,새절,347239,85573,432812
201606,2016,6호선,구산,201768,55296,257064
201606,2016,6호선,연신내,20,3,23
201606,2016,6호선,독바위,69490,21419,90909
201606,2016,6호선,불광,136065,38973,175038
201606,2016,6호선,봉화산(서울의료원),236647,52211,288858
201606,2016,6호선,응암,441647,108436,550083
201606,2016,5호선,개화산,148790,34439,183229
201606,2016,5호선,거여,169090,48675,217765
201606,2016,5호선,개롱,173444,42436,215880
201606,2016,5호선,오금,100126,17620,117746
201606,2016,5호선,방이,179845,40789,220634
201606,2016,5호선,올림픽공원,176229,37762,213991
201606,2016,5호선,둔촌동,332229,78502,410731
201606,2016,5호선,상일동,265144,60654,325798
201606,2016,5호선,고덕,204103,58739,262842
201606,2016,5호선,명일,196201,61291,257492
201606,2016,5호선,굽은다리,247052,63947,310999
201606,2016,5호선,길동,178297,58039,236336
201606,2016,5호선,강동,498585,92341,590926
201606,2016,5호선,천호,493659,146229,639888
201606,2016,5호선,광나루,380040,66223,446263
201606,2016,5호선,아차산,375801,91690,467491
201606,2016,5호선,종로3가,292829,120775,413604
201606,2016,5호선,광화문,990541,82163,1072704
201606,2016,5호선,군자,301166,36343,337509
201606,2016,5호선,장한평,472845,97538,570383
201606,2016,5호선,답십리,422037,84443,506480
201606,2016,5호선,마장,152222,42122,194344
201606,2016,5호선,왕십리(성동구청),129396,25012,154408
201606,2016,5호선,행당,214411,48657,263068
201606,2016,5호선,신금호,142736,35575,178311
201606,2016,5호선,청구,99684,25921,125605
201606,2016,5호선,동대문역사문화공원,80365,11292,91657
201606,2016,5호선,을지로4가,114876,43362,158238
201606,2016,경인선,오류동,290631,86930,377561
201606,2016,경인선,백운,226641,64783,291424
201606,2016,경인선,부평,1050824,141302,1192126
201606,2016,경인선,송내,931178,120956,1052134
201606,2016,경인선,부천,1094838,210661,1305499
201606,2016,1호선,서울역,1665738,221157,1886895
201606,2016,1호선,시청,677099,96838,773937
201606,2016,1호선,종각,1204539,153420,1357959
201606,2016,1호선,종로3가,704957,352937,1057894
201606,2016,1호선,동묘앞,170679,140899,311578
201606,2016,1호선,동대문,344007,138300,482307
201606,2016,1호선,신설동,385108,120693,505801
201606,2016,1호선,제기동,284663,302902,587565
201606,2016,1호선,청량리(지하),552052,347697,899749
201606,2016,1호선,종로5가,553988,270096,824084
201606,2016,2호선,시청,724074,61667,785741
201606,2016,2호선,용두,46443,21971,68414
201606,2016,2호선,을지로3가,528493,92918,621411
201606,2016,2호선,을지로4가,298572,95225,393797
201606,2016,2호선,동대문역사문화공원,527692,60882,588574
201606,2016,2호선,신당,357008,108393,465401
201606,2016,2호선,상왕십리,273729,60199,333928
201606,2016,2호선,왕십리(성동구청),564234,60995,625229
201606,2016,2호선,한양대,342287,15577,357864
201606,2016,2호선,뚝섬,431760,66640,498400
201606,2016,2호선,성수,676817,99618,776435
201606,2016,2호선,건대입구,1284478,95331,1379809
201606,2016,2호선,구의,640845,110218,751063
201606,2016,2호선,강변,1363728,148964,1512692
201606,2016,2호선,신도림,1698919,198339,1897258
201606,2016,2호선,문래,492636,83586,576222
201606,2016,2호선,영등포구청,558668,106334,665002
201606,2016,2호선,당산,611087,69010,680097
201606,2016,2호선,합정,947253,75461,1022714
201606,2016,2호선,홍대입구,2142614,120946,2263560
201606,2016,2호선,신촌,1356548,143143,1499691
201606,2016,2호선,이대,596475,79051,675526
201606,2016,2호선,아현,257245,65498,322743
201606,2016,2호선,충정로,308130,54145,362275
201606,2016,2호선,용답,63018,16668,79686
201606,2016,2호선,신답,31701,11153,42854
201606,2016,2호선,신설동,86217,33552,119769
201606,2016,2호선,도림천,25270,6359,31629
201606,2016,2호선,양천구청,176959,46933,223892
201606,2016,2호선,신정네거리,256792,65938,322730
201606,2016,2호선,을지로입구,1433090,116049,1549139
201606,2016,3호선,지축,30283,13079,43362
201606,2016,3호선,오금,183326,25748,209074
201606,2016,3호선,연신내,1041011,260204,1301215
201606,2016,3호선,불광,459831,150539,610370
201606,2016,3호선,녹번,344947,72634,417581
201606,2016,3호선,홍제,476370,153489,629859
201606,2016,3호선,무악재,96900,34109,131009
201606,2016,3호선,독립문,166560,73961,240521
201606,2016,3호선,경복궁,679133,90453,769586
201606,2016,3호선,안국,687512,130863,818375
201606,2016,3호선,종로3가,188101,63459,251560
201606,2016,3호선,을지로3가,214536,60692,275228
201606,2016,3호선,충무로,55,5,60
201606,2016,3호선,동대입구,316030,42743,358773
201606,2016,3호선,약수,359904,88717,448621
201606,2016,3호선,금호,191245,53410,244655
201606,2016,3호선,옥수,258061,59946,318007
201606,2016,3호선,압구정,943410,150000,1093410
201606,2016,3호선,신사,891814,73145,964959
201606,2016,3호선,잠원,143426,33330,176756
201606,2016,3호선,고속터미널,1514292,178659,1692951
201606,2016,3호선,교대,367731,67610,435341
201606,2016,9호선,등촌,241364,79696,321060
201606,2016,안산선,신길온천,46255,10253,56508
201606,2016,안산선,정왕,273526,25739,299265
201606,2016,안산선,오이도,231104,34069,265173
201606,2016,안산선,고잔,250922,37318,288240
201606,2016,일산선,삼송,325643,76275,401918
201606,2016,일산선,주엽,198312,99911,298223
201606,2016,일산선,정발산,216362,61113,277475
201606,2016,일산선,마두,175318,78570,253888
201606,2016,일산선,백석,262550,75366,337916
201606,2016,일산선,대곡,37372,12518,49890
201606,2016,일산선,원흥,155489,37189,192678
201606,2016,일산선,대화,369184,95336,464520
201606,2016,일산선,원당,296736,88875,385611
201606,2016,일산선,화정,480161,134955,615116
201606,2016,장항선,신창,55710,8017,63727
201606,2016,장항선,온양온천,93839,55634,149473
201606,2016,장항선,배방,24161,7828,31989
201606,2016,장항선,아산,71149,8220,79369
201606,2016,장항선,쌍용동,72616,16417,89033
201606,2016,장항선,봉명,28905,14088,42993
201606,2016,중앙선,회기,805067,131932,936999
201606,2016,중앙선,용문,58122,52074,110196
201606,2016,중앙선,상봉,144710,37688,182398
201606,2016,중앙선,망우,195392,69693,265085
201606,2016,중앙선,양원,48676,17669,66345
201606,2016,중앙선,구리,340486,85045,425531
201606,2016,중앙선,도농,231620,58602,290222
201606,2016,중앙선,양정,19646,9175,28821
201606,2016,중앙선,덕소,154170,50772,204942
201606,2016,중앙선,도심,63641,21812,85453
201606,2016,중앙선,팔당,22518,6949,29467
201606,2016,중앙선,운길산,32496,12653,45149
201606,2016,중앙선,양수,50972,21760,72732
201606,2016,중앙선,신원,5877,3691,9568
201606,2016,중앙선,국수,21411,9130,30541
201606,2016,중앙선,아신,21894,7196,29090
201606,2016,중앙선,오빈,7272,4166,11438
201606,2016,중앙선,양평,88307,35610,123917
201606,2016,중앙선,원덕,8080,6317,14397
201606,2016,중앙선,중랑,140584,52932,193516
201606,2016,9호선,증미,177128,40663,217791
201606,2016,9호선,가양,521907,117412,639319
201606,2016,9호선,양천향교,192548,38364,230912
201606,2016,9호선,마곡나루,66032,8765,74797
201606,2016,9호선,신방화,204819,42239,247058
201606,2016,9호선,공항시장,68799,21058,89857
201606,2016,9호선,신반포,84959,22326,107285
201606,2016,9호선,고속터미널,475121,53219,528340
201606,2016,9호선,사평,70855,14282,85137
201606,2016,9호선,신논현,805237,48603,853840
201606,2016,9호선,김포공항,249169,17680,266849
201606,2016,9호선,개화,164505,34910,199415
201606,2016,8호선,천호,484424,89330,573754
201606,2016,8호선,수진,118182,38548,156730
201606,2016,8호선,신흥,116720,51184,167904
201606,2016,8호선,단대오거리,325941,70205,396146
201606,2016,8호선,남한산성입구,376918,74972,451890
201606,2016,8호선,산성,196346,41822,238168
201606,2016,8호선,복정,257551,37666,295217
201606,2016,8호선,장지,385632,56900,442532
201606,2016,8호선,문정,209539,32108,241647
201606,2016,8호선,가락시장,158614,44341,202955
201606,2016,8호선,송파,131997,34165,166162
201606,2016,8호선,석촌,216797,57910,274707
201606,2016,8호선,잠실,311378,56122,367500
201606,2016,8호선,몽촌토성,159999,39569,199568
201606,2016,8호선,강동구청,257551,59621,317172
201606,2016,8호선,모란,92342,50973,143315
201606,2016,8호선,암사,451012,87088,538100
201606,2016,7호선,부평구청,342571,29856,372427
201606,2016,7호선,굴포천,237463,31843,269306
201606,2016,7호선,삼산체육관,150751,23917,174668
201606,2016,7호선,상동,379816,42881,422697
201606,2016,7호선,부천시청,333831,42939,376770
201606,2016,7호선,신중동,389557,46610,436167
201606,2016,7호선,춘의,227823,27462,255285
201606,2016,7호선,부천종합운동장,151047,18312,169359
201606,2016,7호선,까치울,178574,25587,204161
201606,2016,7호선,온수,306812,33534,340346
201606,2016,7호선,천왕,214683,43127,257810
201606,2016,7호선,광명사거리,708290,146504,854794
201606,2016,7호선,철산,659072,98460,757532
201606,2016,7호선,가산디지털단지,1134915,73523,1208438
201606,2016,7호선,남구로,439033,59011,498044
201606,2016,7호선,대림,299028,35611,334639
201606,2016,9호선,염창,417417,56717,474134
201606,2016,9호선,신목동,107736,17522,125258
201606,2016,9호선,선유도,179491,25523,205014
201606,2016,9호선,당산,476835,61341,538176
201606,2016,9호선,국회의사당,409820,53287,463107
201606,2016,9호선,여의도,547264,41977,589241
201606,2016,9호선,샛강,128334,24862,153196
201606,2016,9호선,노량진,763152,81223,844375
201606,2016,9호선,노들,119971,30474,150445
201606,2016,9호선,흑석(중앙대입구),277613,54828,332441
201606,2016,9호선,동작,64274,24374,88648
201606,2016,9호선,구반포,75211,23159,98370
201606,2016,9호선2단계,언주,198026,22026,220052
201606,2016,9호선2단계,봉은사,321665,33856,355521
201606,2016,9호선2단계,삼성중앙,117786,18071,135857
201606,2016,9호선2단계,선정릉,177602,18798,196400
201606,2016,9호선2단계,종합운동장,152839,12677,165516
201606,2016,경부선,구로,579524,93141,672665
201606,2016,경부선,신길,286859,47959,334818
201606,2016,경부선,금천구청,288291,76172,364463
201606,2016,경부선,석수,319700,48500,368200
201606,2016,경부선,관악,228369,56223,284592
201606,2016,경부선,안양,788161,117654,905815
201606,2016,경부선,명학,283816,42139,325955
201606,2016,경부선,금정,783512,106296,889808
201606,2016,경부선,군포,195409,34501,229910
201606,2016,경부선,의왕,233269,39732,273001
201606,2016,경부선,성균관대,450795,51432,502227
201606,2016,경부선,화서,230093,43593,273686
201606,2016,경부선,수원,1221574,145239,1366813
201606,2016,경부선,독산,428503,66003,494506
201606,2016,경부선,세류,111532,18767,130299
201606,2016,경부선,병점,436940,57847,494787
201606,2016,경부선,세마,68484,13704,82188
201606,2016,경부선,오산대,81977,13978,95955
201606,2016,경부선,오산,274132,41981,316113
201606,2016,3호선,남부터미널,944643,132026,1076669
201606,2016,3호선,양재,1087028,158541,1245569
201606,2016,3호선,매봉,304678,56206,360884
201606,2016,3호선,도곡,192427,29319,221746
201606,2016,3호선,대치,313583,64607,378190
201606,2016,3호선,학여울,58447,14525,72972
201606,2016,3호선,대청,273367,51337,324704
201606,2016,3호선,일원,228147,60021,288168
201606,2016,3호선,수서,288287,83473,371760
201606,2016,3호선,가락시장,218369,64777,283146
201606,2016,3호선,경찰병원,192711,36884,229595
201606,2016,3호선,구파발,454167,89517,543684
201606,2016,4호선,당고개,330784,95859,426643
201606,2016,4호선,남태령,31010,8430,39440
201606,2016,4호선,노원,624393,93893,718286
201606,2016,4호선,창동,745998,187901,933899
201606,2016,4호선,쌍문,875700,168981,1044681
201606,2016,4호선,수유(강북구청),1165731,254600,1420331
201606,2016,4호선,미아,473437,132411,605848
201606,2016,4호선,미아사거리,831177,191969,1023146
201606,2016,4호선,길음,728291,156065,884356
201606,2016,4호선,성신여대입구,732098,105397,837495
201606,2016,4호선,한성대입구,442657,81693,524350
201606,2016,4호선,혜화,1136623,131768,1268391
201606,2016,4호선,동대문,655550,167159,822709
201606,2016,4호선,동대문역사문화공원,660524,67233,727757
201606,2016,4호선,충무로,897072,129943,1027015
201606,2016,4호선,명동,1164364,73639,1238003
201606,2016,4호선,회현,725778,224154,949932
201606,2016,4호선,서울역,336433,39976,376409
201606,2016,4호선,숙대입구,491139,60361,551500
201606,2016,4호선,삼각지,119792,32095,151887
201606,2016,4호선,신용산,352469,53800,406269
201606,2016,4호선,이촌,236177,46650,282827
201606,2016,4호선,동작,75275,28478,103753
201606,2016,4호선,총신대입구,548720,141916,690636
201606,2016,4호선,사당,889891,96636,986527
201606,2016,4호선,상계,569413,120004,689417
201606,2016,5호선,방화,187536,47412,234948
201606,2016,5호선,마천,122059,48342,170401
201606,2016,5호선,김포공항,197791,25520,223311
201606,2016,5호선,송정,240992,65289,306281
201606,2016,5호선,마곡,99927,16470,116397
201606,2016,5호선,발산,308854,57833,366687
201606,2016,5호선,우장산,415920,75489,491409
201606,2016,5호선,화곡,763812,137786,901598
201606,2016,5호선,까치산,770150,148768,918918
201606,2016,5호선,신정,395082,58211,453293
201606,2016,5호선,목동,490855,82452,573307
201606,2016,5호선,오목교,672630,82268,754898
201606,2016,5호선,양평,159898,27555,187453
201606,2016,5호선,영등포구청,82584,18790,101374
201606,2016,5호선,영등포시장,181674,73945,255619
201606,2016,5호선,신길,85054,11934,96988
201606,2016,5호선,여의도,648315,54987,703302
201606,2016,5호선,여의나루,376510,32844,409354
201606,2016,5호선,마포,382841,64009,446850
201606,2016,5호선,공덕,347349,45746,393095
201605,2016,3호선,지축,31183,13553,44736
201605,2016,3호선,연신내,1088481,265145,1353626
201605,2016,3호선,불광,484160,153036,637196
201605,2016,3호선,녹번,360035,75871,435906
201605,2016,3호선,홍제,516314,158972,675286
201605,2016,3호선,무악재,101558,34265,135823
201605,2016,3호선,독립문,182091,77306,259397
201605,2016,3호선,경복궁,753757,97748,851505
201605,2016,3호선,안국,756034,134957,890991
201605,2016,3호선,종로3가,197422,63751,261173
201605,2016,3호선,을지로3가,216578,60043,276621
201605,2016,3호선,충무로,59,5,64
201605,2016,3호선,동대입구,363434,41704,405138
201605,2016,3호선,약수,370709,89323,460032
201605,2016,3호선,금호,198382,55096,253478
201605,2016,3호선,옥수,269516,60789,330305
201605,2016,3호선,압구정,930391,153340,1083731
201605,2016,3호선,신사,896406,73498,969904
201605,2016,3호선,잠원,145337,32507,177844
201605,2016,3호선,고속터미널,1663452,185272,1848724
201605,2016,3호선,교대,377362,65535,442897
201605,2016,3호선,남부터미널,992764,136248,1129012
201605,2016,3호선,양재,1131470,164476,1295946
201605,2016,3호선,매봉,306915,55449,362364
201605,2016,3호선,도곡,199653,29179,228832
201605,2016,3호선,대치,324970,64774,389744
201605,2016,3호선,학여울,103658,13985,117643
201605,2016,3호선,대청,281757,51582,333339
201605,2016,3호선,일원,234924,62435,297359
201605,2016,3호선,수서,293933,84669,378602
201605,2016,3호선,가락시장,222916,64364,287280
201605,2016,3호선,경찰병원,197813,36923,234736
201605,2016,3호선,구파발,480809,93911,574720
201605,2016,4호선,당고개,349231,99983,449214
201605,2016,4호선,남태령,33575,8925,42500
201605,2016,4호선,노원,662722,95919,758641
201605,2016,4호선,창동,781378,195254,976632
201605,2016,4호선,쌍문,908941,173884,1082825
201605,2016,4호선,수유(강북구청),1239506,263017,1502523
201605,2016,4호선,미아,499448,139015,638463
201605,2016,4호선,미아사거리,880425,198851,1079276
201605,2016,4호선,길음,799322,154795,954117
201605,2016,4호선,성신여대입구,794137,108060,902197
201605,2016,4호선,한성대입구,496032,86702,582734
201605,2016,4호선,혜화,1293263,134094,1427357
201605,2016,4호선,동대문,691123,171528,862651
201605,2016,4호선,동대문역사문화공원,684292,69921,754213
201605,2016,4호선,충무로,955759,131360,1087119
201605,2016,4호선,명동,1226497,75338,1301835
201605,2016,4호선,회현,750189,226109,976298
201605,2016,4호선,서울역,342273,41441,383714
201605,2016,4호선,숙대입구,538061,61573,599634
201605,2016,4호선,삼각지,122712,31259,153971
201605,2016,4호선,신용산,365844,54672,420516
201605,2016,4호선,이촌,257418,48661,306079
201605,2016,4호선,동작,83613,23128,106741
201605,2016,4호선,총신대입구,573428,143915,717343
201605,2016,4호선,사당,944572,97773,1042345
201605,2016,4호선,상계,596373,122341,718714
201605,2016,5호선,방화,198678,48074,246752
201605,2016,5호선,마천,131257,49944,181201
201605,2016,5호선,김포공항,209039,27064,236103
201605,2016,5호선,송정,254379,65195,319574
201605,2016,5호선,마곡,100614,16491,117105
201605,2016,5호선,발산,320497,58718,379215
201605,2016,5호선,우장산,432983,78042,511025
201605,2016,5호선,화곡,792426,138761,931187
201605,2016,5호선,까치산,794418,151733,946151
201605,2016,5호선,신정,405666,59536,465202
201605,2016,5호선,목동,504572,83741,588313
201605,2016,5호선,오목교,708511,84771,793282
201605,2016,5호선,양평,162052,27923,189975
201605,2016,5호선,영등포구청,82820,18574,101394
201605,2016,5호선,영등포시장,185873,75171,261044
201605,2016,5호선,신길,86307,12164,98471
201605,2016,5호선,여의도,645061,54524,699585
201605,2016,5호선,여의나루,429831,33586,463417
201605,2016,5호선,마포,389231,65286,454517
201605,2016,5호선,공덕,351769,46311,398080
201605,2016,5호선,애오개,178722,40559,219281
201605,2016,5호선,충정로,130995,16770,147765
201605,2016,5호선,서대문,475030,70995,546025
201605,2016,5호선,광화문,1043310,86620,1129930
201605,2016,5호선,종로3가,308831,123224,432055
201605,2016,5호선,을지로4가,116923,43396,160319
201605,2016,5호선,동대문역사문화공원,77294,11238,88532
201605,2016,5호선,청구,104682,26518,131200
201605,2016,5호선,신금호,144733,36055,180788
201605,2016,5호선,행당,220590,49346,269936
201605,2016,5호선,왕십리(성동구청),135949,25280,161229
201605,2016,5호선,마장,160218,44044,204262
201605,2016,5호선,답십리,433715,84588,518303
201605,2016,5호선,장한평,484608,99665,584273
201605,2016,5호선,군자,310175,36870,347045
201605,2016,5호선,아차산,419129,96373,515502
201605,2016,5호선,광나루,408717,69203,477920
201605,2016,5호선,천호,529271,148733,678004
201605,2016,5호선,강동,522851,94204,617055
201605,2016,5호선,길동,184273,59160,243433
201605,2016,5호선,굽은다리,257246,64113,321359
201605,2016,5호선,명일,207420,62088,269508
201605,2016,5호선,고덕,213147,59227,272374
201605,2016,5호선,상일동,277788,61026,338814
201605,2016,5호선,둔촌동,347155,78385,425540
201605,2016,5호선,올림픽공원,241361,37957,279318
201605,2016,5호선,방이,184539,40971,225510
201605,2016,5호선,오금,102610,17243,119853
201605,2016,5호선,개롱,178887,42779,221666
201605,2016,5호선,거여,177733,49285,227018
201605,2016,5호선,개화산,152937,34720,187657
201605,2016,6호선,응암,462660,111349,574009
201605,2016,6호선,봉화산(서울의료원),245112,53434,298546
201605,2016,6호선,불광,144666,39164,183830
201605,2016,6호선,독바위,72669,21482,94151
201605,2016,6호선,연신내,15,2,17
201605,2016,6호선,구산,209272,56257,265529
201605,2016,6호선,새절,374530,88294,462824
201605,2016,6호선,증산,271143,71333,342476
201605,2016,6호선,디지털미디어시티,404398,63548,467946
201605,2016,6호선,월드컵경기장,200320,61632,261952
201605,2016,6호선,마포구청,353353,82492,435845
201605,2016,6호선,망원,314550,85862,400412
201605,2016,6호선,합정,384663,40046,424709
201605,2016,6호선,상수,320900,23604,344504
201605,2016,6호선,광흥창,240774,60429,301203
201605,2016,6호선,대흥,233045,47544,280589
201605,2016,6호선,공덕,473788,73488,547276
201605,2016,6호선,효창공원앞,206542,44382,250924
201605,2016,6호선,삼각지,229253,21200,250453
201605,2016,6호선,녹사평(용산구청),227501,22961,250462
201605,2016,6호선,이태원,484186,38543,522729
201605,2016,6호선,한강진,182159,14021,196180
201605,2016,6호선,버티고개,66553,15099,81652
201605,2016,6호선,약수,92800,23707,116507
201605,2016,6호선,청구,104389,19077,123466
201605,2016,6호선,신당,215175,32701,247876
201605,2016,6호선,동묘앞,225789,69725,295514
201605,2016,6호선,창신,93920,18203,112123
201605,2016,6호선,보문,240233,39963,280196
201605,2016,6호선,안암,455497,32527,488024
201605,2016,6호선,고려대,299841,37842,337683
201605,2016,6호선,월곡,357322,72343,429665
201605,2016,6호선,상월곡,172775,38682,211457
201605,2016,6호선,돌곶이,250666,62005,312671
201605,2016,6호선,석계,357707,75415,433122
201605,2016,6호선,태릉입구,148773,29787,178560
201605,2016,6호선,화랑대,390712,46897,437609
201605,2016,6호선,역촌,86425,35229,121654
201605,2016,7호선,장암,76732,10016,86748
201605,2016,7호선,도봉산,329267,70865,400132
201605,2016,7호선,수락산,377923,95033,472956
201605,2016,7호선,마들,319642,75164,394806
201605,2016,7호선,노원,563132,115607,678739
201605,2016,7호선,중계,432469,96178,528647
201605,2016,7호선,하계,565757,110221,675978
201605,2016,7호선,공릉,372973,70315,443288
201605,2016,7호선,태릉입구,283089,43660,326749
201605,2016,7호선,먹골,284172,59993,344165
201605,2016,7호선,중화,320219,62914,383133
201605,2016,7호선,상봉,487231,72954,560185
201605,2016,7호선,면목,449386,83527,532913
201605,2016,7호선,사가정,431094,95315,526409
201605,2016,7호선,용마산,173220,37268,210488
201605,2016,7호선,중곡,271878,61039,332917
201605,2016,7호선,군자,395504,78340,473844
201605,2016,7호선,어린이대공원,607534,52671,660205
201605,2016,7호선,건대입구,510088,52886,562974
201605,2016,7호선,뚝섬유원지,340715,47415,388130
201605,2016,7호선,청담,581421,74573,655994
201605,2016,7호선,강남구청,425889,48873,474762
201605,2016,7호선,학동,601970,62687,664657
201605,2016,7호선,논현,539789,51649,591438
201605,2016,7호선,반포,174304,31494,205798
201605,2016,7호선,고속터미널,624790,82394,707184
201605,2016,7호선,내방,378803,64076,442879
201605,2016,7호선,이수,465355,78860,544215
201605,2016,7호선,남성,300615,70855,371470
201605,2016,7호선,숭실대입구,503974,61806,565780
201605,2016,7호선,상도,311827,64323,376150
201605,2016,7호선,장승배기,265902,76348,342250
201605,2016,7호선,신대방삼거리,413303,93040,506343
201605,2016,7호선,보라매,268148,46465,314613
201605,2016,7호선,신풍,315302,68985,384287
201605,2016,7호선,대림,319597,36354,355951
201605,2016,7호선,남구로,452159,60484,512643
201605,2016,7호선,가산디지털단지,1149318,74644,1223962
201605,2016,7호선,철산,691609,100265,791874
201605,2016,7호선,광명사거리,738376,149349,887725
201605,2016,7호선,천왕,220049,43477,263526
201605,2016,7호선,온수,321339,34067,355406
201605,2016,7호선,까치울,190203,27310,217513
201605,2016,7호선,부천종합운동장,160250,18875,179125
201605,2016,7호선,춘의,234417,29116,263533
201605,2016,7호선,신중동,404471,47356,451827
201605,2016,7호선,부천시청,350252,43089,393341
201605,2016,7호선,상동,394228,43731,437959
201605,2016,7호선,삼산체육관,157256,23475,180731
201605,2016,7호선,굴포천,247369,32606,279975
201605,2016,7호선,부평구청,352768,29876,382644
201605,2016,8호선,암사,466748,88114,554862
201605,2016,8호선,모란,100170,52878,153048
201605,2016,8호선,강동구청,264875,61470,326345
201605,2016,8호선,몽촌토성,199714,41633,241347
201605,2016,8호선,잠실,334864,57027,391891
201605,2016,8호선,석촌,224337,59397,283734
201605,2016,8호선,송파,135408,34149,169557
201605,2016,8호선,가락시장,161107,44208,205315
201605,2016,8호선,문정,203018,32047,235065
201605,2016,8호선,장지,402596,58131,460727
201605,2016,8호선,복정,272411,38086,310497
201605,2016,8호선,산성,204860,42539,247399
201605,2016,8호선,남한산성입구,408249,76755,485004
201605,2016,8호선,단대오거리,352768,72837,425605
201605,2016,8호선,신흥,123778,51321,175099
201605,2016,8호선,수진,125827,39695,165522
201605,2016,8호선,천호,505549,91772,597321
201605,2016,9호선,개화,174327,35240,209567
201605,2016,9호선,김포공항,257720,18211,275931
201605,2016,9호선,신논현,812289,48776,861065
201605,2016,9호선,사평,72794,14323,87117
201605,2016,9호선,고속터미널,507357,54042,561399
201605,2016,9호선,신반포,88590,22506,111096
201605,2016,9호선,공항시장,71696,21185,92881
201605,2016,9호선,신방화,209896,43021,252917
201605,2016,9호선,마곡나루,62750,8887,71637
201605,2016,9호선,양천향교,197541,39418,236959
201605,2016,9호선,가양,541006,119875,660881
201605,2016,9호선,증미,181127,41267,222394
201605,2016,9호선,등촌,250694,80884,331578
201605,2016,9호선,염창,434731,58203,492934
201605,2016,9호선,신목동,112708,17968,130676
201605,2016,9호선,선유도,184119,26991,211110
201605,2016,9호선,당산,493626,62585,556211
201605,2016,9호선,국회의사당,401920,51546,453466
201605,2016,9호선,여의도,533657,41293,574950
201605,2016,9호선,샛강,127763,24909,152672
201605,2016,9호선,노량진,787436,82948,870384
201605,2016,9호선,노들,123324,31103,154427
201605,2016,9호선,흑석(중앙대입구),324469,55726,380195
201605,2016,9호선,동작,60936,16518,77454
201605,2016,9호선,구반포,81465,23453,104918
201605,2016,9호선2단계,언주,193550,22004,215554
201605,2016,9호선2단계,봉은사,334111,35640,369751
201605,2016,9호선2단계,삼성중앙,117596,18090,135686
201605,2016,9호선2단계,선정릉,174066,18616,192682
201605,2016,9호선2단계,종합운동장,154922,12430,167352
201605,2016,경부선,구로,603545,95971,699516
201605,2016,경부선,신길,295977,49724,345701
201605,2016,경부선,금천구청,306334,78227,384561
201605,2016,경부선,석수,339235,49371,388606
201605,2016,경부선,관악,244509,58606,303115
201605,2016,경부선,안양,874599,119900,994499
201605,2016,경부선,명학,305097,42872,347969
201605,2016,경부선,금정,825230,109678,934908
201605,2016,경부선,군포,202402,35046,237448
201605,2016,경부선,의왕,248777,41326,290103
201605,2016,경부선,성균관대,508487,53827,562314
201605,2016,경부선,화서,247493,45051,292544
201605,2016,경부선,수원,1402197,152895,1555092
201605,2016,경부선,독산,440865,67001,507866
201605,2016,경부선,세류,130848,20210,151058
201605,2016,경부선,병점,494393,59051,553444
201605,2016,경부선,세마,73500,13929,87429
201605,2016,경부선,오산대,95626,15161,110787
201605,2016,경부선,오산,307108,43346,350454
201605,2016,경부선,진위,48193,8131,56324
201605,2016,경부선,송탄,139717,26547,166264
201605,2016,경부선,서정리,164380,28258,192638
201605,2016,경부선,지제,26837,4223,31060
201605,2016,경부선,평택,423143,71683,494826
201605,2016,경부선,성환,172164,22090,194254
201605,2016,경부선,직산,26530,6256,32786
201605,2016,경부선,두정,206862,23080,229942
201605,2016,경부선,천안,272625,66564,339189
201605,2016,경부선,당정,222667,31657,254324
201605,2016,경부선,서동탄,44877,9181,54058
201605,2016,경부선,광명,25083,1475,26558
201605,2016,경부선,서울역,27,2,29
201605,2016,경부선,남영,349060,42214,391274
201605,2016,경부선,용산,1118448,149465,1267913
201605,2016,경부선,노량진,535859,56057,591916
201605,2016,경부선,대방,431731,77768,509499
201605,2016,경부선,영등포,1367080,280078,1647158
201605,2016,경부선,신도림,94805,19986,114791
201605,2016,경부선,가산디지털단지,470867,31894,502761
201605,2016,경원선,망월사,238891,70958,309849
201605,2016,경원선,창동,5,0,5
201605,2016,경원선,의정부,626917,130279,757196
201605,2016,경원선,가능,188172,63907,252079
201605,2016,경원선,녹양,135279,34971,170250
201605,2016,경원선,양주,255002,57140,312142
201605,2016,경원선,덕계,56377,17557,73934
201605,2016,경원선,덕정,210035,38568,248603
201605,2016,경원선,지행,197069,46692,243761
201605,2016,경원선,동두천 중앙,90151,41110,131261
201605,2016,경원선,보산,48517,15638,64155
201605,2016,경원선,동두천,55340,20349,75689
201605,2016,경원선,소요산,72818,91287,164105
201605,2016,경원선,방학,229267,106066,335333
201605,2016,경원선,도봉,145566,72445,218011
201605,2016,경원선,도봉산,113819,79102,192921
201605,2016,경원선,이촌,130512,31540,162052
201605,2016,경원선,서빙고,58724,17565,76289
201605,2016,경원선,한남,108910,34080,142990
201605,2016,경원선,옥수,1657,137,1794
201605,2016,경원선,응봉,48307,19667,67974
201605,2016,경원선,왕십리,502689,60662,563351
201605,2016,경원선,청량리(지상),366452,144777,511229
201605,2016,경원선,외대앞,371549,59777,431326
201605,2016,경원선,신이문,250866,67743,318609
201605,2016,경원선,석계,302067,67162,369229
201605,2016,경원선,광운대,299742,55835,355577
201605,2016,경원선,월계,167727,53950,221677
201605,2016,경원선,녹천,128536,40423,168959
201605,2016,경원선,회룡,299939,142443,442382
201605,2016,경의선,서울역,40563,5860,46423
201605,2016,경의선,신촌,25298,3896,29194
201605,2016,경의선,효창공원앞,33131,9452,42583
201605,2016,경의선,공덕,55313,9947,65260
201605,2016,경의선,서강대,64384,9560,73944
201605,2016,경의선,홍대입구,44016,4802,48818
201605,2016,경의선,가좌,102598,43788,146386
201605,2016,경의선,디지털미디어시티,67446,10587,78033
201605,2016,경의선,수색,54096,17957,72053
201605,2016,경의선,화전,90233,9116,99349
201605,2016,경의선,강매,65477,15812,81289
201605,2016,경의선,행신,209084,36086,245170
201605,2016,경의선,능곡,95332,31538,126870
201605,2016,경의선,곡산,12330,4977,17307
201605,2016,경의선,백마,187085,32859,219944
201605,2016,경의선,풍산,123455,29383,152838
201605,2016,경의선,일산,255383,58767,314150
201605,2016,경의선,탄현,215343,39585,254928
201605,2016,경의선,야당,77167,18198,95365
201605,2016,경의선,운정,130736,31151,161887
201605,2016,경의선,금릉,133720,26727,160447
201605,2016,경의선,금촌,195553,44345,239898
201605,2016,경의선,월롱,67362,8875,76237
201605,2016,경의선,파주,54323,8440,62763
201605,2016,경의선,문산,157736,48648,206384
201605,2016,경인선,개봉,622991,159194,782185
201605,2016,경인선,역곡,869012,142033,1011045
201605,2016,경인선,온수,203957,47275,251232
201605,2016,경인선,도원,98333,39098,137431
201605,2016,경인선,간석,173086,48666,221752
201605,2016,경인선,부개,283839,66162,350001
201605,2016,경인선,소사,346744,87405,434149
201605,2016,경인선,구일,228625,35963,264588
201605,2016,경인선,인천,133800,51433,185233
201605,2016,경인선,동인천,495737,129469,625206
201605,2016,경인선,제물포,274919,51577,326496
201605,2016,경인선,주안,857233,130422,987655
201605,2016,경인선,도화,87673,35808,123481
201605,2016,경인선,중동,265295,66492,331787
201605,2016,경인선,동암,680926,141117,822043
201605,2016,경인선,백운,234409,66002,300411
201605,2016,경인선,부평,1123335,145178,1268513
201605,2016,경인선,송내,981435,121227,1102662
201605,2016,경인선,부천,1165967,214224,1380191
201605,2016,경인선,오류동,306081,89914,395995
201605,2016,경춘선,춘천,73730,23757,97487
201605,2016,경춘선,남춘천,92082,25938,118020
201605,2016,경춘선,강촌,32830,6524,39354
201605,2016,경춘선,김유정,17681,4522,22203
201605,2016,경춘선,백양리,5210,1719,6929
201605,2016,경춘선,굴봉산,8542,3113,11655
201605,2016,경춘선,가평,77566,18192,95758
201605,2016,경춘선,상천,12981,7619,20600
201605,2016,경춘선,청평,69186,19392,88578
201605,2016,경춘선,대성리,44973,6573,51546
201605,2016,경춘선,마석,95889,32800,128689
201605,2016,경춘선,천마산,28119,13327,41446
201605,2016,경춘선,평내호평,150427,42058,192485
201605,2016,경춘선,금곡,35460,15819,51279
201605,2016,경춘선,사릉,104642,19765,124407
201605,2016,경춘선,퇴계원,91556,24964,116520
201605,2016,경춘선,별내,62809,16452,79261
201605,2016,경춘선,갈매,11019,4382,15401
201605,2016,경춘선,신내,16654,7177,23831
201605,2016,공항철도 1호선,홍대입구,251942,17996,269938
201605,2016,공항철도 1호선,공덕,39272,6131,45403
201605,2016,공항철도 1호선,영종,33520,10299,43819
201605,2016,공항철도 1호선,인천국제공항,354518,42354,396872
201605,2016,공항철도 1호선,공항화물청사,65077,7665,72742
201605,2016,공항철도 1호선,운서,141610,26109,167719
201605,2016,공항철도 1호선,청라국제도시,138876,8665,147541
201605,2016,공항철도 1호선,검암,499594,45808,545402
201605,2016,공항철도 1호선,계양,315227,32107,347334
201605,2016,공항철도 1호선,서울역,289398,32943,322341
201605,2016,공항철도 1호선,디지털미디어시티,335344,21177,356521
201605,2016,공항철도 1호선,김포공항,285608,18131,303739
201605,2016,과천선,과천,141914,37415,179329
201605,2016,과천선,대공원,283129,65748,348877
201605,2016,과천선,경마공원,198048,67213,265261
201605,2016,과천선,선바위,254950,34912,289862
201605,2016,과천선,평촌,430950,62944,493894
201605,2016,과천선,인덕원,720717,105045,825762
201605,2016,과천선,정부과천청사,329129,65609,394738
201605,2016,과천선,범계,889442,111096,1000538
201605,2016,분당선,선릉,230546,26266,256812
201605,2016,분당선,매교,71530,17269,88799
201605,2016,분당선,도곡,166872,38370,205242
201605,2016,분당선,구룡,52839,18897,71736
201605,2016,분당선,개포동,95757,22090,117847
201605,2016,분당선,대모산입구,93952,30506,124458
201605,2016,분당선,수서,213461,49842,263303
201605,2016,분당선,복정,5,0,5
201605,2016,분당선,수원,302947,26673,329620
201605,2016,분당선,서울숲,203810,24725,228535
201605,2016,분당선,압구정로데오,411739,39743,451482
201605,2016,분당선,강남구청,227871,37291,265162
201605,2016,분당선,선정릉,199548,40436,239984
201605,2016,분당선,가천대,321952,23958,345910
201605,2016,분당선,태평,382381,86703,469084
201605,2016,분당선,모란,635210,166925,802135
201605,2016,분당선,야탑,742059,157524,899583
201605,2016,분당선,서현,695621,129300,824921
201605,2016,분당선,수내,345168,80804,425972
201605,2016,분당선,정자,439519,82795,522314
201605,2016,분당선,미금,499498,124425,623923
201605,2016,분당선,오리,373098,96202,469300
201605,2016,분당선,이매,137621,36935,174556
201605,2016,분당선,보정,66595,25675,92270
201605,2016,분당선,죽전,483147,86413,569560
201605,2016,분당선,구성,125781,41243,167024
201605,2016,분당선,신갈,112649,30279,142928
201605,2016,분당선,기흥,234830,31971,266801
201605,2016,분당선,상갈,144262,30636,174898
201605,2016,분당선,청명,122568,16502,139070
201605,2016,분당선,영통,271625,27279,298904
201605,2016,분당선,망포,359193,28551,387744
201605,2016,분당선,매탄권선,130067,13588,143655
201605,2016,분당선,수원시청,300725,33702,334427
201605,2016,분당선,한티,378533,67610,446143
201605,2016,수인선,달월,2330,1235,3565
201605,2016,수인선,월곶,71895,14328,86223
201605,2016,수인선,소래포구,128792,79601,208393
201605,2016,수인선,인천논현,156385,29291,185676
201605,2016,1호선,서울역,1748250,234803,1983053
201605,2016,1호선,시청,697874,96178,794052
201605,2016,1호선,종각,1282865,161590,1444455
201605,2016,1호선,종로3가,761955,369132,1131087
201605,2016,1호선,동묘앞,182742,148019,330761
201605,2016,1호선,동대문,366411,143588,509999
201605,2016,1호선,신설동,395370,124301,519671
201605,2016,1호선,제기동,298797,299148,597945
201605,2016,1호선,청량리(지하),595986,355270,951256
201605,2016,1호선,종로5가,589325,279170,868495
201605,2016,2호선,시청,725829,60024,785853
201605,2016,2호선,용두,47743,22052,69795
201605,2016,2호선,을지로3가,531638,91999,623637
201605,2016,2호선,을지로4가,302273,96096,398369
201605,2016,2호선,동대문역사문화공원,537296,62930,600226
201605,2016,2호선,신당,371330,109937,481267
201605,2016,2호선,상왕십리,282665,61365,344030
201605,2016,2호선,왕십리(성동구청),609024,61693,670717
201605,2016,2호선,한양대,422353,17695,440048
201605,2016,2호선,뚝섬,450113,68418,518531
201605,2016,2호선,성수,674618,100711,775329
201605,2016,2호선,건대입구,1391664,98470,1490134
201605,2016,2호선,구의,653082,110751,763833
201605,2016,2호선,강변,1452038,155554,1607592
201605,2016,2호선,잠실나루,483390,91485,574875
201605,2016,2호선,잠실,2418059,216381,2634440
201605,2016,2호선,신천,728645,119123,847768
201605,2016,2호선,종합운동장,508794,65590,574384
201605,2016,2호선,삼성,1641591,125985,1767576
201605,2016,2호선,선릉,1472304,199742,1672046
201605,2016,2호선,역삼,1201163,152724,1353887
201605,2016,2호선,강남,2778369,163489,2941858
201605,2016,2호선,교대,1017547,162918,1180465
201605,2016,2호선,서초,627089,83960,711049
201605,2016,2호선,방배,610245,82666,692911
201605,2016,2호선,사당,1186128,200450,1386578
201605,2016,2호선,낙성대,876967,114355,991322
201605,2016,2호선,서울대입구,1464663,220574,1685237
201605,2016,2호선,봉천,595274,150577,745851
201605,2016,2호선,신림,2082460,251559,2334019
201605,2016,2호선,신대방,769953,133809,903762
201605,2016,2호선,구로디지털단지,1815263,169710,1984973
201605,2016,2호선,대림,895754,121405,1017159
201605,2016,2호선,신도림,1781310,203831,1985141
201605,2016,2호선,문래,493882,82837,576719
201605,2016,2호선,영등포구청,568170,107342,675512
201605,2016,2호선,당산,639573,70748,710321
201605,2016,2호선,합정,970463,77281,1047744
201605,2016,2호선,홍대입구,2294658,122067,2416725
201605,2016,2호선,신촌,1502947,148648,1651595
201605,2016,2호선,이대,672392,79335,751727
201605,2016,수인선,호구포,85375,15499,100874
201605,2016,수인선,남동인더스파크,54663,4828,59491
201605,2016,수인선,인천,31840,10748,42588
201605,2016,수인선,연수,126171,24242,150413
201605,2016,수인선,송도,79881,21047,100928
201605,2016,수인선,인하대,120804,13958,134762
201605,2016,수인선,숭의,55714,19721,75435
201605,2016,수인선,신포,38810,10579,49389
201605,2016,수인선,원인재,118108,25291,143399
201605,2016,안산선,산본,506376,107911,614287
201605,2016,안산선,대야미,109631,25531,135162
201605,2016,안산선,반월,138984,31011,169995
201605,2016,안산선,상록수,630325,89702,720027
201605,2016,안산선,한대앞,289930,43810,333740
201605,2016,안산선,중앙,528233,59393,587626
201605,2016,안산선,수리산,126925,36729,163654
201605,2016,안산선,초지,142605,17200,159805
201605,2016,안산선,안산,537296,48273,585569
201605,2016,안산선,신길온천,49765,10293,60058
201605,2016,안산선,정왕,310981,26120,337101
201605,2016,안산선,오이도,249447,36363,285810
201605,2016,안산선,고잔,271777,38339,310116
201605,2016,일산선,삼송,348401,79348,427749
201605,2016,일산선,주엽,214154,101527,315681
201605,2016,일산선,정발산,290473,91876,382349
201605,2016,일산선,마두,191609,82346,273955
201605,2016,일산선,백석,276972,76841,353813
201605,2016,일산선,대곡,40302,12677,52979
201605,2016,일산선,원흥,159796,37833,197629
201605,2016,일산선,대화,396334,97833,494167
201605,2016,일산선,원당,316470,92301,408771
201605,2016,일산선,화정,515925,139163,655088
201605,2016,장항선,신창,84212,8513,92725
201605,2016,장항선,온양온천,106188,60493,166681
201605,2016,장항선,배방,26902,7900,34802
201605,2016,장항선,아산,84366,9047,93413
201605,2016,장항선,쌍용동,86283,16954,103237
201605,2016,장항선,봉명,31981,14263,46244
201605,2016,중앙선,회기,891078,134947,1026025
201605,2016,중앙선,용문,68420,62730,131150
201605,2016,중앙선,상봉,151584,39602,191186
201605,2016,중앙선,망우,204977,71354,276331
201605,2016,중앙선,양원,49412,18006,67418
201605,2016,중앙선,구리,370047,87854,457901
201605,2016,중앙선,도농,246055,59938,305993
201605,2016,중앙선,양정,20873,9545,30418
201605,2016,중앙선,덕소,163516,52521,216037
201605,2016,중앙선,도심,66206,22386,88592
201605,2016,중앙선,팔당,27510,7319,34829
201605,2016,중앙선,운길산,39050,13923,52973
201605,2016,중앙선,양수,54128,20990,75118
201605,2016,중앙선,신원,6738,4142,10880
201605,2016,중앙선,국수,22641,10185,32826
201605,2016,중앙선,아신,24323,7783,32106
201605,2016,중앙선,오빈,7592,4874,12466
201605,2016,중앙선,양평,95504,38545,134049
201605,2016,중앙선,원덕,8753,6602,15355
201605,2016,중앙선,중랑,144367,53523,197890
201605,2016,2호선,아현,270074,67147,337221
201605,2016,2호선,충정로,309815,54324,364139
201605,2016,2호선,용답,65518,17238,82756
201605,2016,2호선,신답,32381,11108,43489
201605,2016,2호선,신설동,92362,35072,127434
201605,2016,2호선,도림천,25913,6367,32280
201605,2016,2호선,양천구청,186819,47059,233878
201605,2016,2호선,신정네거리,271858,67142,339000
201605,2016,2호선,을지로입구,1469645,118548,1588193
201605,2016,3호선,오금,186940,25997,212937
201604,2016,경춘선,청평,59181,18428,77609
201604,2016,경춘선,상천,11764,7766,19530
201604,2016,경춘선,가평,63193,16835,80028
201604,2016,경춘선,굴봉산,6126,3253,9379
201604,2016,경부선,두정,201353,22812,224165
201604,2016,경부선,천안,257712,65905,323617
201604,2016,경부선,당정,218489,31465,249954
201604,2016,경부선,서동탄,42546,8985,51531
201604,2016,경부선,광명,23547,1356,24903
201604,2016,경부선,서울역,38,1,39
201604,2016,경부선,남영,342134,42332,384466
201604,2016,경부선,용산,1043902,150888,1194790
201604,2016,경부선,노량진,537882,60450,598332
201604,2016,경부선,대방,421868,78562,500430
201604,2016,경부선,영등포,1317450,282520,1599970
201604,2016,경부선,신도림,91751,19544,111295
201604,2016,경부선,가산디지털단지,467962,32023,499985
201604,2016,경원선,망월사,225894,67916,293810
201604,2016,경원선,창동,4,0,4
201604,2016,경원선,의정부,599088,129521,728609
201604,2016,경원선,가능,182862,62596,245458
201604,2016,경원선,녹양,130249,34406,164655
201604,2016,경원선,양주,245878,56748,302626
201604,2016,경원선,덕계,53228,17965,71193
201604,2016,경원선,덕정,206566,38630,245196
201604,2016,경원선,지행,190110,46377,236487
201604,2016,경원선,동두천 중앙,87317,40691,128008
201604,2016,경원선,보산,45550,15178,60728
201604,2016,경원선,동두천,55611,20392,76003
201604,2016,경원선,소요산,68306,89702,158008
201604,2016,경원선,방학,221623,104470,326093
201604,2016,경원선,도봉,140245,70883,211128
201604,2016,경원선,도봉산,96167,66708,162875
201604,2016,경원선,이촌,122028,30399,152427
201604,2016,경원선,서빙고,56126,16936,73062
201604,2016,경원선,한남,105696,33737,139433
201604,2016,경원선,옥수,1609,118,1727
201604,2016,경원선,응봉,53066,20787,73853
201604,2016,경원선,왕십리,463035,58591,521626
201604,2016,경원선,청량리(지상),336455,142783,479238
201604,2016,경원선,외대앞,352604,58700,411304
201604,2016,경원선,신이문,244534,66351,310885
201604,2016,경원선,석계,290451,66700,357151
201604,2016,경원선,광운대,292179,54197,346376
201604,2016,경원선,월계,166738,52894,219632
201604,2016,경원선,녹천,126471,38910,165381
201604,2016,경원선,회룡,292642,139914,432556
201604,2016,경의선,서울역,80686,12050,92736
201604,2016,경의선,신촌,23042,3701,26743
201604,2016,경의선,효창공원앞,713,449,1162
201604,2016,5호선,올림픽공원,177999,34958,212957
201604,2016,5호선,방이,181406,39890,221296
201604,2016,5호선,오금,102659,17223,119882
201604,2016,5호선,개롱,177008,42018,219026
201604,2016,5호선,거여,174383,49291,223674
201604,2016,5호선,개화산,151204,34707,185911
201604,2016,6호선,응암,451222,111496,562718
201604,2016,6호선,봉화산(서울의료원),238844,52269,291113
201604,2016,6호선,불광,137015,39296,176311
201604,2016,6호선,독바위,68477,20575,89052
201604,2016,6호선,연신내,20,0,20
201604,2016,6호선,구산,205037,56011,261048
201604,2016,6호선,새절,367177,86277,453454
201604,2016,6호선,증산,265681,71476,337157
201604,2016,6호선,디지털미디어시티,395175,63358,458533
201604,2016,6호선,월드컵경기장,163948,57370,221318
201604,2016,6호선,마포구청,342990,83079,426069
201604,2016,6호선,망원,306405,85786,392191
201604,2016,6호선,합정,372292,39346,411638
201604,2016,6호선,상수,306804,23239,330043
201604,2016,6호선,광흥창,235173,60530,295703
201604,2016,6호선,대흥,227496,46037,273533
201604,2016,6호선,공덕,471921,73671,545592
201604,2016,6호선,효창공원앞,209247,47658,256905
201604,2016,6호선,삼각지,214512,20794,235306
201604,2016,6호선,녹사평(용산구청),210987,22437,233424
201604,2016,6호선,이태원,454881,39139,494020
201604,2016,6호선,한강진,178317,14247,192564
201604,2016,6호선,버티고개,64594,15067,79661
201604,2016,6호선,약수,90987,23806,114793
201604,2016,6호선,청구,102836,19020,121856
201604,2016,6호선,신당,214997,37365,252362
201604,2016,6호선,동묘앞,218916,69260,288176
201604,2016,6호선,창신,91700,17965,109665
201604,2016,6호선,보문,231481,38559,270040
201604,2016,6호선,안암,421731,31296,453027
201604,2016,6호선,고려대,291040,37236,328276
201604,2016,6호선,월곡,350503,72134,422637
201604,2016,6호선,상월곡,167985,38547,206532
201604,2016,6호선,돌곶이,245566,62140,307706
201604,2016,6호선,석계,346513,73032,419545
201604,2016,6호선,태릉입구,137925,26345,164270
201604,2016,6호선,화랑대,379053,46166,425219
201604,2016,6호선,역촌,83916,33795,117711
201604,2016,7호선,장암,72904,9387,82291
201604,2016,7호선,도봉산,323625,70770,394395
201604,2016,7호선,수락산,367606,91265,458871
201604,2016,7호선,마들,311317,73711,385028
201604,2016,7호선,노원,537504,114839,652343
201604,2016,7호선,중계,419015,94907,513922
201604,2016,7호선,하계,547418,107952,655370
201604,2016,경의선,월롱,70547,9023,79570
201604,2016,경의선,파주,55020,8986,64006
201604,2016,경의선,문산,151912,47846,199758
201604,2016,경인선,개봉,600255,158286,758541
201604,2016,경인선,역곡,842099,139067,981166
201604,2016,경인선,온수,198009,46160,244169
201604,2016,경인선,도원,94267,35054,129321
201604,2016,경인선,간석,170092,48307,218399
201604,2016,경인선,부개,276788,64899,341687
201604,2016,경인선,소사,341092,86876,427968
201604,2016,경인선,구일,208811,36309,245120
201604,2016,경인선,인천,112832,49457,162289
201604,2016,경인선,동인천,483246,125373,608619
201604,2016,경인선,제물포,268176,50355,318531
201604,2016,경인선,주안,835037,129049,964086
201604,2016,경인선,도화,86681,34420,121101
201604,2016,경인선,중동,260900,67266,328166
201604,2016,경인선,동암,662740,140626,803366
201604,2016,경인선,백운,227840,64399,292239
201604,2016,경인선,부평,1082786,143467,1226253
201604,2016,경인선,송내,969463,121545,1091008
201604,2016,경인선,부천,1133630,209493,1343123
201604,2016,경인선,오류동,296054,88221,384275
201604,2016,경춘선,춘천,63143,22712,85855
201604,2016,경춘선,남춘천,84375,25268,109643
201604,2016,경춘선,강촌,28994,6038,35032
201604,2016,경춘선,김유정,15042,4429,19471
201604,2016,경춘선,백양리,4914,1943,6857
201604,2016,7호선,신풍,307145,69006,376151
201604,2016,7호선,보라매,259686,43248,302934
201604,2016,7호선,신대방삼거리,405337,93355,498692
201604,2016,7호선,장승배기,261185,76142,337327
201604,2016,7호선,상도,300914,62864,363778
201604,2016,7호선,숭실대입구,496910,60843,557753
201604,2016,7호선,남성,294910,70183,365093
201604,2016,7호선,이수,450354,79732,530086
201604,2016,7호선,내방,375905,63183,439088
201604,2016,7호선,고속터미널,593170,84465,677635
201604,2016,7호선,반포,171027,30782,201809
201604,2016,7호선,논현,538328,50646,588974
201604,2016,7호선,학동,608703,63502,672205
201604,2016,7호선,강남구청,425600,49091,474691
201604,2016,7호선,청담,571329,74105,645434
201604,2016,7호선,뚝섬유원지,298596,44121,342717
201604,2016,7호선,건대입구,476654,50896,527550
201604,2016,7호선,어린이대공원,572807,53590,626397
201604,2016,7호선,군자,383728,78455,462183
201604,2016,경의선,공덕,56121,10468,66589
201604,2016,경의선,서강대,61890,9366,71256
201604,2016,경의선,홍대입구,40463,4360,44823
201604,2016,경의선,가좌,98137,44313,142450
201604,2016,경의선,디지털미디어시티,63693,10192,73885
201604,2016,경의선,수색,50862,17493,68355
201604,2016,경의선,화전,86167,9119,95286
201604,2016,경의선,강매,63226,15828,79054
201604,2016,경의선,행신,199691,36803,236494
201604,2016,경의선,능곡,90105,31694,121799
201604,2016,경의선,곡산,12184,5196,17380
201604,2016,경의선,백마,179596,32761,212357
201604,2016,경의선,풍산,118059,28530,146589
201604,2016,경의선,일산,245000,59614,304614
201604,2016,경의선,탄현,205824,38777,244601
201604,2016,경의선,야당,72158,18098,90256
201604,2016,경의선,운정,125709,32005,157714
201604,2016,경의선,금릉,128833,25833,154666
201604,2016,경의선,금촌,188350,45255,233605
201604,2016,5호선,서대문,468947,71172,540119
201604,2016,5호선,충정로,129830,16586,146416
201604,2016,5호선,애오개,175565,40328,215893
201604,2016,5호선,공덕,354567,47653,402220
201604,2016,5호선,마포,391627,66114,457741
201604,2016,5호선,여의나루,533087,55006,588093
201604,2016,5호선,여의도,689071,61321,750392
201604,2016,5호선,신길,87062,12533,99595
201604,2016,5호선,영등포시장,181935,76441,258376
201604,2016,5호선,영등포구청,82659,18314,100973
201604,2016,5호선,양평,161727,27882,189609
201604,2016,5호선,오목교,694920,84155,779075
201604,2016,5호선,목동,500896,84060,584956
201604,2016,5호선,신정,398623,59486,458109
201604,2016,5호선,까치산,780862,152983,933845
201604,2016,5호선,화곡,778466,138540,917006
201604,2016,5호선,우장산,428793,78387,507180
201604,2016,5호선,발산,319226,59236,378462
201604,2016,5호선,마곡,97257,16363,113620
201604,2016,5호선,송정,253564,66621,320185
201604,2016,5호선,김포공항,195826,27282,223108
201604,2016,5호선,마천,127187,49750,176937
201604,2016,5호선,방화,192347,47625,239972
201604,2016,4호선,상계,581996,120401,702397
201604,2016,4호선,사당,932265,98689,1030954
201604,2016,4호선,총신대입구,564011,145284,709295
201604,2016,4호선,동작,72789,23418,96207
201604,2016,4호선,이촌,245796,47039,292835
201604,2016,4호선,신용산,352629,55500,408129
201604,2016,4호선,삼각지,120610,32492,153102
201604,2016,7호선,중곡,264827,59777,324604
201604,2016,7호선,용마산,169436,36276,205712
201604,2016,7호선,사가정,426952,95537,522489
201604,2016,7호선,면목,446813,83256,530069
201604,2016,7호선,상봉,477305,74357,551662
201604,2016,7호선,중화,311897,60736,372633
201604,2016,7호선,먹골,273414,58025,331439
201604,2016,7호선,태릉입구,259706,38461,298167
201604,2016,7호선,공릉,361574,69137,430711
201604,2016,2호선,신천,719842,117605,837447
201604,2016,2호선,종합운동장,495375,63347,558722
201604,2016,2호선,삼성,1546026,124346,1670372
201604,2016,2호선,선릉,1457749,197988,1655737
201604,2016,2호선,역삼,1202575,155382,1357957
201604,2016,2호선,강남,2746287,158908,2905195
201604,2016,2호선,교대,1007781,164216,1171997
201604,2016,2호선,서초,612206,84887,697093
201604,2016,2호선,방배,611759,82424,694183
201604,2016,2호선,사당,1179005,203795,1382800
201604,2016,2호선,낙성대,863599,111987,975586
201604,2016,2호선,서울대입구,1434493,213711,1648204
201604,2016,2호선,봉천,588846,153472,742318
201604,2016,2호선,신림,2043569,251532,2295101
201604,2016,2호선,신대방,749407,132476,881883
201604,2016,2호선,구로디지털단지,1788608,166774,1955382
201604,2016,1호선,서울역,1698080,237844,1935924
201604,2016,1호선,시청,655481,95309,750790
201604,2016,1호선,종각,1224499,150621,1375120
201604,2016,1호선,종로3가,742395,367963,1110358
201604,2016,1호선,동묘앞,178833,146213,325046
201604,2016,1호선,동대문,352920,139644,492564
201604,2016,1호선,신설동,392636,123518,516154
201604,2016,1호선,제기동,295172,302652,597824
201604,2016,1호선,청량리(지하),574646,354877,929523
201604,2016,1호선,종로5가,575057,277635,852692
201604,2016,2호선,시청,701489,59736,761225
201604,2016,2호선,용두,47582,21997,69579
201604,2016,2호선,을지로3가,514368,89287,603655
201604,2016,2호선,을지로4가,300312,95287,395599
201604,2016,2호선,동대문역사문화공원,519814,61427,581241
201604,2016,2호선,신당,368556,107694,476250
201604,2016,2호선,상왕십리,275689,60438,336127
201604,2016,2호선,왕십리(성동구청),589540,60599,650139
201604,2016,2호선,한양대,400883,16106,416989
201604,2016,2호선,뚝섬,447886,68214,516100
201604,2016,2호선,성수,670721,98620,769341
201604,2016,2호선,건대입구,1339374,98075,1437449
201604,2016,2호선,구의,641331,110515,751846
201604,2016,2호선,강변,1385772,154286,1540058
201604,2016,2호선,잠실나루,473065,89630,562695
201604,2016,2호선,잠실,2467845,224227,2692072
201604,2016,4호선,숙대입구,520851,60742,581593
201604,2016,4호선,서울역,330332,40549,370881
201604,2016,4호선,회현,721497,219160,940657
201604,2016,4호선,명동,1198955,76128,1275083
201604,2016,4호선,충무로,945304,130476,1075780
201604,2016,4호선,동대문역사문화공원,648598,67299,715897
201604,2016,4호선,동대문,673566,170892,844458
201604,2016,4호선,혜화,1190762,133314,1324076
201604,2016,4호선,한성대입구,482537,83963,566500
201604,2016,4호선,성신여대입구,759981,107685,867666
201604,2016,4호선,길음,776947,155174,932121
201604,2016,4호선,미아사거리,856765,197410,1054175
201604,2016,4호선,미아,491804,137221,629025
201604,2016,4호선,수유(강북구청),1201122,259799,1460921
201604,2016,4호선,쌍문,887652,172032,1059684
201604,2016,4호선,창동,757731,189117,946848
201604,2016,4호선,노원,639457,95732,735189
201604,2016,4호선,남태령,35948,8540,44488
201604,2016,4호선,당고개,337346,97068,434414
201604,2016,3호선,구파발,461569,88788,550357
201604,2016,3호선,경찰병원,195059,37054,232113
201604,2016,3호선,가락시장,217643,63643,281286
201604,2016,3호선,수서,291642,85085,376727
201604,2016,3호선,일원,231786,61745,293531
201604,2016,3호선,대청,274015,51042,325057
201604,2016,3호선,학여울,77721,15525,93246
201604,2016,3호선,대치,312156,65745,377901
201604,2016,3호선,도곡,198863,29365,228228
201604,2016,3호선,매봉,305191,55888,361079
201604,2016,3호선,양재,1134681,163299,1297980
201604,2016,3호선,남부터미널,970996,135694,1106690
201604,2016,3호선,교대,376713,65663,442376
201604,2016,3호선,고속터미널,1539954,182446,1722400
201604,2016,3호선,잠원,143550,32409,175959
201604,2016,3호선,신사,886141,74848,960989
201604,2016,3호선,압구정,932569,153030,1085599
201604,2016,3호선,옥수,263593,59729,323322
201604,2016,3호선,금호,193606,54357,247963
201604,2016,3호선,약수,365379,89302,454681
201604,2016,3호선,동대입구,358669,42758,401427
201604,2016,3호선,충무로,42,4,46
201604,2016,3호선,을지로3가,215015,59391,274406
201604,2016,3호선,종로3가,190033,60749,250782
201604,2016,3호선,안국,724293,127227,851520
201604,2016,3호선,경복궁,702709,93867,796576
201604,2016,3호선,독립문,171136,76049,247185
201604,2016,3호선,무악재,99757,33708,133465
201604,2016,3호선,홍제,504680,155783,660463
201604,2016,3호선,녹번,357215,77320,434535
201604,2016,3호선,불광,464128,148937,613065
201604,2016,3호선,연신내,1052916,261018,1313934
201604,2016,3호선,오금,185026,25914,210940
201604,2016,3호선,지축,28235,13224,41459
201604,2016,2호선,을지로입구,1424675,116050,1540725
201604,2016,2호선,신정네거리,269248,67127,336375
201604,2016,2호선,양천구청,180620,47165,227785
201604,2016,2호선,도림천,26493,6571,33064
201604,2016,2호선,신설동,90453,34136,124589
201604,2016,2호선,신답,31274,11307,42581
201604,2016,2호선,용답,64862,16897,81759
201604,2016,2호선,충정로,305828,54290,360118
201604,2016,2호선,아현,265099,67099,332198
201604,2016,2호선,이대,651106,80725,731831
201604,2016,2호선,신촌,1427500,146867,1574367
201604,2016,2호선,홍대입구,2145837,120995,2266832
201604,2016,2호선,합정,946383,76092,1022475
201604,2016,2호선,당산,646221,73591,719812
201604,2016,2호선,영등포구청,563755,105550,669305
201604,2016,2호선,문래,491652,82514,574166
201604,2016,2호선,신도림,1735967,204680,1940647
201604,2016,2호선,대림,875539,122037,997576
201604,2016,5호선,광화문,992962,82689,1075651
201604,2016,5호선,종로3가,300548,118710,419258
201604,2016,5호선,을지로4가,116287,42650,158937
201604,2016,5호선,동대문역사문화공원,78390,11206,89596
201604,2016,5호선,청구,102651,27112,129763
201604,2016,5호선,신금호,137404,35606,173010
201604,2016,5호선,행당,215375,48488,263863
201604,2016,5호선,왕십리(성동구청),131422,25226,156648
201604,2016,5호선,마장,156448,44926,201374
201604,2016,5호선,답십리,425649,84456,510105
201604,2016,5호선,장한평,478525,101125,579650
201604,2016,5호선,군자,305061,36973,342034
201604,2016,5호선,아차산,405854,97804,503658
201604,2016,5호선,광나루,406825,69634,476459
201604,2016,5호선,천호,514702,148271,662973
201604,2016,5호선,강동,513109,93993,607102
201604,2016,5호선,길동,178429,58955,237384
201604,2016,5호선,굽은다리,247106,62061,309167
201604,2016,5호선,명일,200762,61899,262661
201604,2016,5호선,고덕,208137,59507,267644
201604,2016,5호선,상일동,272443,62685,335128
201604,2016,5호선,둔촌동,340260,77206,417466
201604,2016,중앙선,중랑,138732,53401,192133
201604,2016,중앙선,원덕,9249,7097,16346
201604,2016,중앙선,양평,89981,38573,128554
201604,2016,중앙선,오빈,7185,4848,12033
201604,2016,중앙선,아신,22756,7613,30369
201604,2016,중앙선,국수,22171,11117,33288
201604,2016,중앙선,신원,6065,4448,10513
201604,2016,중앙선,양수,49798,20128,69926
201604,2016,중앙선,운길산,36535,14082,50617
201604,2016,중앙선,팔당,23413,7434,30847
201604,2016,중앙선,도심,63804,21799,85603
201604,2016,중앙선,덕소,155561,51652,207213
201604,2016,중앙선,양정,20315,9769,30084
201604,2016,중앙선,도농,234045,59541,293586
201604,2016,중앙선,구리,346916,86715,433631
201604,2016,중앙선,양원,48970,17780,66750
201604,2016,중앙선,망우,194934,70646,265580
201604,2016,중앙선,상봉,143697,38854,182551
201604,2016,중앙선,용문,54878,56569,111447
201604,2016,중앙선,회기,871736,136064,1007800
201604,2016,장항선,봉명,29775,14131,43906
201604,2016,장항선,쌍용동,83918,16540,100458
201604,2016,장항선,아산,78852,8592,87444
201604,2016,장항선,배방,25550,7677,33227
201604,2016,장항선,온양온천,101944,63712,165656
201604,2016,장항선,신창,80859,8281,89140
201604,2016,일산선,화정,485899,135932,621831
201604,2016,일산선,원당,303769,91445,395214
201604,2016,일산선,대화,359667,91384,451051
201604,2016,일산선,지축,1,0,1
201604,2016,일산선,원흥,156769,37922,194691
201604,2016,일산선,대곡,38035,12467,50502
201604,2016,일산선,백석,258258,75701,333959
201604,2016,일산선,마두,184428,81107,265535
201604,2016,일산선,정발산,225299,66467,291766
201604,2016,일산선,주엽,200278,100080,300358
201604,2016,7호선,대림,301866,35984,337850
201604,2016,7호선,남구로,444830,60889,505719
201604,2016,7호선,가산디지털단지,1148386,78170,1226556
201604,2016,7호선,철산,673177,98559,771736
201604,2016,7호선,광명사거리,721511,148330,869841
201604,2016,7호선,천왕,213842,43435,257277
201604,2016,7호선,온수,320311,33250,353561
201604,2016,7호선,까치울,185800,29275,215075
201604,2016,7호선,부천종합운동장,197867,31915,229782
201604,2016,7호선,춘의,236413,27361,263774
201604,2016,7호선,신중동,401097,46846,447943
201604,2016,7호선,부천시청,340523,42311,382834
201604,2016,7호선,상동,387589,43736,431325
201604,2016,7호선,삼산체육관,148451,23550,172001
201604,2016,7호선,굴포천,241379,32257,273636
201604,2016,7호선,부평구청,348970,30273,379243
201604,2016,8호선,암사,455464,86814,542278
201604,2016,8호선,모란,99737,54979,154716
201604,2016,8호선,강동구청,258275,59879,318154
201604,2016,8호선,몽촌토성,166448,41099,207547
201604,2016,8호선,잠실,341900,59611,401511
201604,2016,8호선,석촌,228076,60784,288860
201604,2016,8호선,송파,135895,34524,170419
201604,2016,8호선,가락시장,159096,44415,203511
201604,2016,8호선,문정,188404,31491,219895
201604,2016,8호선,장지,389418,57187,446605
201604,2016,8호선,복정,265743,38068,303811
201604,2016,8호선,산성,197601,40907,238508
201604,2016,8호선,남한산성입구,398729,76161,474890
201604,2016,8호선,단대오거리,348619,71397,420016
201604,2016,8호선,신흥,120530,48726,169256
201604,2016,8호선,수진,119790,39373,159163
201604,2016,8호선,천호,498803,91298,590101
201604,2016,9호선,개화,168714,34661,203375
201604,2016,9호선,김포공항,243332,18690,262022
201604,2016,9호선,신논현,813576,48911,862487
201604,2016,9호선,사평,71177,14568,85745
201604,2016,9호선,고속터미널,471078,52966,524044
201604,2016,9호선,신반포,83725,21769,105494
201604,2016,9호선,공항시장,70147,20834,90981
201604,2016,9호선,신방화,206423,42742,249165
201604,2016,9호선,마곡나루,59191,8522,67713
201604,2016,9호선,양천향교,197209,39154,236363
201604,2016,9호선,가양,532126,120353,652479
201604,2016,9호선,증미,179521,40720,220241
201604,2016,9호선,등촌,247339,81477,328816
201604,2016,9호선,염창,428316,58309,486625
201604,2016,9호선,신목동,111522,18515,130037
201604,2016,9호선,선유도,184279,26337,210616
201604,2016,9호선,당산,489287,60965,550252
201604,2016,9호선,국회의사당,546999,71547,618546
201604,2016,9호선,여의도,563355,44222,607577
201604,2016,9호선,샛강,138137,26103,164240
201604,2016,9호선,노량진,759888,83451,843339
201604,2016,9호선,노들,122281,30807,153088
201604,2016,9호선,흑석(중앙대입구),312115,55410,367525
201604,2016,9호선,동작,67934,22168,90102
201604,2016,9호선,구반포,77651,23398,101049
201604,2016,9호선2단계,언주,192797,21456,214253
201604,2016,9호선2단계,봉은사,305376,31519,336895
201604,2016,9호선2단계,삼성중앙,116342,17426,133768
201604,2016,9호선2단계,선정릉,171890,18019,189909
201604,2016,9호선2단계,종합운동장,151343,12320,163663
201604,2016,경부선,구로,588103,93997,682100
201604,2016,경부선,신길,294781,51729,346510
201604,2016,경부선,금천구청,296311,78753,375064
201604,2016,경부선,석수,330148,48612,378760
201604,2016,경부선,관악,234751,56109,290860
201604,2016,경부선,안양,848966,118302,967268
201604,2016,경부선,명학,302239,42753,344992
201604,2016,경부선,금정,817730,109251,926981
201604,2016,경부선,군포,200538,35121,235659
201604,2016,경부선,의왕,240623,40484,281107
201604,2016,경부선,성균관대,485534,54273,539807
201604,2016,경부선,화서,239110,44809,283919
201604,2016,경부선,수원,1322514,152295,1474809
201604,2016,경부선,독산,430526,67054,497580
201604,2016,경부선,세류,115852,19017,134869
201604,2016,경부선,병점,481170,59383,540553
201604,2016,경부선,세마,69149,13743,82892
201604,2016,경부선,오산대,99716,14479,114195
201604,2016,경부선,오산,295123,43602,338725
201604,2016,경부선,진위,46303,8186,54489
201604,2016,경부선,송탄,132552,26038,158590
201604,2016,경부선,서정리,158431,27327,185758
201604,2016,경부선,지제,25804,4342,30146
201604,2016,경부선,평택,401799,71052,472851
201604,2016,경부선,성환,163236,22368,185604
201604,2016,경부선,직산,26158,6461,32619
201604,2016,일산선,삼송,335419,79232,414651
201604,2016,안산선,고잔,258016,37204,295220
201604,2016,안산선,오이도,233384,35751,269135
201604,2016,안산선,정왕,303344,25475,328819
201604,2016,안산선,신길온천,46826,10081,56907
201604,2016,안산선,안산,509272,47477,556749
201604,2016,안산선,초지,141536,17694,159230
201604,2016,안산선,수리산,129333,39710,169043
201604,2016,안산선,중앙,496707,58915,555622
201604,2016,안산선,한대앞,280914,43368,324282
201604,2016,안산선,상록수,608049,89496,697545
201604,2016,안산선,반월,136402,30315,166717
201604,2016,안산선,대야미,108876,25436,134312
201604,2016,안산선,산본,485539,106459,591998
201604,2016,수인선,원인재,113941,24696,138637
201604,2016,수인선,신포,36983,10698,47681
201604,2016,수인선,숭의,50432,18959,69391
201604,2016,수인선,인하대,109158,13294,122452
201604,2016,수인선,송도,75236,20761,95997
201604,2016,수인선,연수,119137,23948,143085
201604,2016,수인선,인천,26124,10807,36931
201604,2016,수인선,남동인더스파크,55618,4781,60399
201604,2016,수인선,호구포,80909,15335,96244
201604,2016,수인선,인천논현,148359,28761,177120
201604,2016,수인선,소래포구,119909,62390,182299
201604,2016,수인선,월곶,69036,14071,83107
201604,2016,수인선,달월,2167,1303,3470
201604,2016,분당선,한티,358874,67547,426421
201604,2016,분당선,수원시청,284181,33179,317360
201604,2016,분당선,매탄권선,124792,13420,138212
201604,2016,분당선,망포,350287,28262,378549
201604,2016,분당선,영통,258493,26621,285114
201604,2016,분당선,청명,115584,16277,131861
201604,2016,분당선,상갈,133362,30473,163835
201604,2016,분당선,기흥,224662,31390,256052
201604,2016,분당선,신갈,110533,30130,140663
201604,2016,분당선,구성,121748,41500,163248
201604,2016,분당선,죽전,466453,86031,552484
201604,2016,분당선,보정,65438,25893,91331
201604,2016,분당선,이매,128349,35754,164103
201604,2016,분당선,오리,363356,95792,459148
201604,2016,분당선,미금,489497,124573,614070
201604,2016,분당선,정자,428269,81402,509671
201604,2016,분당선,수내,335577,79389,414966
201604,2016,분당선,서현,667228,129705,796933
201604,2016,분당선,야탑,709618,158061,867679
201604,2016,분당선,모란,621050,172444,793494
201604,2016,분당선,태평,370361,86395,456756
201604,2016,분당선,가천대,318674,23375,342049
201604,2016,분당선,선정릉,198730,40646,239376
201604,2016,분당선,강남구청,227468,37134,264602
201604,2016,분당선,압구정로데오,407448,39339,446787
201604,2016,분당선,서울숲,188998,24171,213169
201604,2016,분당선,수원,295020,26435,321455
201604,2016,분당선,복정,3,0,3
201604,2016,분당선,수서,209914,49079,258993
201604,2016,분당선,대모산입구,92601,30817,123418
201604,2016,분당선,개포동,93853,21925,115778
201604,2016,분당선,구룡,50915,17891,68806
201604,2016,분당선,도곡,163661,38771,202432
201604,2016,분당선,매교,69856,17416,87272
201604,2016,분당선,선릉,228737,26421,255158
201604,2016,과천선,범계,865829,110827,976656
201604,2016,과천선,정부과천청사,310989,63489,374478
201604,2016,과천선,인덕원,690975,103295,794270
201604,2016,과천선,평촌,420040,62486,482526
201604,2016,과천선,선바위,255664,35652,291316
201604,2016,과천선,경마공원,201887,68979,270866
201604,2016,과천선,대공원,232425,69163,301588
201604,2016,과천선,과천,135045,35647,170692
201604,2016,공항철도 1호선,김포공항,270701,18437,289138
201604,2016,공항철도 1호선,디지털미디어시티,319483,20905,340388
201604,2016,공항철도 1호선,서울역,270459,31872,302331
201604,2016,공항철도 1호선,계양,303049,31480,334529
201604,2016,공항철도 1호선,검암,482216,45412,527628
201604,2016,공항철도 1호선,청라국제도시,133826,8258,142084
201604,2016,공항철도 1호선,운서,136697,26418,163115
201604,2016,공항철도 1호선,공항화물청사,65156,7609,72765
201604,2016,공항철도 1호선,인천국제공항,336526,40808,377334
201604,2016,공항철도 1호선,영종,29492,9741,39233
201604,2016,공항철도 1호선,공덕,38179,6164,44343
201604,2016,공항철도 1호선,홍대입구,236147,17347,253494
201604,2016,경춘선,신내,15740,7253,22993
201604,2016,경춘선,갈매,10906,3860,14766
201604,2016,경춘선,별내,59524,16518,76042
201604,2016,경춘선,퇴계원,87694,24696,112390
201604,2016,경춘선,사릉,99845,19627,119472
201604,2016,경춘선,금곡,33874,15944,49818
201604,2016,경춘선,평내호평,143353,41906,185259
201604,2016,경춘선,천마산,27091,13259,40350
201604,2016,경춘선,마석,88401,32679,121080
201604,2016,경춘선,대성리,41363,6665,48028
201603,2016,9호선,양천향교,208215,39873,248088
201603,2016,1호선,서울역,1726590,233961,1960551
201603,2016,1호선,시청,685371,97901,783272
201603,2016,1호선,종각,1336064,159145,1495209
201603,2016,1호선,종로3가,779748,393973,1173721
201603,2016,1호선,동묘앞,185548,149279,334827
201603,2016,1호선,동대문,366076,145667,511743
201603,2016,1호선,신설동,416607,128868,545475
201603,2016,1호선,제기동,310795,320558,631353
201603,2016,1호선,청량리(지하),607859,359422,967281
201603,2016,1호선,종로5가,607732,285331,893063
201603,2016,2호선,시청,755515,63593,819108
201603,2016,2호선,용두,50364,23602,73966
201603,2016,2호선,을지로3가,543339,96174,639513
201603,2016,2호선,을지로4가,317218,100079,417297
201603,2016,2호선,동대문역사문화공원,554723,62696,617419
201603,2016,2호선,신당,382567,113997,496564
201603,2016,2호선,상왕십리,293348,63401,356749
201603,2016,2호선,왕십리(성동구청),634902,63946,698848
201603,2016,2호선,한양대,435163,16697,451860
201603,2016,2호선,뚝섬,460492,70609,531101
201603,2016,2호선,성수,709459,104165,813624
201603,2016,2호선,건대입구,1390919,100743,1491662
201603,2016,2호선,구의,674110,115773,789883
201603,2016,2호선,강변,1412719,152271,1564990
201603,2016,2호선,잠실나루,493976,92088,586064
201603,2016,2호선,잠실,2386887,214831,2601718
201603,2016,2호선,신천,740236,121852,862088
201603,2016,2호선,종합운동장,372498,54238,426736
201603,2016,2호선,삼성,1672860,131574,1804434
201603,2016,2호선,선릉,1574984,215298,1790282
201603,2016,2호선,역삼,1315471,166901,1482372
201603,2016,2호선,강남,2969911,171167,3141078
201603,2016,2호선,교대,1079861,181111,1260972
201603,2016,2호선,서초,652478,90130,742608
201603,2016,2호선,방배,654853,86841,741694
201603,2016,2호선,사당,1239188,213762,1452950
201603,2016,2호선,낙성대,900516,117796,1018312
201603,2016,2호선,서울대입구,1524063,227747,1751810
201603,2016,2호선,봉천,616232,159661,775893
201603,2016,2호선,신림,2127436,263174,2390610
201603,2016,2호선,신대방,767100,134760,901860
201603,2016,2호선,구로디지털단지,1877010,172693,2049703
201603,2016,2호선,대림,902941,125372,1028313
201603,2016,2호선,신도림,1831923,213039,2044962
201603,2016,2호선,문래,523857,87974,611831
201603,2016,2호선,영등포구청,598266,110518,708784
201603,2016,2호선,당산,659497,71619,731116
201603,2016,2호선,합정,978812,77737,1056549
201603,2016,2호선,홍대입구,2266709,127705,2394414
201603,2016,2호선,신촌,1574497,156705,1731202
201603,2016,2호선,이대,698543,87899,786442
201603,2016,2호선,아현,279672,69875,349547
201603,2016,2호선,충정로,324104,57140,381244
201603,2016,2호선,용답,68302,17617,85919
201603,2016,2호선,신답,32897,10885,43782
201603,2016,2호선,신설동,96904,35699,132603
201603,2016,2호선,도림천,27943,6280,34223
201603,2016,2호선,양천구청,189042,48425,237467
201603,2016,2호선,신정네거리,282636,69467,352103
201603,2016,2호선,을지로입구,1519289,125221,1644510
201603,2016,3호선,지축,28069,12449,40518
201603,2016,3호선,오금,193191,26192,219383
201603,2016,3호선,연신내,1092307,264911,1357218
201603,2016,3호선,불광,488611,155246,643857
201603,2016,3호선,녹번,381344,81635,462979
201603,2016,3호선,홍제,522291,158119,680410
201603,2016,3호선,무악재,103788,33859,137647
201603,2016,3호선,독립문,177468,76852,254320
201603,2016,3호선,경복궁,720007,94877,814884
201603,2016,3호선,안국,723387,134362,857749
201603,2016,3호선,종로3가,197807,69073,266880
201603,2016,3호선,을지로3가,229112,64463,293575
201603,2016,3호선,충무로,60,27,87
201603,2016,3호선,동대입구,348255,37598,385853
201603,2016,3호선,약수,387620,93885,481505
201603,2016,3호선,금호,200716,55331,256047
201603,2016,3호선,옥수,270775,59757,330532
201603,2016,3호선,압구정,984758,158058,1142816
201603,2016,3호선,신사,930723,79629,1010352
201603,2016,3호선,잠원,148457,33395,181852
201603,2016,3호선,고속터미널,1565717,187635,1753352
201603,2016,3호선,교대,399731,71683,471414
201603,2016,3호선,남부터미널,1013379,141528,1154907
201603,2016,3호선,양재,1203056,170219,1373275
201603,2016,3호선,매봉,326635,59529,386164
201603,2016,3호선,도곡,208731,30856,239587
201603,2016,3호선,대치,332245,67621,399866
201603,2016,3호선,학여울,78938,18734,97672
201603,2016,3호선,대청,289380,52286,341666
201603,2016,3호선,일원,249613,65835,315448
201603,2016,3호선,수서,307279,87493,394772
201603,2016,3호선,가락시장,225774,65602,291376
201603,2016,3호선,경찰병원,206881,39361,246242
201603,2016,3호선,구파발,475399,88993,564392
201603,2016,4호선,당고개,346544,97529,444073
201603,2016,4호선,남태령,35250,8641,43891
201603,2016,4호선,노원,666928,97913,764841
201603,2016,4호선,창동,787682,190728,978410
201603,2016,4호선,쌍문,920829,176254,1097083
201603,2016,4호선,수유(강북구청),1257987,266292,1524279
201603,2016,4호선,미아,513234,140355,653589
201603,2016,4호선,미아사거리,897751,204135,1101886
201603,2016,4호선,길음,830166,158247,988413
201603,2016,4호선,성신여대입구,818836,111684,930520
201603,2016,4호선,한성대입구,507524,87554,595078
201603,2016,4호선,혜화,1260110,141571,1401681
201603,2016,4호선,동대문,701130,172840,873970
201603,2016,4호선,동대문역사문화공원,686248,70397,756645
201603,2016,4호선,충무로,999458,137148,1136606
201603,2016,4호선,명동,1274113,77766,1351879
201603,2016,4호선,회현,734931,220100,955031
201603,2016,4호선,서울역,346732,41174,387906
201603,2016,4호선,숙대입구,566462,63830,630292
201603,2016,4호선,삼각지,128784,33946,162730
201603,2016,4호선,신용산,371864,58126,429990
201603,2016,4호선,이촌,237676,46481,284157
201603,2016,4호선,동작,60180,20565,80745
201603,2016,4호선,총신대입구,584791,150995,735786
201603,2016,4호선,사당,980004,101518,1081522
201603,2016,4호선,상계,606291,122790,729081
201603,2016,5호선,방화,197820,47485,245305
201603,2016,5호선,마천,134869,51629,186498
201603,2016,5호선,김포공항,197548,27090,224638
201603,2016,5호선,송정,261806,67264,329070
201603,2016,5호선,마곡,99435,16631,116066
201603,2016,5호선,발산,328660,59856,388516
201603,2016,5호선,우장산,450903,81482,532385
201603,2016,5호선,화곡,807688,143310,950998
201603,2016,5호선,까치산,809399,156158,965557
201603,2016,5호선,신정,413395,59729,473124
201603,2016,5호선,목동,524744,87366,612110
201603,2016,5호선,오목교,723190,87259,810449
201603,2016,5호선,양평,171587,28696,200283
201603,2016,5호선,영등포구청,86656,18531,105187
201603,2016,5호선,영등포시장,185374,77234,262608
201603,2016,5호선,신길,88941,12253,101194
201603,2016,5호선,여의도,671087,56683,727770
201603,2016,5호선,여의나루,272166,29751,301917
201603,2016,5호선,마포,407271,69163,476434
201603,2016,5호선,공덕,369846,49653,419499
201603,2016,5호선,애오개,184476,41642,226118
201603,2016,5호선,충정로,138589,17104,155693
201603,2016,5호선,서대문,505336,77854,583190
201603,2016,5호선,광화문,1052342,87426,1139768
201603,2016,5호선,종로3가,310336,127101,437437
201603,2016,5호선,을지로4가,121060,44733,165793
201603,2016,5호선,동대문역사문화공원,87045,12161,99206
201603,2016,5호선,청구,107672,27459,135131
201603,2016,5호선,신금호,142442,36639,179081
201603,2016,5호선,행당,226037,49776,275813
201603,2016,5호선,왕십리(성동구청),140496,26325,166821
201603,2016,5호선,마장,165477,47145,212622
201603,2016,5호선,답십리,449768,86991,536759
201603,2016,5호선,장한평,507992,104722,612714
201603,2016,5호선,군자,318974,39067,358041
201603,2016,5호선,아차산,405584,97205,502789
201603,2016,5호선,광나루,414962,70082,485044
201603,2016,5호선,천호,533918,154480,688398
201603,2016,5호선,강동,536331,97055,633386
201603,2016,5호선,길동,188289,59523,247812
201603,2016,5호선,굽은다리,258687,64035,322722
201603,2016,5호선,명일,213711,64133,277844
201603,2016,5호선,고덕,219381,62593,281974
201603,2016,5호선,상일동,292364,65455,357819
201603,2016,5호선,둔촌동,360492,79889,440381
201603,2016,5호선,올림픽공원,242879,34116,276995
201603,2016,5호선,방이,192042,42218,234260
201603,2016,5호선,오금,108698,17908,126606
201603,2016,5호선,개롱,182823,44338,227161
201603,2016,5호선,거여,185435,50979,236414
201603,2016,5호선,개화산,157749,35134,192883
201603,2016,6호선,응암,467445,111485,578930
201603,2016,6호선,봉화산(서울의료원),252270,53948,306218
201603,2016,6호선,불광,141476,40281,181757
201603,2016,6호선,독바위,72241,21326,93567
201603,2016,6호선,연신내,14,0,14
201603,2016,6호선,구산,211446,56030,267476
201603,2016,6호선,새절,378718,85136,463854
201603,2016,6호선,증산,275492,71242,346734
201603,2016,6호선,디지털미디어시티,418036,64456,482492
201603,2016,6호선,월드컵경기장,146950,51185,198135
201603,2016,6호선,마포구청,359343,84800,444143
201603,2016,6호선,망원,313570,88576,402146
201603,2016,6호선,합정,384099,39900,423999
201603,2016,6호선,상수,324332,26501,350833
201603,2016,6호선,광흥창,241813,63888,305701
201603,2016,6호선,대흥,238541,47627,286168
201603,2016,6호선,공덕,493695,76086,569781
201603,2016,6호선,효창공원앞,216290,50556,266846
201603,2016,6호선,삼각지,218641,21580,240221
201603,2016,6호선,녹사평(용산구청),208289,23480,231769
201603,2016,6호선,이태원,460899,39947,500846
201603,2016,6호선,한강진,178961,13962,192923
201603,2016,6호선,버티고개,68905,15237,84142
201603,2016,6호선,약수,96484,25848,122332
201603,2016,6호선,청구,106242,19620,125862
201603,2016,6호선,신당,237657,39443,277100
201603,2016,6호선,동묘앞,231991,71579,303570
201603,2016,6호선,창신,98238,19173,117411
201603,2016,6호선,보문,245360,40151,285511
201603,2016,6호선,안암,484451,34575,519026
201603,2016,6호선,고려대,310579,39272,349851
201603,2016,6호선,월곡,383912,75485,459397
201603,2016,6호선,상월곡,177553,39734,217287
201603,2016,6호선,돌곶이,257383,65360,322743
201603,2016,6호선,석계,367619,75578,443197
201603,2016,6호선,태릉입구,145432,27226,172658
201603,2016,6호선,화랑대,401459,47845,449304
201603,2016,6호선,역촌,88136,34640,122776
201603,2016,7호선,장암,73572,8651,82223
201603,2016,7호선,도봉산,333072,70018,403090
201603,2016,7호선,수락산,383501,93492,476993
201603,2016,7호선,마들,326335,76199,402534
201603,2016,7호선,노원,567716,118693,686409
201603,2016,7호선,중계,430624,97099,527723
201603,2016,7호선,하계,569545,111083,680628
201603,2016,7호선,공릉,386829,70639,457468
201603,2016,7호선,태릉입구,270148,38330,308478
201603,2016,7호선,먹골,287608,60545,348153
201603,2016,7호선,중화,321700,62856,384556
201603,2016,7호선,상봉,494732,75862,570594
201603,2016,7호선,면목,465141,84664,549805
201603,2016,7호선,사가정,440974,97173,538147
201603,2016,7호선,용마산,173512,36942,210454
201603,2016,7호선,중곡,278747,62479,341226
201603,2016,7호선,군자,403366,81515,484881
201603,2016,7호선,어린이대공원,556912,48765,605677
201603,2016,7호선,건대입구,520317,53932,574249
201603,2016,7호선,뚝섬유원지,252680,40538,293218
201603,2016,7호선,청담,617744,78616,696360
201603,2016,7호선,강남구청,451143,50599,501742
201603,2016,7호선,학동,653191,68554,721745
201603,2016,7호선,논현,573694,53979,627673
201603,2016,7호선,반포,179132,32413,211545
201603,2016,7호선,고속터미널,596599,83068,679667
201603,2016,7호선,내방,397401,66115,463516
201603,2016,7호선,이수,470985,82893,553878
201603,2016,7호선,남성,309599,71177,380776
201603,2016,7호선,숭실대입구,534984,62572,597556
201603,2016,7호선,상도,319020,64853,383873
201603,2016,7호선,장승배기,268207,78473,346680
201603,2016,7호선,신대방삼거리,424337,95748,520085
201603,2016,7호선,보라매,273067,44951,318018
201603,2016,7호선,신풍,320719,71677,392396
201603,2016,7호선,대림,313403,36277,349680
201603,2016,7호선,남구로,469974,62477,532451
201603,2016,7호선,가산디지털단지,1240954,85474,1326428
201603,2016,7호선,철산,699231,100378,799609
201603,2016,7호선,광명사거리,749228,150328,899556
201603,2016,7호선,천왕,222431,43916,266347
201603,2016,7호선,온수,335418,34091,369509
201603,2016,7호선,까치울,175487,22611,198098
201603,2016,7호선,부천종합운동장,160000,18058,178058
201603,2016,7호선,춘의,237791,26910,264701
201603,2016,7호선,신중동,413760,47568,461328
201603,2016,7호선,부천시청,351499,42855,394354
201603,2016,7호선,상동,402507,44495,447002
201603,2016,7호선,삼산체육관,151592,22688,174280
201603,2016,7호선,굴포천,248767,32692,281459
201603,2016,7호선,부평구청,359696,29806,389502
201603,2016,8호선,암사,474629,89831,564460
201603,2016,8호선,모란,99368,54881,154249
201603,2016,8호선,강동구청,274818,61310,336128
201603,2016,8호선,몽촌토성,159638,40931,200569
201603,2016,8호선,잠실,334488,59007,393495
201603,2016,8호선,석촌,232225,61022,293247
201603,2016,8호선,송파,140885,35535,176420
201603,2016,8호선,가락시장,169487,46163,215650
201603,2016,8호선,문정,185284,32211,217495
201603,2016,8호선,장지,408166,59478,467644
201603,2016,8호선,복정,271662,37808,309470
201603,2016,8호선,산성,204025,41863,245888
201603,2016,8호선,남한산성입구,420819,77034,497853
201603,2016,8호선,단대오거리,361692,73725,435417
201603,2016,8호선,신흥,124891,52508,177399
201603,2016,8호선,수진,125137,41631,166768
201603,2016,8호선,천호,519492,95302,614794
201603,2016,9호선,개화,172167,33058,205225
201603,2016,9호선,김포공항,247933,18288,266221
201603,2016,9호선,신논현,856510,51237,907747
201603,2016,9호선,사평,75225,15014,90239
201603,2016,9호선,고속터미널,458516,53670,512186
201603,2016,9호선,신반포,84536,23172,107708
201603,2016,9호선,공항시장,73627,21302,94929
201603,2016,9호선,신방화,213581,43692,257273
201603,2016,9호선,마곡나루,60099,8336,68435
201603,2016,9호선,가양,534719,123123,657842
201603,2016,9호선,증미,190622,41781,232403
201603,2016,9호선,등촌,259081,84808,343889
201603,2016,9호선,염창,441663,58839,500502
201603,2016,9호선,신목동,115405,18309,133714
201603,2016,9호선,선유도,186670,26136,212806
201603,2016,9호선,당산,498423,62215,560638
201603,2016,9호선,국회의사당,405753,54181,459934
201603,2016,9호선,여의도,545664,41905,587569
201603,2016,9호선,샛강,135747,25501,161248
201603,2016,9호선,노량진,764489,82557,847046
201603,2016,9호선,노들,124688,31096,155784
201603,2016,9호선,흑석(중앙대입구),340232,56608,396840
201603,2016,9호선,동작,47195,13519,60714
201603,2016,9호선,구반포,80483,24500,104983
201603,2016,9호선2단계,언주,202414,22078,224492
201603,2016,9호선2단계,봉은사,315770,33280,349050
201603,2016,9호선2단계,삼성중앙,124812,18449,143261
201603,2016,9호선2단계,선정릉,177889,19246,197135
201603,2016,9호선2단계,종합운동장,152495,12504,164999
201603,2016,경부선,구로,620275,103720,723995
201603,2016,경부선,신길,299430,50534,349964
201603,2016,경부선,금천구청,301511,79882,381393
201603,2016,경부선,석수,343224,48968,392192
201603,2016,경부선,관악,242179,56768,298947
201603,2016,경부선,안양,895929,119885,1015814
201603,2016,경부선,명학,320260,43209,363469
201603,2016,경부선,금정,845387,109774,955161
201603,2016,경부선,군포,205279,34834,240113
201603,2016,경부선,의왕,248477,39602,288079
201603,2016,경부선,성균관대,514654,55489,570143
201603,2016,경부선,화서,244308,44976,289284
201603,2016,경부선,수원,1379645,148065,1527710
201603,2016,경부선,독산,448952,67618,516570
201603,2016,경부선,세류,118928,19267,138195
201603,2016,경부선,병점,501967,59001,560968
201603,2016,경부선,세마,70422,13223,83645
201603,2016,경부선,오산대,104664,12689,117353
201603,2016,경부선,오산,297345,43656,341001
201603,2016,경부선,진위,46928,7867,54795
201603,2016,경부선,송탄,135295,26724,162019
201603,2016,경부선,서정리,163630,27168,190798
201603,2016,경부선,지제,25449,4115,29564
201603,2016,경부선,평택,417895,70663,488558
201603,2016,경부선,성환,180516,21596,202112
201603,2016,경부선,직산,26539,6099,32638
201603,2016,경부선,두정,217502,23166,240668
201603,2016,경부선,천안,276095,64919,341014
201603,2016,경부선,당정,229994,32707,262701
201603,2016,경부선,서동탄,43045,8683,51728
201603,2016,경부선,광명,23953,1298,25251
201603,2016,경부선,서울역,20,2,22
201603,2016,경부선,남영,367836,43960,411796
201603,2016,경부선,용산,1046014,144704,1190718
201603,2016,경부선,노량진,585135,65742,650877
201603,2016,경부선,대방,442452,79128,521580
201603,2016,경부선,영등포,1340162,280142,1620304
201603,2016,경부선,신도림,92601,18023,110624
201603,2016,경부선,가산디지털단지,489616,32031,521647
201603,2016,경원선,회룡,302618,141291,443909
201603,2016,경원선,창동,8,0,8
201603,2016,경원선,가능,188284,63401,251685
201603,2016,경원선,녹양,133120,33838,166958
201603,2016,경원선,양주,250973,53928,304901
201603,2016,경원선,덕계,54439,17371,71810
201603,2016,경원선,덕정,216322,36734,253056
201603,2016,경원선,지행,194722,45194,239916
201603,2016,경원선,동두천 중앙,89515,40617,130132
201603,2016,경원선,보산,46862,14529,61391
201603,2016,경원선,동두천,52330,19846,72176
201603,2016,경원선,소요산,61643,75185,136828
201603,2016,경원선,방학,228629,107415,336044
201603,2016,경원선,도봉,146407,71956,218363
201603,2016,경원선,도봉산,96235,63616,159851
201603,2016,경원선,망월사,241923,69833,311756
201603,2016,경원선,이촌,123188,31050,154238
201603,2016,경원선,서빙고,57284,17275,74559
201603,2016,경원선,한남,113226,35242,148468
201603,2016,경원선,옥수,1605,170,1775
201603,2016,경원선,응봉,48167,19774,67941
201603,2016,경원선,왕십리,494293,60924,555217
201603,2016,경원선,청량리(지상),346350,141707,488057
201603,2016,경원선,외대앞,385686,60071,445757
201603,2016,경원선,신이문,253213,67097,320310
201603,2016,경원선,석계,305466,65615,371081
201603,2016,경원선,광운대,318179,56136,374315
201603,2016,경원선,월계,176596,54276,230872
201603,2016,경원선,녹천,132092,38830,170922
201603,2016,경원선,의정부,613527,131330,744857
201603,2016,경의선,서울역,82903,11250,94153
201603,2016,경의선,신촌,24311,3631,27942
201603,2016,경의선,공덕,55409,10019,65428
201603,2016,경의선,서강대,63418,9222,72640
201603,2016,경의선,홍대입구,40247,4303,44550
201603,2016,경의선,가좌,99330,43310,142640
201603,2016,경의선,디지털미디어시티,65619,9902,75521
201603,2016,경의선,수색,51585,17927,69512
201603,2016,경의선,화전,97082,8830,105912
201603,2016,경의선,강매,64461,15497,79958
201603,2016,경의선,행신,207253,35436,242689
201603,2016,경의선,능곡,92190,30599,122789
201603,2016,경의선,곡산,12267,4809,17076
201603,2016,경의선,백마,188697,32553,221250
201603,2016,경의선,풍산,121115,28350,149465
201603,2016,경의선,일산,256408,58712,315120
201603,2016,경의선,탄현,212185,38819,251004
201603,2016,경의선,야당,70127,17357,87484
201603,2016,경의선,운정,127860,30925,158785
201603,2016,경의선,금릉,130500,24891,155391
201603,2016,경의선,금촌,188976,43720,232696
201603,2016,경의선,월롱,72477,8084,80561
201603,2016,경의선,파주,58168,7908,66076
201603,2016,경의선,문산,151174,45489,196663
201603,2016,경인선,개봉,616733,161923,778656
201603,2016,경인선,오류동,310146,90718,400864
201603,2016,경인선,온수,204210,46711,250921
201603,2016,경인선,도원,98828,36084,134912
201603,2016,경인선,간석,176470,48323,224793
201603,2016,경인선,부개,284066,65989,350055
201603,2016,경인선,소사,349459,86719,436178
201603,2016,경인선,구일,179537,31382,210919
201603,2016,경인선,인천,99547,44402,143949
201603,2016,경인선,동인천,504935,128418,633353
201603,2016,경인선,제물포,277362,51044,328406
201603,2016,경인선,주안,876428,130219,1006647
201603,2016,경인선,도화,89093,34414,123507
201603,2016,경인선,동암,683205,142126,825331
201603,2016,경인선,백운,236025,64394,300419
201603,2016,경인선,부평,1113808,146585,1260393
201603,2016,경인선,송내,1002226,122242,1124468
201603,2016,경인선,부천,1173740,212425,1386165
201603,2016,경인선,역곡,882426,139776,1022202
201603,2016,경인선,중동,267307,67971,335278
201603,2016,경춘선,춘천,60931,17541,78472
201603,2016,경춘선,김유정,11560,3558,15118
201603,2016,경춘선,남춘천,85335,24083,109418
201603,2016,경춘선,강촌,23435,4019,27454
201603,2016,경춘선,백양리,3782,903,4685
201603,2016,경춘선,굴봉산,4215,1839,6054
201603,2016,경춘선,가평,52632,12752,65384
201603,2016,경춘선,상천,9309,4999,14308
201603,2016,경춘선,청평,55903,15325,71228
201603,2016,경춘선,대성리,43720,5093,48813
201603,2016,경춘선,마석,88460,31068,119528
201603,2016,경춘선,천마산,26925,13002,39927
201603,2016,경춘선,평내호평,145100,41653,186753
201603,2016,경춘선,금곡,34864,15759,50623
201603,2016,경춘선,사릉,101798,18814,120612
201603,2016,경춘선,퇴계원,89316,24153,113469
201603,2016,경춘선,별내,60772,16197,76969
201603,2016,경춘선,갈매,9504,3357,12861
201603,2016,경춘선,신내,15614,6798,22412
201603,2016,공항철도 1호선,공덕,38789,6414,45203
201603,2016,공항철도 1호선,서울역,267702,31221,298923
201603,2016,공항철도 1호선,영종,5084,1942,7026
201603,2016,공항철도 1호선,인천국제공항,348509,38641,387150
201603,2016,공항철도 1호선,공항화물청사,68933,8005,76938
201603,2016,공항철도 1호선,운서,147323,29009,176332
201603,2016,공항철도 1호선,청라국제도시,141122,8717,149839
201603,2016,공항철도 1호선,검암,491573,44456,536029
201603,2016,공항철도 1호선,계양,310430,30995,341425
201603,2016,공항철도 1호선,홍대입구,234351,17361,251712
201603,2016,공항철도 1호선,디지털미디어시티,330210,21613,351823
201603,2016,공항철도 1호선,김포공항,266328,17775,284103
201603,2016,과천선,과천,140235,36458,176693
201603,2016,과천선,대공원,109249,45403,154652
201603,2016,과천선,경마공원,173991,61610,235601
201603,2016,과천선,선바위,260371,33881,294252
201603,2016,과천선,평촌,432364,63557,495921
201603,2016,과천선,인덕원,708675,103794,812469
201603,2016,과천선,정부과천청사,331707,67159,398866
201603,2016,과천선,범계,898965,112814,1011779
201603,2016,분당선,선릉,249639,28389,278028
201603,2016,분당선,매교,72042,18150,90192
201603,2016,분당선,도곡,173306,39669,212975
201603,2016,분당선,구룡,54981,19432,74413
201603,2016,분당선,개포동,100029,22701,122730
201603,2016,분당선,대모산입구,98565,31553,130118
201603,2016,분당선,수서,225579,51847,277426
201603,2016,분당선,복정,4,1,5
201603,2016,분당선,수원,306208,26921,333129
201603,2016,분당선,서울숲,172592,22315,194907
201603,2016,분당선,압구정로데오,431411,40818,472229
201603,2016,분당선,강남구청,245704,39994,285698
201603,2016,분당선,선정릉,214502,43296,257798
201603,2016,분당선,가천대,354668,23711,378379
201603,2016,분당선,태평,384677,87912,472589
201603,2016,분당선,모란,647958,170820,818778
201603,2016,분당선,야탑,746378,161743,908121
201603,2016,분당선,서현,709890,136014,845904
201603,2016,분당선,수내,353756,82529,436285
201603,2016,분당선,정자,455145,85709,540854
201603,2016,분당선,미금,518907,128732,647639
201603,2016,분당선,오리,385946,100202,486148
201603,2016,분당선,이매,134803,36799,171602
201603,2016,분당선,보정,69357,26519,95876
201603,2016,분당선,죽전,496794,86714,583508
201603,2016,분당선,구성,128796,41861,170657
201603,2016,분당선,신갈,116113,30939,147052
201603,2016,분당선,기흥,235343,31644,266987
201603,2016,분당선,상갈,138665,30765,169430
201603,2016,분당선,청명,121788,16524,138312
201603,2016,분당선,영통,271746,27235,298981
201603,2016,분당선,망포,365407,28826,394233
201603,2016,분당선,매탄권선,131976,13555,145531
201603,2016,분당선,수원시청,293967,34276,328243
201603,2016,분당선,한티,385620,70133,455753
201603,2016,수인선,달월,2029,1326,3355
201603,2016,수인선,월곶,71247,13868,85115
201603,2016,수인선,소래포구,120513,53430,173943
201603,2016,수인선,인천논현,150274,29985,180259
201603,2016,수인선,호구포,81330,14672,96002
201603,2016,수인선,남동인더스파크,56929,4581,61510
201603,2016,수인선,인천,26704,12024,38728
201603,2016,수인선,연수,118075,23700,141775
201603,2016,수인선,송도,78307,22106,100413
201603,2016,수인선,인하대,115808,13721,129529
201603,2016,수인선,숭의,46085,18658,64743
201603,2016,수인선,신포,36155,11817,47972
201603,2016,수인선,원인재,112353,24562,136915
201603,2016,안산선,산본,488603,106349,594952
201603,2016,안산선,대야미,108244,24130,132374
201603,2016,안산선,반월,138173,29777,167950
201603,2016,안산선,상록수,632180,89801,721981
201603,2016,안산선,한대앞,291453,43575,335028
201603,2016,안산선,중앙,514713,60390,575103
201603,2016,안산선,수리산,119862,33174,153036
201603,2016,안산선,초지,148686,17701,166387
201603,2016,안산선,안산,516976,47812,564788
201603,2016,안산선,신길온천,46799,9680,56479
201603,2016,안산선,정왕,314235,25573,339808
201603,2016,안산선,오이도,239921,33864,273785
201603,2016,안산선,고잔,267671,37583,305254
201603,2016,일산선,삼송,348632,79376,428008
201603,2016,일산선,주엽,209606,102709,312315
201603,2016,일산선,정발산,216552,59253,275805
201603,2016,일산선,마두,194523,82810,277333
201603,2016,일산선,백석,268220,78292,346512
201603,2016,일산선,대곡,38366,10835,49201
201603,2016,일산선,원흥,162030,38167,200197
201603,2016,일산선,대화,382634,93923,476557
201603,2016,일산선,원당,314379,91308,405687
201603,2016,일산선,화정,502144,140596,642740
201603,2016,장항선,신창,86135,8303,94438
201603,2016,장항선,온양온천,102063,68159,170222
201603,2016,장항선,배방,24837,7439,32276
201603,2016,장항선,아산,82479,8213,90692
201603,2016,장항선,쌍용동,90345,16911,107256
201603,2016,장항선,봉명,32064,14803,46867
201603,2016,중앙선,회기,914516,135656,1050172
201603,2016,중앙선,용문,47574,41772,89346
201603,2016,중앙선,상봉,143841,37369,181210
201603,2016,중앙선,망우,196529,70115,266644
201603,2016,중앙선,양원,49900,17249,67149
201603,2016,중앙선,구리,358744,86614,445358
201603,2016,중앙선,도농,241030,59297,300327
201603,2016,중앙선,양정,19423,8275,27698
201603,2016,중앙선,덕소,159131,51250,210381
201603,2016,중앙선,도심,65307,21771,87078
201603,2016,중앙선,팔당,18783,6288,25071
201603,2016,중앙선,운길산,29034,10285,39319
201603,2016,중앙선,양수,44159,17359,61518
201603,2016,중앙선,신원,5298,3588,8886
201603,2016,중앙선,국수,20924,9524,30448
201603,2016,중앙선,아신,21766,6770,28536
201603,2016,중앙선,오빈,6432,4076,10508
201603,2016,중앙선,양평,85990,35652,121642
201603,2016,중앙선,원덕,7420,5611,13031
201603,2016,중앙선,중랑,141397,52891,194288
201602,2016,6호선,삼각지,180597,17392,197989
201602,2016,6호선,효창공원앞,164480,39844,204324
201602,2016,6호선,공덕,400786,62671,463457
201602,2016,6호선,대흥,173461,37780,211241
201602,2016,6호선,광흥창,193493,51176,244669
201602,2016,6호선,상수,267123,20320,287443
201602,2016,6호선,합정,319981,33062,353043
201602,2016,6호선,망원,259465,73145,332610
201602,2016,6호선,마포구청,296348,69686,366034
201602,2016,6호선,월드컵경기장,126465,39878,166343
201602,2016,6호선,디지털미디어시티,342119,52879,394998
201602,2016,6호선,증산,224463,58897,283360
201602,2016,6호선,새절,278160,68961,347121
201602,2016,6호선,구산,171146,46024,217170
201602,2016,6호선,연신내,16,1,17
201602,2016,6호선,독바위,61246,17184,78430
201602,2016,6호선,불광,130117,33876,163993
201602,2016,6호선,봉화산(서울의료원),208178,43615,251793
201602,2016,6호선,응암,387363,91148,478511
201602,2016,5호선,개화산,135139,28732,163871
201602,2016,5호선,거여,149378,42499,191877
201602,2016,5호선,개롱,150517,36309,186826
201602,2016,5호선,오금,83913,14746,98659
201602,2016,5호선,방이,158558,34520,193078
201602,2016,5호선,올림픽공원,155399,27694,183093
201602,2016,5호선,둔촌동,285685,64735,350420
201602,2016,5호선,상일동,242756,53542,296298
201602,2016,5호선,고덕,174993,50105,225098
201602,2016,5호선,명일,172660,52349,225009
201602,2016,5호선,굽은다리,219622,52424,272046
201602,2016,5호선,길동,158680,48714,207394
201602,2016,5호선,강동,440954,79686,520640
201602,2016,5호선,천호,475053,126530,601583
201602,2016,5호선,광나루,324049,54305,378354
201602,2016,5호선,아차산,314586,78357,392943
201602,2016,5호선,군자,263556,31375,294931
201602,2016,5호선,장한평,420911,86042,506953
201602,2016,5호선,답십리,370276,71120,441396
201602,2016,5호선,마장,129413,39739,169152
201602,2016,5호선,왕십리(성동구청),119754,20998,140752
201602,2016,5호선,행당,183652,41255,224907
201602,2016,5호선,신금호,111551,29679,141230
201602,2016,5호선,청구,86937,22721,109658
201602,2016,5호선,동대문역사문화공원,71478,9682,81160
201602,2016,5호선,을지로4가,101393,35132,136525
201602,2016,5호선,종로3가,272829,111385,384214
201602,2016,5호선,광화문,883635,70697,954332
201602,2016,5호선,서대문,377839,65503,443342
201602,2016,5호선,충정로,101325,13936,115261
201602,2016,5호선,애오개,147478,33880,181358
201602,2016,5호선,공덕,298063,41251,339314
201602,2016,5호선,마포,338661,58208,396869
201602,2016,5호선,여의나루,156383,22903,179286
201602,2016,5호선,여의도,547306,45216,592522
201602,2016,4호선,충무로,759046,115139,874185
201602,2016,4호선,명동,1091823,63208,1155031
201602,2016,4호선,회현,605124,159306,764430
201602,2016,4호선,서울역,282315,34247,316562
201602,2016,4호선,숙대입구,386438,53132,439570
201602,2016,4호선,삼각지,105871,26636,132507
201602,2016,4호선,신용산,327402,47446,374848
201602,2016,4호선,이촌,205865,36050,241915
201602,2016,4호선,동작,45180,15597,60777
201602,2016,4호선,총신대입구,486426,121568,607994
201602,2016,4호선,사당,785028,81759,866787
201602,2016,4호선,상계,500063,101349,601412
201602,2016,5호선,방화,163080,38968,202048
201602,2016,5호선,마천,111614,43063,154677
201602,2016,5호선,김포공항,196124,23312,219436
201602,2016,5호선,송정,216640,54703,271343
201602,2016,5호선,마곡,75925,12505,88430
201602,2016,5호선,발산,250847,47198,298045
201602,2016,5호선,우장산,358808,66461,425269
201602,2016,5호선,화곡,676600,118406,795006
201602,2016,5호선,까치산,687990,130057,818047
201602,2016,5호선,신정,340697,50413,391110
201602,2016,5호선,목동,434140,70897,505037
201602,2016,5호선,오목교,626190,71661,697851
201602,2016,5호선,양평,141818,23961,165779
201602,2016,5호선,영등포구청,69523,15287,84810
201602,2016,5호선,영등포시장,157515,64671,222186
201602,2016,5호선,신길,69351,9814,79165
201602,2016,공항철도 1호선,계양,259239,25490,284729
201602,2016,공항철도 1호선,검암,419809,37210,457019
201602,2016,공항철도 1호선,청라국제도시,118356,7481,125837
201602,2016,공항철도 1호선,운서,136100,24286,160386
201602,2016,공항철도 1호선,공항화물청사,60941,6981,67922
201602,2016,경원선,도봉산,76122,46888,123010
201602,2016,경원선,망월사,157344,57649,214993
201602,2016,경원선,이촌,99635,25232,124867
201602,2016,경원선,서빙고,43730,14163,57893
201602,2016,경원선,한남,92904,29473,122377
201602,2016,경원선,옥수,1201,140,1341
201602,2016,경원선,응봉,36349,15788,52137
201602,2016,경원선,왕십리,399000,50196,449196
201602,2016,경원선,청량리(지상),315606,118542,434148
201602,2016,경원선,외대앞,263594,50567,314161
201602,2016,경원선,신이문,212955,56401,269356
201602,2016,경원선,석계,239426,54004,293430
201602,2016,경원선,광운대,201242,46018,247260
201602,2016,경원선,월계,96142,44066,140208
201602,2016,경원선,녹천,107327,31541,138868
201602,2016,경원선,의정부,545215,109077,654292
201602,2016,경의선,서울역,70869,8892,79761
201602,2016,경의선,신촌,18261,2815,21076
201602,2016,경의선,공덕,44484,8136,52620
201602,2016,경의선,서강대,48070,7664,55734
201602,2016,경의선,홍대입구,33526,3469,36995
201602,2016,경의선,가좌,74342,34541,108883
201602,2016,경의선,디지털미디어시티,50766,8315,59081
201602,2016,경의선,수색,42066,14226,56292
201602,2016,경의선,화전,34244,6653,40897
201602,2016,경의선,강매,49536,12077,61613
201602,2016,경의선,행신,163667,28526,192193
201602,2016,경의선,능곡,75496,23941,99437
201602,2016,경의선,곡산,9831,3455,13286
201602,2016,경의선,백마,145840,25960,171800
201602,2016,경의선,풍산,97944,22618,120562
201602,2016,경의선,일산,196846,47081,243927
201602,2016,경의선,탄현,171810,30860,202670
201602,2016,경의선,야당,53103,13370,66473
201602,2016,경의선,운정,101757,24325,126082
201602,2016,경의선,금릉,107525,20102,127627
201602,2016,경의선,금촌,157761,35884,193645
201602,2016,경의선,월롱,45534,6029,51563
201602,2016,경의선,파주,27559,5729,33288
201602,2016,경의선,문산,133597,36142,169739
201602,2016,경인선,개봉,498688,132152,630840
201602,2016,경인선,오류동,258275,73999,332274
201602,2016,경인선,온수,148702,37342,186044
201602,2016,경인선,도원,61435,29226,90661
201602,2016,경인선,간석,144275,39165,183440
201602,2016,경인선,부개,232121,53998,286119
201602,2016,경인선,소사,278011,71169,349180
201602,2016,경인선,구일,122671,23783,146454
201602,2016,경인선,인천,84395,28088,112483
201602,2016,경인선,동인천,439539,107823,547362
201602,2016,경인선,제물포,174438,40076,214514
201602,2016,경인선,도화,69535,27614,97149
201602,2016,경인선,주안,674866,110018,784884
201602,2016,경인선,동암,572813,118296,691109
201602,2016,경인선,백운,185537,53167,238704
201602,2016,경인선,부평,1010234,124045,1134279
201602,2016,경인선,송내,792518,99494,892012
201602,2016,경인선,부천,983082,179146,1162228
201602,2016,경인선,역곡,664258,116105,780363
201602,2016,경인선,중동,221781,54930,276711
201602,2016,경춘선,춘천,40882,13664,54546
201602,2016,경춘선,김유정,10313,2253,12566
201602,2016,경춘선,남춘천,62371,18831,81202
201602,2016,경춘선,강촌,16166,3026,19192
201602,2016,경춘선,백양리,9898,712,10610
201602,2016,경춘선,굴봉산,5970,1203,7173
201602,2016,경춘선,가평,53682,9581,63263
201602,2016,경춘선,상천,6837,2835,9672
201602,2016,경춘선,청평,55314,11877,67191
201602,2016,경춘선,대성리,17521,3488,21009
201602,2016,경춘선,마석,66268,24266,90534
201602,2016,경춘선,천마산,20926,10324,31250
201602,2016,경춘선,평내호평,115929,33450,149379
201602,2016,경춘선,금곡,25439,11786,37225
201602,2016,경춘선,사릉,76058,14714,90772
201602,2016,경춘선,퇴계원,70413,19249,89662
201602,2016,경춘선,별내,46206,12536,58742
201602,2016,경춘선,갈매,6157,2611,8768
201602,2016,경춘선,신내,11097,5109,16206
201602,2016,공항철도 1호선,서울역,260059,26814,286873
201602,2016,공항철도 1호선,공덕,34465,5348,39813
201602,2016,공항철도 1호선,인천국제공항,361003,33955,394958
201602,2016,분당선,강남구청,200559,32269,232828
201602,2016,분당선,압구정로데오,366369,32913,399282
201602,2016,분당선,서울숲,130448,17469,147917
201602,2016,분당선,수원,246432,22175,268607
201602,2016,분당선,복정,2,0,2
201602,2016,분당선,수서,183206,41426,224632
201602,2016,분당선,대모산입구,80354,25569,105923
201602,2016,분당선,개포동,79481,18562,98043
201602,2016,분당선,구룡,34302,15696,49998
201602,2016,분당선,도곡,136113,31361,167474
201602,2016,분당선,매교,55911,14778,70689
201602,2016,분당선,선릉,203622,22860,226482
201602,2016,분당선,서현,646804,109761,756565
201602,2016,분당선,수내,309307,67236,376543
201602,2016,1호선,제기동,256958,268469,525427
201602,2016,분당선,정자,391434,70495,461929
201602,2016,분당선,미금,452361,104258,556619
201602,2016,분당선,오리,336216,82456,418672
201602,2016,분당선,이매,106826,30070,136896
201602,2016,분당선,보정,55505,21421,76926
201602,2016,분당선,죽전,389554,71750,461304
201602,2016,분당선,구성,107731,33730,141461
201602,2016,분당선,신갈,102778,24853,127631
201602,2016,분당선,야탑,648353,130925,779278
201602,2016,분당선,모란,538316,134625,672941
201602,2016,분당선,태평,334658,72842,407500
201602,2016,분당선,가천대,157086,20702,177788
201602,2016,분당선,선정릉,172137,33252,205389
201602,2016,과천선,범계,760499,92504,853003
201602,2016,과천선,인덕원,562071,85461,647532
201602,2016,과천선,평촌,352277,51605,403882
201602,2016,과천선,선바위,203021,25972,228993
201602,2016,과천선,경마공원,127717,46616,174333
201602,2016,과천선,대공원,89618,32057,121675
201602,2016,과천선,과천,116413,29865,146278
201602,2016,과천선,정부과천청사,272476,55228,327704
201602,2016,공항철도 1호선,디지털미디어시티,272590,17383,289973
201602,2016,공항철도 1호선,홍대입구,199795,14260,214055
201602,2016,분당선,기흥,174072,25913,199985
201602,2016,분당선,상갈,117049,24877,141926
201602,2016,분당선,청명,98574,13052,111626
201602,2016,분당선,영통,210040,21627,231667
201602,2016,분당선,망포,301811,23453,325264
201602,2016,분당선,매탄권선,104313,10822,115135
201602,2016,분당선,수원시청,258739,27320,286059
201602,2016,분당선,한티,333656,54504,388160
201602,2016,수인선,달월,1558,881,2439
201602,2016,수인선,월곶,54514,10288,64802
201602,2016,수인선,소래포구,85496,29445,114941
201602,2016,수인선,인천논현,113186,22464,135650
201602,2016,수인선,호구포,61599,10860,72459
201602,2016,수인선,남동인더스파크,43338,3105,46443
201602,2016,수인선,인천,5993,2774,8767
201602,2016,수인선,연수,80636,15610,96246
201602,2016,수인선,송도,75097,15841,90938
201602,2016,수인선,인하대,8371,1929,10300
201602,2016,수인선,숭의,3617,2348,5965
201602,2016,수인선,신포,4029,1968,5997
201602,2016,수인선,원인재,83819,18111,101930
201602,2016,안산선,산본,414443,87328,501771
201602,2016,안산선,대야미,88798,18362,107160
201602,2016,안산선,반월,113598,23524,137122
201602,2016,안산선,상록수,490214,72144,562358
201602,2016,안산선,한대앞,207663,35066,242729
201602,2016,안산선,중앙,425861,47833,473694
201602,2016,안산선,수리산,97703,27241,124944
201602,2016,안산선,초지,90744,13826,104570
201602,2016,안산선,안산,466873,39176,506049
201602,2016,1호선,청량리(지하),516573,311123,827696
201602,2016,1호선,종로5가,534847,225244,760091
201602,2016,2호선,시청,635298,50608,685906
201602,2016,2호선,용두,42590,19770,62360
201602,2016,2호선,을지로3가,442428,77855,520283
201602,2016,2호선,을지로4가,268782,81477,350259
201602,2016,2호선,동대문역사문화공원,423955,48533,472488
201602,2016,2호선,신당,314620,94405,409025
201602,2016,2호선,상왕십리,238436,52398,290834
201602,2016,2호선,왕십리(성동구청),486588,52239,538827
201602,2016,2호선,한양대,202664,12921,215585
201602,2016,2호선,뚝섬,358011,56690,414701
201602,2016,2호선,성수,579671,84455,664126
201602,2016,2호선,건대입구,1156979,83099,1240078
201602,2016,2호선,구의,559122,93591,652713
201602,2016,2호선,강변,1288478,126316,1414794
201602,2016,2호선,잠실나루,399910,73838,473748
201602,2016,2호선,잠실,2183204,176020,2359224
201602,2016,2호선,신천,620275,98420,718695
201602,2016,2호선,종합운동장,274321,41967,316288
201602,2016,2호선,삼성,1399594,104186,1503780
201602,2016,2호선,선릉,1299501,172566,1472067
201602,2016,2호선,역삼,1108409,132453,1240862
201602,2016,2호선,강남,2723001,140426,2863427
201602,2016,2호선,교대,863928,140920,1004848
201602,2016,2호선,서초,528701,71067,599768
201602,2016,2호선,방배,452670,68888,521558
201602,2016,2호선,사당,1009851,165029,1174880
201602,2016,2호선,낙성대,735759,97332,833091
201602,2016,2호선,서울대입구,1226429,187507,1413936
201602,2016,2호선,봉천,516733,128768,645501
201602,2016,2호선,신림,1814519,218796,2033315
201602,2016,2호선,신대방,645680,108511,754191
201602,2016,2호선,구로디지털단지,1582033,142185,1724218
201602,2016,2호선,대림,758011,102133,860144
201602,2016,2호선,신도림,1568100,176086,1744186
201602,2016,2호선,문래,436468,71071,507539
201602,2016,2호선,영등포구청,484962,90778,575740
201602,2016,2호선,당산,517333,58087,575420
201602,2016,2호선,합정,842525,65295,907820
201602,2016,2호선,홍대입구,2058032,105835,2163867
201602,2016,2호선,신촌,1309035,128298,1437333
201602,2016,2호선,이대,495921,65528,561449
201602,2016,2호선,아현,209226,56553,265779
201602,2016,2호선,충정로,261261,48353,309614
201602,2016,2호선,용답,53344,14376,67720
201602,2016,2호선,신답,26504,8589,35093
201602,2016,2호선,신설동,79354,30464,109818
201602,2016,2호선,도림천,21565,5085,26650
201602,2016,2호선,양천구청,154380,39184,193564
201602,2016,2호선,신정네거리,238761,57309,296070
201602,2016,2호선,을지로입구,1307211,102571,1409782
201602,2016,3호선,지축,22574,9743,32317
201602,2016,3호선,오금,158509,21689,180198
201602,2016,3호선,연신내,916111,220504,1136615
201602,2016,3호선,불광,400913,129739,530652
201602,2016,3호선,녹번,325543,70232,395775
201602,2016,3호선,홍제,410205,131727,541932
201602,2016,3호선,무악재,87526,29064,116590
201602,2016,3호선,독립문,138876,61558,200434
201602,2016,3호선,경복궁,530191,75436,605627
201602,2016,3호선,안국,585354,111286,696640
201602,2016,3호선,종로3가,170566,56871,227437
201602,2016,3호선,을지로3가,190830,53322,244152
201602,2016,3호선,충무로,27,7,34
201602,2016,3호선,동대입구,241609,30611,272220
201602,2016,3호선,약수,315802,77132,392934
201602,2016,3호선,금호,168837,46107,214944
201602,2016,3호선,옥수,223290,48310,271600
201602,2016,3호선,압구정,871114,124637,995751
201602,2016,3호선,신사,798215,65211,863426
201602,2016,3호선,잠원,118343,26764,145107
201602,2016,3호선,고속터미널,1491196,156975,1648171
201602,2016,3호선,교대,306671,54789,361460
201602,2016,3호선,남부터미널,919608,114414,1034022
201602,2016,3호선,양재,963014,137052,1100066
201602,2016,3호선,매봉,270395,48681,319076
201602,2016,3호선,도곡,164589,25018,189607
201602,2016,3호선,대치,281551,57892,339443
201602,2016,3호선,학여울,91169,12150,103319
201602,2016,3호선,대청,232600,43526,276126
201602,2016,3호선,일원,197685,53567,251252
201602,2016,3호선,수서,250775,72869,323644
201602,2016,3호선,가락시장,186982,55615,242597
201602,2016,3호선,경찰병원,170392,32343,202735
201602,2016,3호선,구파발,384522,74764,459286
201602,2016,4호선,당고개,292344,79929,372273
201602,2016,4호선,남태령,25359,7267,32626
201602,2016,4호선,노원,579021,79725,658746
201602,2016,4호선,창동,657959,157130,815089
201602,2016,4호선,쌍문,774649,144881,919530
201602,2016,4호선,수유(강북구청),1023069,222586,1245655
201602,2016,4호선,미아,400296,116223,516519
201602,2016,4호선,미아사거리,764639,168046,932685
201602,2016,4호선,길음,602016,129375,731391
201602,2016,4호선,성신여대입구,620352,91790,712142
201602,2016,4호선,한성대입구,357253,71766,429019
201602,2016,4호선,혜화,1066564,115200,1181764
201602,2016,4호선,동대문,544008,123937,667945
201602,2016,4호선,동대문역사문화공원,557241,56179,613420
201602,2016,안산선,신길온천,37603,7350,44953
201602,2016,안산선,정왕,209001,20122,229123
201602,2016,안산선,오이도,189837,22687,212524
201602,2016,안산선,고잔,212178,29653,241831
201602,2016,일산선,삼송,273491,65316,338807
201602,2016,일산선,주엽,177560,82800,260360
201602,2016,일산선,정발산,204795,46711,251506
201602,2016,일산선,마두,165922,67834,233756
201602,2016,일산선,백석,232785,63441,296226
201602,2016,일산선,대곡,28922,7518,36440
201602,2016,일산선,원흥,128075,30383,158458
201602,2016,일산선,대화,305297,77828,383125
201602,2016,일산선,원당,258122,73118,331240
201602,2016,일산선,화정,426849,114408,541257
201602,2016,장항선,신창,33805,6412,40217
201602,2016,장항선,온양온천,89258,60500,149758
201602,2016,장항선,배방,19953,5861,25814
201602,2016,장항선,아산,58292,6165,64457
201602,2016,장항선,쌍용동,48242,12359,60601
201602,2016,경원선,도봉,120159,57516,177675
201602,2016,경원선,방학,190575,88985,279560
201602,2016,경원선,소요산,59346,52657,112003
201602,2016,경원선,동두천,43451,15300,58751
201602,2016,경원선,보산,39659,11927,51586
201602,2016,경원선,동두천 중앙,75957,33472,109429
201602,2016,경원선,지행,158325,36551,194876
201602,2016,경원선,덕정,146916,28967,175883
201602,2016,경원선,덕계,42868,13827,56695
201602,2016,경원선,양주,203221,42461,245682
201602,2016,경원선,녹양,106958,26989,133947
201602,2016,경원선,가능,150999,52374,203373
201602,2016,경원선,창동,6,1,7
201602,2016,경원선,회룡,252266,113077,365343
201602,2016,경부선,가산디지털단지,403068,25878,428946
201602,2016,경부선,신도림,71533,13670,85203
201602,2016,경부선,영등포,1251238,236039,1487277
201602,2016,경부선,대방,355840,63330,419170
201602,2016,경부선,노량진,512775,57787,570562
201602,2016,경부선,용산,1058443,122191,1180634
201602,2016,경부선,남영,257545,36132,293677
201602,2016,경부선,서울역,33,3,36
201602,2016,경부선,광명,21396,1132,22528
201602,2016,경부선,서동탄,36263,7045,43308
201602,2016,경부선,당정,162229,26055,188284
201602,2016,경부선,천안,170151,55167,225318
201602,2016,경부선,두정,130278,19362,149640
201602,2016,경부선,직산,22288,4667,26955
201602,2016,경부선,성환,83776,17184,100960
201602,2016,경부선,평택,317748,57077,374825
201602,2016,경부선,지제,19798,3286,23084
201602,2016,경부선,서정리,102409,20972,123381
201602,2016,경부선,송탄,110408,21422,131830
201602,2016,경부선,진위,35556,6017,41573
201602,2016,경부선,오산,245503,35628,281131
201602,2016,경부선,오산대,53762,9568,63330
201602,2016,경부선,세마,57806,10801,68607
201602,2016,경부선,병점,343481,47899,391380
201602,2016,경부선,세류,96697,15819,112516
201602,2016,경부선,독산,365725,56604,422329
201602,2016,경부선,수원,1113483,124315,1237798
201602,2016,경부선,화서,189337,35361,224698
201602,2016,경부선,성균관대,378732,46200,424932
201602,2016,경부선,의왕,194773,32122,226895
201602,2016,경부선,군포,167571,28425,195996
201602,2016,경부선,금정,695886,89487,785373
201602,2016,경부선,명학,228437,35145,263582
201602,2016,경부선,안양,635596,98510,734106
201602,2016,경부선,관악,189345,46272,235617
201602,2016,경부선,석수,267654,38826,306480
201602,2016,경부선,금천구청,243185,64054,307239
201602,2016,경부선,신길,241744,40114,281858
201602,2016,경부선,구로,519293,80267,599560
201602,2016,공항철도 1호선,김포공항,255293,14992,270285
201602,2016,9호선2단계,종합운동장,125289,9847,135136
201602,2016,9호선2단계,선정릉,143749,15271,159020
201602,2016,9호선2단계,삼성중앙,102396,15161,117557
201602,2016,9호선2단계,봉은사,268846,28155,297001
201602,2016,9호선2단계,언주,170940,17607,188547
201602,2016,9호선,구반포,68973,19675,88648
201602,2016,9호선,동작,39468,10774,50242
201602,2016,9호선,흑석(중앙대입구),208605,47433,256038
201602,2016,9호선,노들,106416,25736,132152
201602,2016,9호선,노량진,652286,68857,721143
201602,2016,9호선,샛강,114837,20550,135387
201602,2016,9호선,여의도,454538,33712,488250
201602,2016,9호선,국회의사당,335755,42493,378248
201602,2016,9호선,당산,417566,52038,469604
201602,2016,9호선,선유도,152143,20892,173035
201602,2016,9호선,신목동,93087,14384,107471
201602,2016,9호선,염창,369384,49387,418771
201602,2016,9호선,등촌,217482,69358,286840
201602,2016,9호선,증미,160146,35489,195635
201602,2016,9호선,가양,445370,104005,549375
201602,2016,9호선,양천향교,162349,32709,195058
201602,2016,9호선,마곡나루,48686,7162,55848
201602,2016,장항선,봉명,25156,12186,37342
201602,2016,중앙선,회기,653894,111166,765060
201602,2016,중앙선,용문,41943,28955,70898
201602,2016,중앙선,상봉,119152,29745,148897
201602,2016,중앙선,망우,160885,56562,217447
201602,2016,중앙선,양원,32671,13786,46457
201602,2016,중앙선,구리,308369,69821,378190
201602,2016,중앙선,도농,191537,47972,239509
201602,2016,중앙선,양정,15956,5801,21757
201602,2016,중앙선,덕소,129006,41117,170123
201602,2016,중앙선,도심,50678,17314,67992
201602,2016,중앙선,팔당,12942,4334,17276
201602,2016,중앙선,운길산,20641,6353,26994
201602,2016,중앙선,양수,35828,12970,48798
201602,2016,중앙선,신원,3768,2248,6016
201602,2016,중앙선,국수,14725,6665,21390
201602,2016,중앙선,아신,15341,5261,20602
201602,2016,중앙선,오빈,5644,2932,8576
201602,2016,중앙선,양평,74274,26616,100890
201602,2016,중앙선,원덕,6336,3735,10071
201602,2016,중앙선,중랑,120564,43256,163820
201602,2016,9호선,신방화,172204,35798,208002
201602,2016,9호선,공항시장,63767,18255,82022
201602,2016,9호선,신반포,66619,17930,84549
201602,2016,9호선,고속터미널,433001,44426,477427
201602,2016,9호선,사평,60012,11976,71988
201602,2016,9호선,신논현,756199,43192,799391
201602,2016,9호선,김포공항,237028,15607,252635
201602,2016,9호선,개화,139431,25939,165370
201602,2016,8호선,천호,448190,79096,527286
201602,2016,8호선,수진,109668,35343,145011
201602,2016,8호선,신흥,110316,44627,154943
201602,2016,8호선,단대오거리,283113,61028,344141
201602,2016,8호선,남한산성입구,312355,62744,375099
201602,2016,8호선,산성,163854,34537,198391
201602,2016,8호선,복정,176360,27639,203999
201602,2016,8호선,장지,333119,46820,379939
201602,2016,8호선,문정,143939,25513,169452
201602,2016,8호선,가락시장,140871,39028,179899
201602,2016,8호선,송파,110763,29282,140045
201602,2016,8호선,석촌,194231,49306,243537
201602,2016,8호선,잠실,305309,49359,354668
201602,2016,8호선,몽촌토성,131037,32284,163321
201602,2016,8호선,강동구청,226882,50459,277341
201602,2016,8호선,모란,82198,44486,126684
201602,2016,8호선,암사,398562,74875,473437
201602,2016,7호선,부평구청,295679,24360,320039
201602,2016,7호선,굴포천,213722,25975,239697
201602,2016,7호선,삼산체육관,126876,18740,145616
201602,2016,7호선,상동,344486,35975,380461
201602,2016,7호선,부천시청,306768,34871,341639
201602,2016,7호선,신중동,347017,38484,385501
201602,2016,7호선,춘의,194602,21855,216457
201602,2016,7호선,부천종합운동장,126092,13633,139725
201602,2016,7호선,까치울,140122,16929,157051
201602,2016,7호선,온수,248428,28065,276493
201602,2016,7호선,천왕,183451,36704,220155
201602,2016,7호선,광명사거리,642183,126365,768548
201602,2016,7호선,철산,589256,83240,672496
201602,2016,7호선,가산디지털단지,1070777,70794,1141571
201602,2016,7호선,남구로,403318,52629,455947
201602,2016,7호선,대림,286575,30555,317130
201602,2016,7호선,신풍,269181,58028,327209
201602,2016,7호선,보라매,218798,36487,255285
201602,2016,7호선,신대방삼거리,351251,79636,430887
201602,2016,7호선,장승배기,223579,64014,287593
201602,2016,7호선,상도,234511,52502,287013
201602,2016,7호선,숭실대입구,320887,50559,371446
201602,2016,7호선,남성,250819,57898,308717
201602,2016,7호선,이수,400648,67220,467868
201602,2016,7호선,내방,318971,53807,372778
201602,2016,7호선,고속터미널,581699,69255,650954
201602,2016,7호선,반포,147815,26174,173989
201602,2016,7호선,논현,480235,44623,524858
201602,2016,7호선,학동,537627,55965,593592
201602,2016,7호선,강남구청,375478,42164,417642
201602,2016,7호선,청담,505593,64749,570342
201602,2016,7호선,뚝섬유원지,180289,32830,213119
201602,2016,7호선,건대입구,421014,45646,466660
201602,2016,7호선,어린이대공원,327548,37512,365060
201602,2016,7호선,군자,344560,66220,410780
201602,2016,7호선,중곡,228918,51632,280550
201602,2016,7호선,용마산,145080,30934,176014
201602,2016,7호선,사가정,372657,79194,451851
201602,2016,7호선,면목,344933,70642,415575
201602,2016,7호선,상봉,418835,63546,482381
201602,2016,7호선,중화,269945,51610,321555
201602,2016,7호선,먹골,242897,50416,293313
201602,2016,7호선,태릉입구,186952,31095,218047
201602,2016,7호선,공릉,277609,57743,335352
201602,2016,7호선,하계,467278,90906,558184
201602,2016,7호선,중계,346447,79119,425566
201602,2016,7호선,노원,506279,96679,602958
201602,2016,7호선,마들,272790,64017,336807
201602,2016,7호선,수락산,319745,74005,393750
201602,2016,7호선,도봉산,262493,53211,315704
201602,2016,7호선,장암,57862,6396,64258
201602,2016,6호선,역촌,74466,28004,102470
201602,2016,6호선,화랑대,287908,39074,326982
201602,2016,6호선,태릉입구,111333,22734,134067
201602,2016,6호선,석계,288538,62034,350572
201602,2016,6호선,돌곶이,203757,54396,258153
201602,2016,1호선,신설동,327179,106767,433946
201602,2016,1호선,동대문,321355,115831,437186
201602,2016,1호선,동묘앞,147909,117437,265346
201602,2016,1호선,종로3가,712684,330776,1043460
201602,2016,1호선,종각,1162764,134729,1297493
201602,2016,1호선,시청,576113,78139,654252
201602,2016,1호선,서울역,1601463,193565,1795028
201602,2016,6호선,상월곡,134046,32315,166361
201602,2016,6호선,월곡,266871,63722,330593
201602,2016,6호선,고려대,217692,31325,249017
201602,2016,6호선,안암,294319,27524,321843
201602,2016,6호선,보문,194364,33442,227806
201602,2016,6호선,창신,72962,15945,88907
201602,2016,6호선,동묘앞,195019,56762,251781
201602,2016,6호선,신당,187659,31941,219600
201602,2016,6호선,청구,86222,16325,102547
201602,2016,6호선,약수,77560,20407,97967
201602,2016,6호선,버티고개,52340,12336,64676
201602,2016,6호선,한강진,153418,11420,164838
201602,2016,6호선,이태원,410464,32958,443422
201602,2016,6호선,녹사평(용산구청),175061,18487,193548
201601,2016,5호선,방화,175357,41234,216591
201601,2016,경인선,백운,200280,56316,256596
201601,2016,경인선,부평,1031628,132506,1164134
201601,2016,경인선,송내,860817,105061,965878
201601,2016,경인선,부천,1040328,191322,1231650
201601,2016,경인선,역곡,715490,123143,838633
201601,2016,경인선,중동,237744,59415,297159
201601,2016,경춘선,춘천,39546,15034,54580
201601,2016,경춘선,김유정,9771,2349,12120
201601,2016,경춘선,남춘천,62369,20269,82638
201601,2016,경춘선,강촌,16918,3046,19964
201601,2016,경춘선,백양리,11486,791,12277
201601,2016,경춘선,굴봉산,5545,1094,6639
201601,2016,경춘선,가평,51944,9958,61902
201601,2016,경춘선,상천,6935,3031,9966
201601,2016,경춘선,청평,56436,12229,68665
201601,2016,경춘선,대성리,19969,3588,23557
201601,2016,경춘선,마석,67067,25497,92564
201601,2016,경춘선,천마산,21449,11001,32450
201601,2016,경춘선,평내호평,121215,35238,156453
201601,2016,경춘선,금곡,26519,12714,39233
201601,2016,경춘선,사릉,78848,15323,94171
201601,2016,경춘선,퇴계원,74196,20447,94643
201601,2016,경춘선,별내,49127,13154,62281
201601,2016,경춘선,갈매,6819,3379,10198
201601,2016,경춘선,신내,11599,5624,17223
201601,2016,공항철도 1호선,서울역,266601,28637,295238
201601,2016,공항철도 1호선,공덕,35688,5910,41598
201601,2016,공항철도 1호선,인천국제공항,362487,31706,394193
201601,2016,공항철도 1호선,공항화물청사,64998,7528,72526
201601,2016,공항철도 1호선,운서,143789,26241,170030
201601,2016,공항철도 1호선,청라국제도시,128689,7684,136373
201601,2016,공항철도 1호선,검암,449471,39209,488680
201601,2016,공항철도 1호선,계양,279493,26460,305953
201601,2016,공항철도 1호선,김포공항,258953,16072,275025
201601,2016,공항철도 1호선,홍대입구,212612,15649,228261
201601,2016,공항철도 1호선,디지털미디어시티,296825,18814,315639
201601,2016,과천선,정부과천청사,300759,59216,359975
201601,2016,과천선,과천,124991,32091,157082
201601,2016,과천선,대공원,86508,31374,117882
201601,2016,과천선,경마공원,195669,66438,262107
201601,2016,과천선,선바위,226074,27600,253674
201601,2016,과천선,평촌,388327,55846,444173
201601,2016,3호선,수서,275871,78154,354025
201601,2016,3호선,일원,215022,53643,268665
201601,2016,3호선,대청,254390,46389,300779
201601,2016,3호선,학여울,80309,19659,99968
201601,2016,3호선,대치,310243,59567,369810
201601,2016,3호선,도곡,178429,26251,204680
201601,2016,3호선,매봉,300943,51999,352942
201601,2016,3호선,양재,1083643,149460,1233103
201601,2016,3호선,남부터미널,982654,120253,1102907
201601,2016,3호선,교대,340672,60017,400689
201601,2016,3호선,고속터미널,1512162,167909,1680071
201601,2016,9호선,고속터미널,440735,46876,487611
201601,2016,6호선,안암,313353,29571,342924
201601,2016,6호선,보문,210652,36092,246744
201601,2016,6호선,창신,76932,17782,94714
201601,2016,6호선,동묘앞,206408,63546,269954
201601,2016,6호선,신당,211995,34651,246646
201601,2016,6호선,청구,92836,17122,109958
201601,2016,6호선,약수,84710,21710,106420
201601,2016,6호선,버티고개,58459,13219,71678
201601,2016,6호선,한강진,167072,12250,179322
201601,2016,6호선,이태원,437026,35194,472220
201601,2016,6호선,녹사평(용산구청),185562,19528,205090
201601,2016,6호선,삼각지,200495,19542,220037
201601,2016,6호선,효창공원앞,179753,42415,222168
201601,2016,6호선,공덕,444882,68195,513077
201601,2016,6호선,대흥,190763,40512,231275
201601,2016,6호선,광흥창,216567,53531,270098
201601,2016,6호선,상수,294146,21332,315478
201601,2016,6호선,합정,347924,34964,382888
201601,2016,6호선,망원,282486,78090,360576
201601,2016,6호선,마포구청,320451,75058,395509
201601,2016,6호선,월드컵경기장,128332,42077,170409
201601,2016,9호선,신반포,73730,19551,93281
201601,2016,9호선,공항시장,68325,19526,87851
201601,2016,9호선,신방화,185984,38455,224439
201601,2016,9호선,마곡나루,52008,7313,59321
201601,2016,9호선,양천향교,177199,34635,211834
201601,2016,7호선,노원,537235,105442,642677
201601,2016,중앙선,중랑,127515,46501,174016
201601,2016,중앙선,원덕,6121,4152,10273
201601,2016,중앙선,양평,73818,27674,101492
201601,2016,중앙선,오빈,5878,3079,8957
201601,2016,중앙선,아신,15279,5288,20567
201601,2016,중앙선,국수,13811,7085,20896
201601,2016,중앙선,신원,3946,2287,6233
201601,2016,중앙선,양수,37162,13442,50604
201601,2016,중앙선,운길산,21778,6469,28247
201601,2016,7호선,마들,294825,68008,362833
201601,2016,7호선,수락산,343043,78931,421974
201601,2016,7호선,부평구청,323123,26383,349506
201601,2016,7호선,장암,63229,6652,69881
201601,2016,6호선,역촌,81412,30343,111755
201601,2016,6호선,화랑대,315359,42022,357381
201601,2016,6호선,태릉입구,120289,24760,145049
201601,2016,6호선,석계,312816,66510,379326
201601,2016,6호선,돌곶이,220774,59733,280507
201601,2016,6호선,상월곡,144237,34416,178653
201601,2016,6호선,월곡,283578,68578,352156
201601,2016,6호선,고려대,232135,33738,265873
201601,2016,7호선,하계,499662,96648,596310
201601,2016,7호선,공릉,297826,62773,360599
201601,2016,7호선,태릉입구,203624,33074,236698
201601,2016,7호선,먹골,261917,54559,316476
201601,2016,7호선,중화,290318,56444,346762
201601,2016,7호선,상봉,453594,68077,521671
201601,2016,7호선,면목,367935,75121,443056
201601,2016,7호선,사가정,400602,85047,485649
201601,2016,7호선,용마산,155344,32658,188002
201601,2016,7호선,중곡,248143,56087,304230
201601,2016,7호선,군자,371787,71086,442873
201601,2016,7호선,어린이대공원,357494,40405,397899
201601,2016,9호선,가양,483766,109471,593237
201601,2016,9호선,증미,177902,37521,215423
201601,2016,9호선,등촌,236121,74116,310237
201601,2016,9호선,염창,401395,52513,453908
201601,2016,9호선,신목동,100309,15098,115407
201601,2016,9호선,선유도,170366,23065,193431
201601,2016,9호선,당산,457042,55312,512354
201601,2016,9호선,국회의사당,383393,48580,431973
201601,2016,9호선,여의도,504233,36647,540880
201601,2016,9호선,샛강,129047,22325,151372
201601,2016,9호선,노량진,702342,73991,776333
201601,2016,9호선,노들,115866,27788,143654
201601,2016,9호선,흑석(중앙대입구),229574,50793,280367
201601,2016,9호선,동작,40794,11637,52431
201601,2016,9호선,구반포,75622,21310,96932
201601,2016,9호선2단계,언주,192500,19256,211756
201601,2016,9호선2단계,봉은사,287956,29310,317266
201601,2016,9호선2단계,삼성중앙,113455,15925,129380
201601,2016,9호선2단계,선정릉,157223,15069,172292
201601,2016,9호선2단계,종합운동장,136444,10471,146915
201601,2016,경부선,구로,558482,85674,644156
201601,2016,경부선,신길,261066,43152,304218
201601,2016,경부선,금천구청,258247,67877,326124
201601,2016,경부선,석수,288503,41828,330331
201601,2016,경부선,관악,204917,49172,254089
201601,2016,경부선,안양,654394,106609,761003
201601,2016,경부선,명학,250787,37660,288447
201601,2016,경부선,금정,755921,95950,851871
201601,2016,경부선,군포,181711,29825,211536
201601,2016,경부선,의왕,210948,34536,245484
201601,2016,경부선,성균관대,398873,49031,447904
201601,2016,경부선,화서,203219,37443,240662
201601,2016,경부선,수원,1120534,133537,1254071
201601,2016,경부선,독산,398736,61460,460196
201601,2016,경부선,세류,102169,16897,119066
201601,2016,경부선,병점,358485,49879,408364
201601,2016,경부선,세마,60181,11462,71643
201601,2016,경부선,오산대,55554,9767,65321
201601,2016,경부선,오산,248804,37883,286687
201601,2016,경부선,진위,36935,6345,43280
201601,2016,3호선,잠원,129167,28548,157715
201601,2016,3호선,신사,875395,71764,947159
201601,2016,3호선,압구정,958140,134122,1092262
201601,2016,3호선,옥수,240267,50834,291101
201601,2016,3호선,금호,181562,48772,230334
201601,2016,3호선,약수,341775,83040,424815
201601,2016,3호선,동대입구,273921,34737,308658
201601,2016,3호선,충무로,36,2,38
201601,2016,3호선,을지로3가,213484,57313,270797
201601,2016,3호선,종로3가,183749,57437,241186
201601,2016,3호선,안국,641414,118929,760343
201601,2016,3호선,경복궁,560709,79124,639833
201601,2016,3호선,독립문,151199,65472,216671
201601,2016,3호선,무악재,94627,30741,125368
201601,2016,3호선,홍제,440271,140864,581135
201601,2016,3호선,녹번,354254,74343,428597
201601,2016,3호선,불광,429368,139030,568398
201601,2016,3호선,연신내,977506,235266,1212772
201601,2016,3호선,오금,174590,22845,197435
201601,2016,3호선,지축,24013,10651,34664
201601,2016,2호선,을지로입구,1434463,115093,1549556
201601,2016,2호선,신정네거리,256936,61542,318478
201601,2016,2호선,양천구청,169267,41652,210919
201601,2016,2호선,도림천,23149,5312,28461
201601,2016,2호선,신설동,87859,34297,122156
201601,2016,2호선,신답,28757,9454,38211
201601,2016,2호선,용답,57424,15650,73074
201601,2016,2호선,충정로,285895,50570,336465
201601,2016,2호선,아현,225444,60391,285835
201601,2016,2호선,이대,526609,66528,593137
201601,2016,2호선,신촌,1419109,138371,1557480
201601,2016,2호선,홍대입구,2179099,112125,2291224
201601,2016,2호선,합정,915458,69464,984922
201601,2016,2호선,당산,567386,61694,629080
201601,2016,7호선,건대입구,453050,49147,502197
201601,2016,7호선,뚝섬유원지,195345,34118,229463
201601,2016,2호선,영등포구청,533130,97499,630629
201601,2016,2호선,문래,480939,74215,555154
201601,2016,2호선,신도림,1701314,190617,1891931
201601,2016,2호선,대림,822355,110322,932677
201601,2016,2호선,구로디지털단지,1738572,152707,1891279
201601,2016,2호선,신대방,698756,116150,814906
201601,2016,2호선,신림,1966029,234170,2200199
201601,2016,2호선,봉천,565017,139403,704420
201601,2016,2호선,서울대입구,1352902,201948,1554850
201601,2016,2호선,낙성대,811029,103179,914208
201601,2016,2호선,사당,1125104,175888,1300992
201601,2016,2호선,방배,502519,73344,575863
201601,2016,2호선,서초,586845,76244,663089
201601,2016,2호선,교대,959260,152328,1111588
201601,2016,2호선,강남,3104249,157889,3262138
201601,2016,2호선,역삼,1253194,150766,1403960
201601,2016,2호선,선릉,1465441,189289,1654730
201601,2016,2호선,삼성,1549413,118672,1668085
201601,2016,2호선,종합운동장,303837,44621,348458
201601,2016,2호선,신천,681243,106181,787424
201601,2016,2호선,잠실,2326533,190560,2517093
201601,2016,2호선,잠실나루,444382,79774,524156
201601,2016,2호선,강변,1338455,132910,1471365
201601,2016,2호선,구의,616515,101584,718099
201601,2016,2호선,건대입구,1243959,89189,1333148
201601,2016,2호선,성수,639332,92294,731626
201601,2016,2호선,뚝섬,386445,61320,447765
201601,2016,2호선,한양대,226340,13879,240219
201601,2016,2호선,왕십리(성동구청),520542,56924,577466
201601,2016,2호선,상왕십리,260504,56593,317097
201601,2016,2호선,신당,339215,102217,441432
201601,2016,2호선,동대문역사문화공원,456406,52972,509378
201601,2016,2호선,을지로4가,289057,93873,382930
201601,2016,2호선,을지로3가,502540,86510,589050
201601,2016,2호선,용두,44030,22014,66044
201601,2016,2호선,시청,713718,56188,769906
201601,2016,1호선,종로5가,583953,240818,824771
201601,2016,1호선,청량리(지하),548716,342495,891211
201601,2016,1호선,제기동,279307,306695,586002
201601,2016,1호선,신설동,359584,116691,476275
201601,2016,1호선,동대문,334099,125120,459219
201601,2016,1호선,동묘앞,157114,124221,281335
201601,2016,1호선,종로3가,813525,359714,1173239
201601,2016,1호선,종각,1311062,146465,1457527
201601,2016,1호선,시청,661266,88127,749393
201601,2016,1호선,서울역,1682629,208109,1890738
201601,2016,경부선,송탄,112843,22905,135748
201601,2016,경부선,서정리,105451,23335,128786
201601,2016,경부선,지제,21084,3554,24638
201601,2016,경부선,평택,319109,61053,380162
201601,2016,경부선,성환,80490,18388,98878
201601,2016,경부선,직산,23069,4814,27883
201601,2016,경부선,두정,138468,21002,159470
201601,2016,경부선,천안,163686,57474,221160
201601,2016,경부선,당정,175977,27706,203683
201601,2016,경부선,서동탄,38947,7503,46450
201601,2016,경부선,광명,22355,1181,23536
201601,2016,경부선,서울역,37,1,38
201601,2016,경부선,남영,283046,38370,321416
201601,2016,경부선,용산,1067633,130144,1197777
201601,2016,경부선,노량진,585131,64312,649443
201601,2016,경부선,대방,395636,68368,464004
201601,2016,7호선,중계,375055,83554,458609
201601,2016,7호선,청담,566470,68866,635336
201601,2016,7호선,강남구청,419768,45455,465223
201601,2016,7호선,학동,601204,60056,661260
201601,2016,7호선,논현,534524,48608,583132
201601,2016,7호선,반포,159435,27631,187066
201601,2016,7호선,고속터미널,596718,72698,669416
201601,2016,7호선,내방,355081,57629,412710
201601,2016,7호선,이수,433182,72548,505730
201601,2016,7호선,남성,272731,62491,335222
201601,2016,7호선,숭실대입구,346820,54446,401266
201601,2016,7호선,상도,257022,55525,312547
201601,2016,7호선,장승배기,239416,67550,306966
201601,2016,7호선,신대방삼거리,380230,83919,464149
201601,2016,7호선,보라매,238233,40383,278616
201601,2016,7호선,신풍,286003,62915,348918
201601,2016,7호선,대림,301301,33112,334413
201601,2016,7호선,남구로,436918,56364,493282
201601,2016,7호선,가산디지털단지,1183678,76588,1260266
201601,2016,7호선,철산,636198,88948,725146
201601,2016,7호선,광명사거리,684475,135407,819882
201601,2016,7호선,천왕,194447,38977,233424
201601,2016,7호선,온수,264576,29968,294544
201601,2016,7호선,까치울,149666,17744,167410
201601,2016,7호선,부천종합운동장,137620,14567,152187
201601,2016,7호선,춘의,210513,23319,233832
201601,2016,7호선,신중동,377480,41753,419233
201601,2016,7호선,부천시청,325747,37176,362923
201601,2016,7호선,상동,376278,38545,414823
201601,2016,7호선,삼산체육관,135595,20049,155644
201601,2016,7호선,굴포천,229327,28566,257893
201601,2016,7호선,도봉산,282422,57044,339466
201601,2016,8호선,암사,432954,79943,512897
201601,2016,8호선,천호,486748,86523,573271
201601,2016,8호선,강동구청,251211,55202,306413
201601,2016,8호선,몽촌토성,149210,34821,184031
201601,2016,8호선,잠실,330070,54379,384449
201601,2016,8호선,석촌,215160,52963,268123
201601,2016,8호선,송파,118165,31518,149683
201601,2016,8호선,가락시장,154562,42202,196764
201601,2016,8호선,문정,151645,27036,178681
201601,2016,8호선,장지,360354,49998,410352
201601,2016,8호선,복정,185614,29751,215365
201601,2016,8호선,산성,176970,36161,213131
201601,2016,8호선,남한산성입구,338291,68459,406750
201601,2016,8호선,단대오거리,302948,66042,368990
201601,2016,8호선,신흥,115672,47118,162790
201601,2016,8호선,수진,116148,38411,154559
201601,2016,8호선,모란,86754,47929,134683
201601,2016,9호선,개화,148081,28055,176136
201601,2016,9호선,김포공항,243447,16602,260049
201601,2016,9호선,신논현,858551,46478,905029
201601,2016,9호선,사평,64984,12322,77306
201601,2016,6호선,디지털미디어시티,374081,56539,430620
201601,2016,6호선,증산,242279,61956,304235
201601,2016,6호선,새절,299387,72910,372297
201601,2016,6호선,구산,181455,49494,230949
201601,2016,6호선,연신내,16,0,16
201601,2016,6호선,독바위,65956,18543,84499
201601,2016,6호선,불광,136006,36418,172424
201601,2016,6호선,봉화산(서울의료원),226008,46451,272459
201601,2016,6호선,응암,417111,97322,514433
201601,2016,5호선,개화산,144913,30667,175580
201601,2016,5호선,거여,161256,45106,206362
201601,2016,5호선,개롱,164513,38903,203416
201601,2016,5호선,오금,92043,15384,107427
201601,2016,5호선,방이,175171,37336,212507
201601,2016,5호선,올림픽공원,155873,29353,185226
201601,2016,5호선,둔촌동,315120,69934,385054
201601,2016,5호선,상일동,269462,57343,326805
201601,2016,5호선,고덕,188525,51350,239875
201601,2016,5호선,명일,189439,55543,244982
201601,2016,5호선,굽은다리,239620,56788,296408
201601,2016,5호선,길동,173990,53409,227399
201601,2016,5호선,강동,480145,86527,566672
201601,2016,5호선,천호,513370,137370,650740
201601,2016,5호선,광나루,360241,57557,417798
201601,2016,5호선,아차산,344977,84669,429646
201601,2016,5호선,군자,286952,34625,321577
201601,2016,5호선,장한평,458128,91729,549857
201601,2016,5호선,답십리,404315,76785,481100
201601,2016,5호선,마장,141930,44393,186323
201601,2016,5호선,왕십리(성동구청),127572,22109,149681
201601,2016,5호선,행당,200720,44313,245033
201601,2016,5호선,신금호,120471,31492,151963
201601,2016,5호선,청구,93981,24895,118876
201601,2016,5호선,동대문역사문화공원,79691,11239,90930
201601,2016,5호선,을지로4가,110165,39746,149911
201601,2016,5호선,종로3가,301127,118028,419155
201601,2016,5호선,광화문,998043,79770,1077813
201601,2016,5호선,서대문,413407,69023,482430
201601,2016,5호선,충정로,111018,15434,126452
201601,2016,5호선,애오개,162367,36299,198666
201601,2016,5호선,공덕,335925,45502,381427
201601,2016,5호선,마포,376595,61944,438539
201601,2016,5호선,여의나루,174468,24542,199010
201601,2016,5호선,여의도,616831,50429,667260
201601,2016,5호선,신길,77481,10257,87738
201601,2016,5호선,영등포시장,171238,72096,243334
201601,2016,5호선,영등포구청,75587,16108,91695
201601,2016,5호선,양평,156958,25828,182786
201601,2016,5호선,오목교,674271,76635,750906
201601,2016,5호선,목동,474869,76278,551147
201601,2016,5호선,신정,368921,53621,422542
201601,2016,5호선,까치산,742516,138420,880936
201601,2016,5호선,화곡,730417,126273,856690
201601,2016,5호선,우장산,388919,70631,459550
201601,2016,5호선,발산,268673,51114,319787
201601,2016,5호선,마곡,80378,13175,93553
201601,2016,5호선,송정,235061,58101,293162
201601,2016,5호선,김포공항,198620,25200,223820
201601,2016,5호선,마천,121259,46605,167864
201601,2016,4호선,상계,540184,107842,648026
201601,2016,경부선,영등포,1317864,255806,1573670
201601,2016,경부선,신도림,78045,14871,92916
201601,2016,경부선,가산디지털단지,440981,28169,469150
201601,2016,경원선,회룡,268505,120986,389491
201601,2016,경원선,창동,3,1,4
201601,2016,경원선,가능,158472,55468,213940
201601,2016,경원선,녹양,113603,28997,142600
201601,2016,경원선,양주,212421,45279,257700
201601,2016,경원선,덕계,45261,14747,60008
201601,2016,경원선,덕정,148231,31110,179341
201601,2016,4호선,사당,869691,88953,958644
201601,2016,경원선,지행,158829,39516,198345
201601,2016,경원선,동두천 중앙,77438,35469,112907
201601,2016,경원선,보산,40001,13161,53162
201601,2016,경원선,동두천,43637,16450,60087
201601,2016,경원선,소요산,57833,55847,113680
201601,2016,경원선,방학,201553,96181,297734
201601,2016,경원선,도봉,129718,61975,191693
201601,2016,경원선,도봉산,80788,49670,130458
201601,2016,경원선,망월사,158572,60298,218870
201601,2016,경원선,이촌,109961,27177,137138
201601,2016,경원선,서빙고,48039,15156,63195
201601,2016,경원선,한남,97429,31239,128668
201601,2016,경원선,옥수,1350,140,1490
201601,2016,경원선,응봉,38376,16501,54877
201601,2016,경원선,왕십리,417434,54802,472236
201601,2016,경원선,청량리(지상),329825,130596,460421
201601,2016,경원선,외대앞,285258,55156,340414
201601,2016,경원선,신이문,229027,59930,288957
201601,2016,경원선,석계,260973,57845,318818
201601,2016,경원선,광운대,216389,49444,265833
201601,2016,경원선,월계,98657,46668,145325
201601,2016,경원선,녹천,114376,34020,148396
201601,2016,경원선,의정부,544669,116195,660864
201601,2016,경의선,서울역,75608,9509,85117
201601,2016,경의선,신촌,19655,2960,22615
201601,2016,경의선,공덕,42524,8182,50706
201601,2016,경의선,서강대,52170,8241,60411
201601,2016,경의선,홍대입구,36116,3652,39768
201601,2016,경의선,가좌,77943,36325,114268
201601,2016,경의선,디지털미디어시티,52936,8525,61461
201601,2016,경의선,수색,46645,15507,62152
201601,2016,경의선,화전,38949,7058,46007
201601,2016,경의선,강매,54928,13118,68046
201601,2016,경의선,행신,174648,30406,205054
201601,2016,경의선,능곡,81501,25495,106996
201601,2016,중앙선,팔당,13059,4095,17154
201601,2016,중앙선,도심,52777,18306,71083
201601,2016,중앙선,덕소,136261,44158,180419
201601,2016,중앙선,양정,17061,6041,23102
201601,2016,중앙선,도농,203057,50685,253742
201601,2016,중앙선,구리,322280,75075,397355
201601,2016,중앙선,양원,34780,15123,49903
201601,2016,중앙선,망우,169250,60194,229444
201601,2016,중앙선,상봉,125316,32435,157751
201601,2016,중앙선,용문,41266,31109,72375
201601,2016,중앙선,회기,706943,120327,827270
201601,2016,장항선,봉명,28640,12966,41606
201601,2016,장항선,쌍용동,55417,13162,68579
201601,2016,장항선,아산,62428,6843,69271
201601,2016,장항선,배방,21929,6175,28104
201601,2016,장항선,온양온천,96508,68742,165250
201601,2016,장항선,신창,30496,6403,36899
201601,2016,일산선,화정,457764,122124,579888
201601,2016,일산선,원당,276297,76911,353208
201601,2016,일산선,대화,360999,80477,441476
201601,2016,일산선,원흥,135935,31859,167794
201601,2016,일산선,대곡,30155,7902,38057
201601,2016,일산선,백석,249755,66034,315789
201601,2016,일산선,마두,176628,71284,247912
201601,2016,일산선,정발산,217446,51460,268906
201601,2016,일산선,주엽,189707,87769,277476
201601,2016,일산선,삼송,288427,68304,356731
201601,2016,안산선,고잔,228880,32226,261106
201601,2016,안산선,오이도,197051,22502,219553
201601,2016,안산선,정왕,218067,21661,239728
201601,2016,안산선,신길온천,41113,7869,48982
201601,2016,안산선,안산,483881,41509,525390
201601,2016,안산선,초지,98630,16133,114763
201601,2016,안산선,수리산,105308,29007,134315
201601,2016,안산선,중앙,447536,51229,498765
201601,2016,안산선,한대앞,228447,36873,265320
201601,2016,안산선,상록수,523308,77121,600429
201601,2016,안산선,반월,123028,25502,148530
201601,2016,안산선,대야미,96753,19227,115980
201601,2016,안산선,산본,447079,92121,539200
201601,2016,수인선,호구포,65022,11484,76506
201601,2016,수인선,연수,83854,16291,100145
201601,2016,수인선,원인재,89333,18518,107851
201601,2016,수인선,남동인더스파크,45601,3442,49043
201601,2016,수인선,송도,79527,15358,94885
201601,2016,수인선,인천논현,119787,23431,143218
201601,2016,수인선,소래포구,88341,30868,119209
201601,2016,수인선,월곶,55999,9618,65617
201601,2016,수인선,달월,1589,1005,2594
201601,2016,분당선,한티,370595,58959,429554
201601,2016,분당선,수원시청,284556,29992,314548
201601,2016,분당선,매탄권선,111762,11738,123500
201601,2016,분당선,망포,325942,25512,351454
201601,2016,분당선,영통,227413,23687,251100
201601,2016,분당선,청명,111370,14566,125936
201601,2016,분당선,상갈,124540,26832,151372
201601,2016,분당선,기흥,184365,27268,211633
201601,2016,분당선,신갈,109431,26458,135889
201601,2016,분당선,구성,122860,36335,159195
201601,2016,분당선,죽전,521712,119555,641267
201601,2016,분당선,보정,60733,23081,83814
201601,2016,분당선,이매,117165,31745,148910
201601,2016,분당선,오리,378535,92240,470775
201601,2016,분당선,미금,532908,123694,656602
201601,2016,분당선,정자,434490,77431,511921
201601,2016,분당선,수내,341211,72889,414100
201601,2016,분당선,서현,699418,118563,817981
201601,2016,분당선,야탑,696367,138568,834935
201601,2016,분당선,모란,579292,144016,723308
201601,2016,분당선,태평,360668,78157,438825
201601,2016,분당선,가천대,182473,21880,204353
201601,2016,분당선,선정릉,194031,33092,227123
201601,2016,분당선,강남구청,221065,33541,254606
201601,2016,분당선,압구정로데오,403115,35828,438943
201601,2016,분당선,서울숲,143206,18714,161920
201601,2016,분당선,수원,257374,23855,281229
201601,2016,분당선,복정,5,0,5
201601,2016,분당선,수서,199895,43485,243380
201601,2016,분당선,대모산입구,87866,27230,115096
201601,2016,분당선,개포동,86887,19265,106152
201601,2016,분당선,구룡,39424,17018,56442
201601,2016,분당선,도곡,151593,33655,185248
201601,2016,분당선,매교,58402,16428,74830
201601,2016,분당선,선릉,234706,25148,259854
201601,2016,과천선,범계,822978,100183,923161
201601,2016,과천선,인덕원,618817,93188,712005
201601,2016,경의선,곡산,10694,3863,14557
201601,2016,경의선,백마,156789,27922,184711
201601,2016,경의선,풍산,104382,24459,128841
201601,2016,경의선,일산,210398,50214,260612
201601,2016,경의선,탄현,184028,32567,216595
201601,2016,경의선,야당,54494,13753,68247
201601,2016,경의선,운정,109514,25831,135345
201601,2016,경의선,금릉,112922,21353,134275
201601,2016,경의선,금촌,162211,37891,200102
201601,2016,경의선,월롱,47455,6488,53943
201601,2016,경의선,파주,27194,5976,33170
201601,2016,경의선,문산,138727,38183,176910
201601,2016,경인선,개봉,509697,138640,648337
201601,2016,경인선,오류동,279900,79371,359271
201601,2016,경인선,온수,155198,39102,194300
201601,2016,경인선,도원,65818,32640,98458
201601,2016,경인선,간석,154312,41738,196050
201601,2016,경인선,부개,248470,57039,305509
201601,2016,경인선,소사,293223,78635,371858
201601,2016,경인선,구일,129041,25395,154436
201601,2016,경인선,인천,74939,25598,100537
201601,2016,경인선,동인천,475991,114413,590404
201601,2016,경인선,제물포,159386,40129,199515
201601,2016,경인선,도화,73663,30157,103820
201601,2016,경인선,주안,718213,115162,833375
201601,2016,경인선,동암,607573,124950,732523
201601,2016,4호선,총신대입구,529848,130520,660368
201601,2016,4호선,동작,47374,16230,63604
201601,2016,4호선,이촌,242380,39373,281753
201601,2016,4호선,신용산,348105,51176,399281
201601,2016,4호선,삼각지,119206,29225,148431
201601,2016,4호선,숙대입구,421792,56398,478190
201601,2016,4호선,서울역,303598,36831,340429
201601,2016,4호선,회현,656608,169495,826103
201601,2016,4호선,명동,1107628,68723,1176351
201601,2016,4호선,충무로,813107,121999,935106
201601,2016,4호선,동대문역사문화공원,594978,61940,656918
201601,2016,4호선,동대문,589666,136715,726381
201601,2016,4호선,혜화,1168049,122720,1290769
201601,2016,4호선,한성대입구,374998,75606,450604
201601,2016,4호선,성신여대입구,654112,97885,751997
201601,2016,4호선,길음,645094,135823,780917
201601,2016,4호선,미아사거리,809165,181718,990883
201601,2016,4호선,미아,429462,125151,554613
201601,2016,4호선,수유(강북구청),1093702,237225,1330927
201601,2016,4호선,쌍문,830929,155428,986357
201601,2016,4호선,창동,706896,170144,877040
201601,2016,4호선,노원,614232,85498,699730
201601,2016,4호선,남태령,24861,7359,32220
201601,2016,4호선,당고개,308370,85029,393399
201601,2016,3호선,구파발,415971,77848,493819
201601,2016,3호선,경찰병원,188338,35212,223550
201601,2016,3호선,가락시장,204415,58837,263252
201512,2015,경의선,월롱,60074,7580,67654
201512,2015,경의선,금촌,185822,41679,227501
201512,2015,경의선,금릉,127623,23687,151310
201512,2015,경의선,운정,122961,29237,152198
201512,2015,경의선,야당,58535,15209,73744
201512,2015,3호선,무악재,102419,34187,136606
201512,2015,3호선,독립문,176759,72250,249009
201512,2015,3호선,경복궁,688057,93217,781274
201512,2015,3호선,안국,732435,108743,841178
201512,2015,7호선,학동,652403,69602,722005
201512,2015,7호선,강남구청,454346,51130,505476
201512,2015,7호선,청담,619687,77039,696726
201512,2015,7호선,뚝섬유원지,213809,37819,251628
201512,2015,7호선,건대입구,514422,53627,568049
201512,2015,7호선,어린이대공원,465214,43954,509168
201512,2015,7호선,군자,402128,79888,482016
201512,2015,7호선,중곡,273788,61909,335697
201512,2015,7호선,용마산,171228,36450,207678
201512,2015,7호선,사가정,440794,92415,533209
201512,2015,7호선,면목,425170,82807,507977
201512,2015,7호선,상봉,495530,74181,569711
201512,2015,7호선,중화,319385,61805,381190
201512,2015,7호선,먹골,286777,58702,345479
201512,2015,3호선,종로3가,198556,63417,261973
201512,2015,3호선,을지로3가,237794,62834,300628
201512,2015,3호선,충무로,44,15,59
201512,2015,3호선,동대입구,343035,39639,382674
201512,2015,3호선,약수,383283,90683,473966
201512,2015,3호선,금호,200852,53505,254357
201512,2015,3호선,옥수,267002,57437,324439
201512,2015,3호선,압구정,1035316,153227,1188543
201512,2015,3호선,신사,953767,82600,1036367
201512,2015,3호선,잠원,150388,34127,184515
201512,2015,3호선,고속터미널,1654701,189150,1843851
201512,2015,3호선,교대,376397,69721,446118
201512,2015,3호선,남부터미널,1057094,140052,1197146
201512,2015,3호선,양재,1218700,175844,1394544
201512,2015,3호선,매봉,331580,60124,391704
201512,2015,3호선,도곡,208912,32633,241545
201512,2015,3호선,대치,311262,64676,375938
201512,2015,3호선,학여울,109942,17242,127184
201512,2015,3호선,대청,289410,51300,340710
201512,2015,3호선,일원,236924,58868,295792
201512,2015,3호선,수서,306321,85449,391770
201512,2015,3호선,가락시장,225828,64922,290750
201512,2015,3호선,경찰병원,203532,38029,241561
201512,2015,3호선,구파발,461818,88110,549928
201512,2015,4호선,당고개,339617,93612,433229
201512,2015,4호선,남태령,34099,8295,42394
201512,2015,4호선,노원,680589,95307,775896
201512,2015,4호선,창동,789429,184623,974052
201512,2015,4호선,쌍문,916160,174157,1090317
201512,2015,4호선,수유(강북구청),1232376,262131,1494507
201512,2015,4호선,미아,492428,137169,629597
201512,2015,4호선,미아사거리,912819,202107,1114926
201512,2015,4호선,길음,748142,151381,899523
201512,2015,4호선,성신여대입구,764550,108591,873141
201512,2015,4호선,한성대입구,462985,85057,548042
201512,2015,4호선,혜화,1461258,138010,1599268
201512,2015,4호선,동대문,674581,161672,836253
201512,2015,4호선,동대문역사문화공원,667182,70308,737490
201512,2015,4호선,충무로,951597,136663,1088260
201512,2015,4호선,명동,1304824,83866,1388690
201512,2015,4호선,회현,741085,205343,946428
201512,2015,4호선,서울역,336147,40347,376494
201512,2015,4호선,숙대입구,507705,63703,571408
201512,2015,4호선,삼각지,132600,33568,166168
201512,2015,4호선,신용산,383357,57193,440550
201512,2015,4호선,이촌,276860,44842,321702
201512,2015,4호선,동작,56205,18214,74419
201512,2015,4호선,총신대입구,591475,143939,735414
201512,2015,4호선,사당,962057,101630,1063687
201512,2015,4호선,상계,605343,119059,724402
201512,2015,5호선,방화,197771,45718,243489
201512,2015,5호선,마천,140191,51003,191194
201512,2015,5호선,김포공항,214739,27217,241956
201512,2015,5호선,송정,264430,65883,330313
201512,2015,5호선,마곡,88501,14316,102817
201512,2015,5호선,발산,309061,58263,367324
201512,2015,5호선,우장산,441839,78819,520658
201512,2015,5호선,화곡,804783,138852,943635
201512,2015,5호선,까치산,816909,150987,967896
201512,2015,5호선,신정,413355,58730,472085
201512,2015,경부선,직산,26007,5292,31299
201512,2015,경부선,성환,117175,20903,138078
201512,2015,경부선,평택,382313,68337,450650
201512,2015,경부선,지제,23675,3964,27639
201512,2015,경부선,서정리,138031,25850,163881
201512,2015,경부선,송탄,130660,24866,155526
201512,2015,경부선,진위,45909,7241,53150
201512,2015,경부선,오산,285344,42120,327464
201512,2015,경부선,오산대,74165,11169,85334
201512,2015,경부선,세마,71183,12613,83796
201512,2015,경부선,병점,440950,56202,497152
201512,2015,경부선,세류,116395,19022,135417
201512,2015,경부선,독산,431761,68074,499835
201512,2015,경부선,수원,1280929,149535,1430464
201512,2015,경부선,화서,235671,42307,277978
201512,2015,경부선,성균관대,475731,53678,529409
201512,2015,경부선,의왕,238339,37933,276272
201512,2015,경부선,군포,197210,33108,230318
201512,2015,경부선,금정,838061,106649,944710
201512,2015,경부선,명학,296328,42093,338421
201512,2015,경부선,안양,797487,116344,913831
201512,2015,경부선,관악,230013,54823,284836
201512,2015,경부선,석수,332198,46034,378232
201512,2015,경부선,금천구청,295545,76731,372276
201512,2015,경부선,신길,291573,48719,340292
201512,2015,경부선,구로,622844,93865,716709
201512,2015,9호선2단계,종합운동장,145136,11885,157021
201512,2015,9호선2단계,선정릉,167646,16162,183808
201512,2015,9호선2단계,삼성중앙,122935,16668,139603
201512,2015,9호선2단계,봉은사,334117,31588,365705
201512,2015,9호선2단계,언주,205876,21801,227677
201512,2015,9호선,구반포,83262,24173,107435
201512,2015,9호선,동작,45687,12476,58163
201512,2015,9호선,흑석(중앙대입구),283657,56206,339863
201512,2015,9호선,노들,123557,30203,153760
201512,2015,9호선,노량진,685203,81862,767065
201512,2015,9호선,샛강,141127,25237,166364
201512,2015,9호선,여의도,539993,41474,581467
201512,2015,9호선,국회의사당,424878,55553,480431
201512,2015,9호선,당산,490218,60616,550834
201512,2015,8호선,석촌,233344,59362,292706
201512,2015,8호선,송파,138109,35728,173837
201512,2015,8호선,가락시장,166678,44720,211398
201512,2015,8호선,문정,162459,29624,192083
201512,2015,8호선,장지,399910,55324,455234
201512,2015,8호선,복정,213974,31874,245848
201512,2015,8호선,산성,193057,40372,233429
201512,2015,8호선,남한산성입구,393670,74749,468419
201512,2015,8호선,단대오거리,346691,71563,418254
201512,2015,8호선,신흥,126498,50336,176834
201512,2015,8호선,수진,129001,40722,169723
201512,2015,8호선,모란,98866,52109,150975
201512,2015,9호선,개화,169093,33620,202713
201512,2015,9호선,김포공항,263394,17686,281080
201512,2015,9호선,신논현,896454,52850,949304
201512,2015,9호선,사평,75982,14585,90567
201512,2015,9호선,고속터미널,479696,52924,532620
201512,2015,9호선,신반포,84229,22107,106336
201512,2015,9호선,공항시장,74111,21506,95617
201512,2015,9호선,신방화,207967,41652,249619
201512,2015,9호선,마곡나루,58587,7974,66561
201512,2015,9호선,양천향교,193831,38701,232532
201512,2015,9호선,가양,529410,118937,648347
201512,2015,9호선,증미,192307,40335,232642
201512,2015,9호선,등촌,258718,81363,340081
201512,2015,9호선,염창,440683,58618,499301
201512,2015,9호선,신목동,114493,17280,131773
201512,2015,9호선,선유도,182716,25035,207751
201512,2015,분당선,매탄권선,127827,13176,141003
201512,2015,분당선,망포,369151,27761,396912
201512,2015,분당선,영통,263560,25662,289222
201512,2015,분당선,청명,126411,16060,142471
201512,2015,분당선,상갈,139756,30376,170132
201512,2015,3호선,홍제,501892,153285,655177
201512,2015,3호선,녹번,394457,82684,477141
201512,2015,3호선,불광,480039,151043,631082
201512,2015,3호선,연신내,1083203,257075,1340278
201512,2015,3호선,오금,190253,25255,215508
201512,2015,3호선,지축,26941,11776,38717
201512,2015,2호선,을지로입구,1629679,133953,1763632
201512,2015,2호선,신정네거리,284831,67966,352797
201512,2015,2호선,양천구청,188045,47378,235423
201512,2015,2호선,도림천,25169,6326,31495
201512,2015,2호선,신설동,90994,35795,126789
201512,2015,2호선,신답,32220,10593,42813
201512,2015,2호선,용답,64572,17112,81684
201512,2015,2호선,충정로,317668,56227,373895
201512,2015,2호선,아현,258243,65300,323543
201512,2015,2호선,이대,633864,80896,714760
201512,2015,2호선,신촌,1510348,156083,1666431
201512,2015,2호선,홍대입구,2338229,128326,2466555
201512,2015,2호선,합정,997553,78544,1076097
201512,2015,2호선,당산,638156,70684,708840
201512,2015,2호선,영등포구청,584613,111277,695890
201512,2015,2호선,문래,532555,83543,616098
201512,2015,2호선,신도림,1879557,207818,2087375
201512,2015,2호선,대림,888234,119347,1007581
201512,2015,2호선,구로디지털단지,1881721,167183,2048904
201512,2015,2호선,신대방,759169,128569,887738
201512,2015,2호선,신림,2125973,262299,2388272
201512,2015,2호선,봉천,611462,149071,760533
201512,2015,2호선,서울대입구,1457247,219363,1676610
201512,2015,2호선,낙성대,869739,114006,983745
201512,2015,2호선,사당,1278340,212061,1490401
201512,2015,2호선,방배,586019,84454,670473
201512,2015,2호선,서초,660216,89934,750150
201512,2015,2호선,교대,1034590,175123,1209713
201512,2015,2호선,강남,3010868,177597,3188465
201512,2015,2호선,역삼,1327053,169715,1496768
201512,2015,2호선,선릉,1584419,207434,1791853
201512,2015,2호선,삼성,1818471,132454,1950925
201512,2015,2호선,종합운동장,370417,50448,420865
201512,2015,2호선,신천,752968,119939,872907
201512,2015,2호선,잠실,2592617,217721,2810338
201512,2015,2호선,잠실나루,492392,88145,580537
201512,2015,2호선,강변,1469451,150386,1619837
201512,2015,2호선,구의,670512,114148,784660
201512,2015,2호선,건대입구,1372114,101279,1473393
201512,2015,2호선,성수,693124,103289,796413
201512,2015,2호선,뚝섬,424409,69387,493796
201512,2015,2호선,한양대,353981,16498,370479
201512,2015,2호선,왕십리(성동구청),597680,64522,662202
201512,2015,2호선,상왕십리,291201,62312,353513
201512,2015,2호선,신당,377869,110203,488072
201512,2015,2호선,동대문역사문화공원,528920,60751,589671
201512,2015,2호선,을지로4가,322487,102059,424546
201512,2015,2호선,을지로3가,559060,96431,655491
201512,2015,2호선,용두,48977,23564,72541
201512,2015,2호선,시청,808125,64413,872538
201512,2015,1호선,종로5가,630988,276092,907080
201512,2015,1호선,청량리(지하),605320,355266,960586
201512,2015,1호선,제기동,305975,311257,617232
201512,2015,1호선,신설동,403786,130091,533877
201512,2015,1호선,동대문,377067,144125,521192
201512,2015,1호선,동묘앞,171359,133923,305282
201512,2015,1호선,종로3가,829653,402176,1231829
201512,2015,1호선,종각,1426031,169895,1595926
201512,2015,1호선,시청,765950,102259,868209
201512,2015,1호선,서울역,1795435,235606,2031041
201512,2015,5호선,목동,519121,85639,604760
201512,2015,5호선,오목교,740855,85941,826796
201512,2015,5호선,양평,169595,28095,197690
201512,2015,5호선,영등포구청,83954,16118,100072
201512,2015,5호선,영등포시장,185309,75171,260480
201512,2015,5호선,신길,84240,10801,95041
201512,2015,5호선,여의도,664793,57105,721898
201512,2015,5호선,여의나루,195172,27779,222951
201512,2015,5호선,마포,420595,69936,490531
201512,2015,5호선,공덕,382344,51493,433837
201512,2015,분당선,수원시청,312686,33458,346144
201512,2015,분당선,한티,370578,64073,434651
201512,2015,수인선,달월,1763,1017,2780
201512,2015,수인선,월곶,65721,12249,77970
201512,2015,수인선,소래포구,102544,37893,140437
201512,2015,수인선,인천논현,136060,25539,161599
201512,2015,수인선,송도,94919,17190,112109
201512,2015,수인선,남동인더스파크,48655,3835,52490
201512,2015,수인선,원인재,101159,20070,121229
201512,2015,수인선,연수,93630,19143,112773
201512,2015,수인선,호구포,74615,12824,87439
201512,2015,안산선,산본,492050,99996,592046
201512,2015,안산선,대야미,106427,21749,128176
201512,2015,안산선,반월,138896,28364,167260
201512,2015,안산선,상록수,592332,86595,678927
201512,2015,안산선,한대앞,268342,40829,309171
201512,2015,안산선,중앙,496981,58456,555437
201512,2015,안산선,수리산,119258,32326,151584
201512,2015,안산선,초지,124135,18446,142581
201512,2015,안산선,안산,514664,45552,560216
201512,2015,안산선,신길온천,46405,8513,54918
201512,2015,안산선,정왕,265726,23859,289585
201512,2015,안산선,오이도,228989,26520,255509
201512,2015,안산선,고잔,255878,35844,291722
201512,2015,일산선,삼송,329489,75763,405252
201512,2015,일산선,주엽,211311,99424,310735
201512,2015,일산선,정발산,243630,57589,301219
201512,2015,일산선,마두,196508,82967,279475
201512,2015,일산선,백석,277721,75730,353451
201512,2015,일산선,대곡,34414,9224,43638
201512,2015,일산선,원흥,147054,35170,182224
201512,2015,일산선,지축,1,0,1
201512,2015,일산선,대화,388505,92938,481443
201512,2015,일산선,원당,315856,87613,403469
201512,2015,일산선,화정,508044,136734,644778
201512,2015,장항선,신창,51926,7283,59209
201512,2015,장항선,온양온천,102604,71610,174214
201512,2015,장항선,배방,24461,7196,31657
201512,2015,장항선,아산,74069,8107,82176
201512,2015,장항선,쌍용동,72806,15361,88167
201512,2015,장항선,봉명,30692,13922,44614
201512,2015,중앙선,회기,838898,133715,972613
201512,2015,중앙선,용문,45796,34204,80000
201512,2015,중앙선,상봉,137473,35750,173223
201512,2015,중앙선,망우,194015,67187,261202
201512,2015,중앙선,양원,45391,16786,62177
201512,2015,중앙선,구리,354178,83264,437442
201512,2015,중앙선,도농,228534,56731,285265
201512,2015,중앙선,양정,18891,7076,25967
201512,2015,중앙선,덕소,154112,48558,202670
201512,2015,중앙선,도심,61032,20640,81672
201512,2015,중앙선,팔당,13606,4820,18426
201512,2015,중앙선,운길산,23174,7524,30698
201512,2015,중앙선,양수,40612,15325,55937
201512,2015,중앙선,신원,4259,2739,6998
201512,2015,중앙선,국수,18715,8081,26796
201512,2015,중앙선,아신,18578,6220,24798
201512,2015,중앙선,오빈,6490,3530,10020
201512,2015,중앙선,양평,84653,31896,116549
201512,2015,중앙선,원덕,6661,4353,11014
201512,2015,중앙선,중랑,141342,51184,192526
201512,2015,5호선,애오개,179220,40460,219680
201512,2015,5호선,충정로,136387,19520,155907
201512,2015,5호선,서대문,491155,77200,568355
201512,2015,5호선,광화문,1153989,92089,1246078
201512,2015,5호선,종로3가,314934,125268,440202
201512,2015,5호선,상일동,308310,64928,373238
201512,2015,5호선,둔촌동,353707,77465,431172
201512,2015,5호선,올림픽공원,216615,32264,248879
201512,2015,5호선,방이,190549,40762,231311
201512,2015,5호선,오금,105270,17127,122397
201512,2015,5호선,개롱,185522,42528,228050
201512,2015,5호선,거여,183238,50132,233370
201512,2015,5호선,개화산,157855,33093,190948
201512,2015,6호선,응암,460941,107074,568015
201512,2015,6호선,봉화산(서울의료원),253371,51861,305232
201512,2015,6호선,불광,146152,39017,185169
201512,2015,6호선,독바위,71596,19914,91510
201512,2015,6호선,연신내,8,1,9
201512,2015,6호선,구산,206109,54319,260428
201512,2015,6호선,새절,347258,80705,427963
201512,2015,6호선,증산,272301,69213,341514
201512,2015,6호선,디지털미디어시티,412019,62603,474622
201512,2015,6호선,월드컵경기장,146355,46720,193075
201512,2015,경부선,두정,177510,23560,201070
201512,2015,경부선,천안,221330,62661,283991
201512,2015,경부선,당정,210031,31546,241577
201512,2015,경부선,서동탄,43966,8308,52274
201512,2015,경부선,광명,24440,1345,25785
201512,2015,경부선,서울역,37,2,39
201512,2015,경부선,남영,329288,43302,372590
201512,2015,경부선,용산,1121835,145212,1267047
201512,2015,경부선,노량진,641114,75367,716481
201512,2015,경부선,대방,430182,77374,507556
201512,2015,경부선,영등포,1439049,280623,1719672
201512,2015,경부선,신도림,90918,17074,107992
201512,2015,경부선,가산디지털단지,484720,32553,517273
201512,2015,경원선,회룡,302243,136491,438734
201512,2015,경원선,창동,5,0,5
201512,2015,경원선,가능,183129,61365,244494
201512,2015,경원선,녹양,128847,32325,161172
201512,2015,경원선,양주,241035,52453,293488
201512,2015,경원선,덕계,52035,16630,68665
201512,2015,경원선,덕정,183145,35434,218579
201512,2015,경원선,지행,190260,44253,234513
201512,2015,경원선,동두천 중앙,88640,39313,127953
201512,2015,경원선,보산,49124,14334,63458
201512,2015,경원선,동두천,50744,18551,69295
201512,2015,경원선,소요산,62009,62539,124548
201512,2015,경원선,방학,228870,104983,333853
201512,2015,6호선,마포구청,351588,82851,434439
201512,2015,6호선,망원,302972,84455,387427
201512,2015,6호선,합정,385062,39295,424357
201512,2015,6호선,상수,321852,24118,345970
201512,2015,6호선,광흥창,236502,61242,297744
201512,2015,6호선,대흥,222404,44862,267266
201512,2015,6호선,공덕,503291,75750,579041
201512,2015,6호선,효창공원앞,208916,47764,256680
201512,2015,6호선,삼각지,236565,22600,259165
201512,2015,6호선,녹사평(용산구청),214960,22550,237510
201512,2015,6호선,석계,357054,73358,430412
201512,2015,6호선,이태원,495881,39091,534972
201512,2015,6호선,한강진,189785,13705,203490
201512,2015,6호선,버티고개,66762,14637,81399
201512,2015,6호선,약수,93117,23167,116284
201512,2015,6호선,청구,99437,18716,118153
201512,2015,6호선,신당,239103,37808,276911
201512,2015,6호선,동묘앞,231934,68885,300819
201512,2015,6호선,창신,89901,18610,108511
201512,2015,6호선,보문,234862,39239,274101
201512,2015,6호선,안암,391308,32112,423420
201512,2015,6호선,돌곶이,251331,65236,316567
201512,2015,6호선,고려대,286139,37650,323789
201512,2015,6호선,월곡,331832,73080,404912
201512,2015,6호선,상월곡,165844,37963,203807
201512,2015,7호선,태릉입구,237645,36840,274485
201512,2015,7호선,공릉,345071,68511,413582
201512,2015,7호선,하계,573471,108634,682105
201512,2015,7호선,중계,424067,93317,517384
201512,2015,7호선,노원,577658,115385,693043
201512,2015,7호선,마들,323855,74036,397891
201512,2015,7호선,수락산,380207,88947,469154
201512,2015,7호선,부평구청,354495,29566,384061
201512,2015,7호선,장암,70149,7593,77742
201512,2015,6호선,역촌,88526,33580,122106
201512,2015,6호선,화랑대,377391,46428,423819
201512,2015,6호선,태릉입구,136633,27057,163690
201512,2015,5호선,을지로4가,123241,41869,165110
201512,2015,5호선,동대문역사문화공원,83288,11380,94668
201512,2015,5호선,청구,106477,26947,133424
201512,2015,5호선,신금호,136627,34568,171195
201512,2015,5호선,행당,222825,48060,270885
201512,2015,5호선,왕십리(성동구청),142072,24590,166662
201512,2015,5호선,마장,164469,45462,209931
201512,2015,5호선,답십리,449086,85632,534718
201512,2015,5호선,장한평,504941,102975,607916
201512,2015,5호선,군자,317634,37430,355064
201512,2015,5호선,아차산,395058,91935,486993
201512,2015,5호선,광나루,417208,65089,482297
201512,2015,5호선,천호,558162,150388,708550
201512,2015,5호선,강동,535007,95789,630796
201512,2015,5호선,길동,188555,58029,246584
201512,2015,5호선,굽은다리,265224,63559,328783
201512,2015,5호선,명일,211894,61441,273335
201512,2015,5호선,고덕,219276,58705,277981
201512,2015,경원선,도봉,145161,69607,214768
201512,2015,경원선,도봉산,89598,54477,144075
201512,2015,경원선,망월사,202893,67362,270255
201512,2015,경원선,이촌,123258,30376,153634
201512,2015,경원선,서빙고,53982,16895,70877
201512,2015,경원선,한남,105973,33970,139943
201512,2015,경원선,옥수,1513,151,1664
201512,2015,경원선,응봉,43172,18905,62077
201512,2015,경원선,왕십리,487809,61251,549060
201512,2015,경원선,청량리(지상),357499,137218,494717
201512,2015,경원선,외대앞,341656,59608,401264
201512,2015,경원선,신이문,254735,65549,320284
201512,2015,경원선,석계,292290,64825,357115
201512,2015,경원선,광운대,266543,54347,320890
201512,2015,경원선,월계,141322,52000,193322
201512,2015,경원선,녹천,127879,37481,165360
201512,2015,경원선,의정부,611401,128055,739456
201512,2015,경의선,서울역,83249,11309,94558
201512,2015,경의선,신촌,22298,3304,25602
201512,2015,분당선,기흥,224126,30824,254950
201512,2015,분당선,신갈,119371,29594,148965
201512,2015,분당선,구성,141032,41761,182793
201512,2015,분당선,죽전,611843,140145,751988
201512,2015,분당선,보정,70255,26420,96675
201512,2015,분당선,이매,135778,35989,171767
201512,2015,분당선,오리,418591,104355,522946
201512,2015,분당선,미금,575459,139720,715179
201512,2015,분당선,정자,472525,86505,559030
201512,2015,분당선,수내,369718,82030,451748
201512,2015,분당선,서현,758374,131138,889512
201512,2015,분당선,야탑,769442,157846,927288
201512,2015,분당선,모란,637337,156660,793997
201512,2015,분당선,태평,384893,84184,469077
201512,2015,분당선,가천대,280045,24544,304589
201512,2015,분당선,선정릉,205892,36205,242097
201512,2015,분당선,강남구청,237216,38324,275540
201512,2015,분당선,압구정로데오,437564,39727,477291
201512,2015,분당선,서울숲,156576,20952,177528
201512,2015,분당선,수원,290987,26083,317070
201512,2015,분당선,복정,2,0,2
201512,2015,분당선,수서,219033,47509,266542
201512,2015,분당선,대모산입구,99628,30030,129658
201512,2015,분당선,개포동,96601,21924,118525
201512,2015,분당선,구룡,49288,18643,67931
201512,2015,분당선,도곡,171511,39437,210948
201512,2015,분당선,매교,67062,17438,84500
201512,2015,분당선,선릉,248990,27600,276590
201512,2015,과천선,범계,916951,111589,1028540
201512,2015,과천선,인덕원,691866,102732,794598
201512,2015,과천선,평촌,432801,62292,495093
201512,2015,과천선,선바위,260571,32590,293161
201512,2015,과천선,경마공원,164942,61155,226097
201512,2015,과천선,대공원,110001,34776,144777
201512,2015,과천선,과천,139231,35775,175006
201512,2015,과천선,정부과천청사,344743,68232,412975
201512,2015,공항철도 1호선,디지털미디어시티,322388,21341,343729
201512,2015,공항철도 1호선,홍대입구,229246,17024,246270
201512,2015,공항철도 1호선,김포공항,270427,17057,287484
201512,2015,공항철도 1호선,계양,305494,29087,334581
201512,2015,공항철도 1호선,검암,492249,43197,535446
201512,2015,공항철도 1호선,청라국제도시,140305,8809,149114
201512,2015,공항철도 1호선,운서,155869,29145,185014
201512,2015,공항철도 1호선,공항화물청사,66001,7968,73969
201512,2015,공항철도 1호선,인천국제공항,341891,32806,374697
201512,2015,공항철도 1호선,공덕,38362,6840,45202
201512,2015,공항철도 1호선,서울역,287470,32010,319480
201512,2015,경춘선,신내,13731,6399,20130
201512,2015,경춘선,갈매,8534,3766,12300
201512,2015,경춘선,별내,55958,14875,70833
201512,2015,경춘선,퇴계원,84386,22400,106786
201512,2015,경춘선,사릉,93201,17422,110623
201512,2015,경춘선,금곡,30475,13502,43977
201512,2015,경춘선,평내호평,138756,39722,178478
201512,2015,경춘선,천마산,24347,11927,36274
201512,2015,경춘선,마석,79680,28499,108179
201512,2015,경춘선,대성리,18318,4036,22354
201512,2015,경춘선,청평,58935,13662,72597
201512,2015,경춘선,상천,6933,3274,10207
201512,2015,경춘선,가평,56790,11398,68188
201512,2015,경춘선,굴봉산,4937,1234,6171
201512,2015,경춘선,백양리,9070,912,9982
201512,2015,경춘선,강촌,18956,3368,22324
201512,2015,경춘선,남춘천,74743,22447,97190
201512,2015,경춘선,김유정,10322,2589,12911
201512,2015,경춘선,춘천,48932,16526,65458
201512,2015,경인선,중동,266792,69533,336325
201512,2015,경인선,역곡,835986,136595,972581
201512,2015,경인선,부천,1148508,208940,1357448
201512,2015,경인선,송내,963216,116847,1080063
201512,2015,경인선,부평,1102636,144755,1247391
201512,2015,경인선,백운,231922,62849,294771
201512,2015,경인선,동암,680042,138391,818433
201512,2015,경인선,주안,833221,129294,962515
201512,2015,경인선,도화,88837,33823,122660
201512,2015,경인선,제물포,202847,44672,247519
201512,2015,경의선,공덕,45479,8943,54422
201512,2015,경의선,서강대,55358,8797,64155
201512,2015,경의선,홍대입구,40299,3882,44181
201512,2015,경의선,가좌,85305,38279,123584
201512,2015,경의선,디지털미디어시티,60355,9783,70138
201512,2015,경의선,수색,48613,16735,65348
201512,2015,경의선,화전,71197,8235,79432
201512,2015,경의선,강매,62430,14432,76862
201512,2015,경의선,행신,194971,34023,228994
201512,2015,경의선,능곡,90078,27811,117889
201512,2015,경의선,곡산,12194,4392,16586
201512,2015,경의선,백마,175692,31101,206793
201512,2015,경의선,풍산,116904,28033,144937
201512,2015,경의선,일산,239493,54586,294079
201512,2015,경의선,탄현,206809,37570,244379
201512,2015,8호선,잠실,359607,59408,419015
201512,2015,8호선,몽촌토성,165527,39488,205015
201512,2015,8호선,강동구청,274790,60803,335593
201512,2015,8호선,천호,533319,95203,628522
201512,2015,8호선,암사,473574,87737,561311
201512,2015,7호선,도봉산,314710,62417,377127
201512,2015,7호선,굴포천,249284,31425,280709
201512,2015,7호선,삼산체육관,159765,22347,182112
201512,2015,7호선,상동,408265,43907,452172
201512,2015,7호선,부천시청,353850,40967,394817
201512,2015,7호선,신중동,416276,46170,462446
201512,2015,7호선,춘의,223694,25857,249551
201512,2015,7호선,부천종합운동장,154229,16149,170378
201512,2015,7호선,까치울,169381,20928,190309
201512,2015,7호선,온수,309363,32453,341816
201512,2015,7호선,천왕,217349,42684,260033
201512,2015,7호선,광명사거리,747088,146633,893721
201512,2015,7호선,철산,704844,99447,804291
201512,2015,7호선,가산디지털단지,1245731,82588,1328319
201512,2015,7호선,남구로,463134,61713,524847
201512,2015,7호선,대림,311543,35577,347120
201512,2015,7호선,신풍,314283,69602,383885
201512,2015,7호선,보라매,265331,44909,310240
201512,2015,7호선,신대방삼거리,417378,92269,509647
201512,2015,7호선,장승배기,265029,74951,339980
201512,2015,7호선,상도,299265,61834,361099
201512,2015,7호선,숭실대입구,445561,60999,506560
201512,2015,7호선,남성,298655,68165,366820
201512,2015,7호선,이수,474042,81700,555742
201512,2015,7호선,내방,390896,63808,454704
201512,2015,7호선,고속터미널,628028,80984,709012
201512,2015,7호선,반포,180074,31848,211922
201512,2015,7호선,논현,579107,55789,634896
201512,2015,경인선,동인천,531519,127211,658730
201512,2015,경인선,인천,82263,29521,111784
201512,2015,경인선,구일,165021,28916,193937
201512,2015,경인선,소사,331554,87657,419211
201512,2015,경인선,부개,284507,62876,347383
201512,2015,경인선,간석,174593,46667,221260
201512,2015,경인선,도원,91236,35673,126909
201512,2015,경인선,온수,191273,43368,234641
201512,2015,경인선,오류동,309506,86349,395855
201512,2015,경인선,개봉,580765,155701,736466
201512,2015,경의선,문산,152602,42455,195057
201512,2015,경의선,파주,39063,6946,46009
201511,2015,5호선,목동,500828,532694,1033522
201511,2015,경인선,동암,659823,641590,1301413
201511,2015,경인선,백운,231782,228101,459883
201511,2015,경인선,부평,1049412,1179259,2228671
201511,2015,경인선,송내,952226,935340,1887566
201511,2015,경인선,부천,1118909,1098319,2217228
201511,2015,경인선,역곡,836342,802569,1638911
201511,2015,경인선,오류동,300467,273020,573487
201511,2015,경인선,개봉,561985,558851,1120836
201511,2015,경부선,광명,24386,20053,44439
201511,2015,경부선,서동탄,42166,38267,80433
201511,2015,경부선,당정,212274,207537,419811
201511,2015,경부선,천안,253476,210950,464426
201511,2015,경부선,두정,192015,218693,410708
201511,2015,경부선,직산,25566,29368,54934
201511,2015,경부선,성환,159912,158476,318388
201511,2015,경부선,평택,393833,392685,786518
201511,2015,경부선,지제,24056,23570,47626
201511,2015,경부선,서정리,147490,145009,292499
201511,2015,경부선,송탄,127165,123844,251009
201511,2015,경부선,진위,46180,40148,86328
201511,2015,경부선,오산,284539,271407,555946
201511,2015,경부선,오산대,83032,84335,167367
201511,2015,경부선,세마,68805,60504,129309
201511,2015,경부선,병점,462634,461895,924529
201511,2015,경부선,세류,115580,107265,222845
201511,2015,경부선,독산,422622,441315,863937
201511,2015,경부선,수원,1301759,1391968,2693727
201511,2015,경부선,화서,233091,231770,464861
201511,2015,경부선,성균관대,487640,463470,951110
201511,2015,경부선,의왕,237004,223697,460701
201511,2015,경부선,군포,192525,179330,371855
201511,2015,경부선,금정,817194,809973,1627167
201511,2015,경부선,명학,309915,312011,621926
201511,2015,경부선,안양,820207,821853,1642060
201511,2015,경부선,관악,225257,204932,430189
201511,2015,경부선,석수,332202,296363,628565
201511,2015,경부선,금천구청,285682,265450,551132
201511,2015,경부선,가산디지털단지,475541,568620,1044161
201511,2015,경부선,구로,603741,632946,1236687
201511,2015,경부선,신길,285720,230418,516138
201511,2015,경부선,신도림,94463,96545,191008
201511,2015,경부선,영등포,1304383,1401744,2706127
201511,2015,경부선,대방,424149,420052,844201
201511,2015,경부선,노량진,651176,629112,1280288
201511,2015,경부선,용산,1043251,1038911,2082162
201511,2015,경부선,남영,328128,360205,688333
201511,2015,경부선,서울역,67,0,67
201511,2015,4호선,남태령,34151,20527,54678
201511,2015,4호선,사당,935322,736187,1671509
201511,2015,4호선,총신대입구,562461,632462,1194923
201511,2015,4호선,동작,58675,62999,121674
201511,2015,4호선,이촌,240179,272545,512724
201511,2015,4호선,신용산,357937,382048,739985
201511,2015,4호선,삼각지,123782,160526,284308
201511,2015,4호선,숙대입구,515738,509690,1025428
201511,2015,4호선,서울역,318775,612172,930947
201511,2015,4호선,회현,694403,745397,1439800
201511,2015,4호선,명동,1192104,1291387,2483491
201511,2015,4호선,충무로,919700,947035,1866735
201511,2015,4호선,동대문역사문화공원,621934,575176,1197110
201511,2015,4호선,동대문,627787,649883,1277670
201511,2015,4호선,혜화,1293385,1349632,2643017
201511,2015,4호선,한성대입구,477769,452363,930132
201511,2015,4호선,성신여대입구,753626,685412,1439038
201511,2015,4호선,길음,754382,725301,1479683
201511,2015,4호선,미아사거리,861461,833385,1694846
201511,2015,4호선,미아,483830,437445,921275
201511,2015,4호선,수유(강북구청),1188261,1151823,2340084
201511,2015,4호선,쌍문,871182,738162,1609344
201511,2015,4호선,창동,760222,827493,1587715
201511,2015,4호선,노원,636828,724843,1361671
201511,2015,4호선,상계,575446,510638,1086084
201511,2015,4호선,당고개,325833,301278,627111
201511,2015,3호선,오금,182053,159957,342010
201511,2015,3호선,경찰병원,193933,190137,384070
201511,2015,3호선,가락시장,207597,191155,398752
201511,2015,3호선,수서,293172,304600,597772
201511,2015,3호선,일원,230203,235761,465964
201511,2015,3호선,대청,282404,246958,529362
201511,2015,3호선,학여울,73502,76406,149908
201511,2015,3호선,대치,310628,293393,604021
201511,2015,3호선,도곡,204203,193204,397407
201511,2015,3호선,매봉,316377,304768,621145
201511,2015,3호선,양재,1173159,1248512,2421671
201511,2015,3호선,남부터미널,996156,1037060,2033216
201511,2015,3호선,교대,365368,277455,642823
201511,2015,3호선,고속터미널,1526873,1626510,3153383
201511,2015,3호선,잠원,144549,140498,285047
201511,2015,3호선,신사,863034,953906,1816940
201511,2015,3호선,압구정,942239,1047999,1990238
201511,2015,3호선,옥수,257484,264293,521777
201511,2015,3호선,금호,191791,173594,365385
201511,2015,3호선,약수,367366,352612,719978
201511,2015,3호선,동대입구,355365,405938,761303
201511,2015,3호선,충무로,57,0,57
201511,2015,3호선,을지로3가,226604,268426,495030
201511,2015,3호선,종로3가,193214,267990,461204
201511,2015,3호선,안국,722656,772168,1494824
201511,2015,3호선,경복궁,709877,756776,1466653
201511,2015,3호선,독립문,173398,180731,354129
201511,2015,3호선,무악재,98916,96748,195664
201511,2015,3호선,홍제,490832,454020,944852
201511,2015,3호선,녹번,380525,321592,702117
201511,2015,3호선,불광,461943,499867,961810
201511,2015,3호선,연신내,1036843,968855,2005698
201511,2015,3호선,구파발,451307,365204,816511
201511,2015,3호선,지축,28364,27760,56124
201511,2015,2호선,용두,45998,48359,94357
201511,2015,2호선,신정네거리,272369,272990,545359
201511,2015,2호선,양천구청,183284,194469,377753
201511,2015,2호선,도림천,24632,28154,52786
201511,2015,2호선,신설동,86375,81414,167789
201511,2015,2호선,신답,30670,35499,66169
201511,2015,2호선,용답,64120,66408,130528
201511,2015,2호선,충정로,304215,333339,637554
201511,2015,2호선,아현,255709,243854,499563
201511,2015,2호선,이대,663358,714197,1377555
201511,2015,2호선,신촌,1433100,1460470,2893570
201511,2015,2호선,홍대입구,2091584,2203399,4294983
201511,2015,2호선,합정,940402,978853,1919255
201511,2015,2호선,당산,621441,695215,1316656
201511,2015,2호선,영등포구청,559361,566451,1125812
201511,2015,2호선,문래,510658,520255,1030913
201511,2015,2호선,신도림,1778785,1773468,3552253
201511,2015,2호선,대림,859825,891910,1751735
201511,2015,2호선,구로디지털단지,1780824,1787743,3568567
201511,2015,2호선,신대방,730639,688337,1418976
201511,2015,2호선,신림,2014242,1949618,3963860
201511,2015,2호선,봉천,586609,534048,1120657
201511,2015,2호선,서울대입구,1425323,1399639,2824962
201511,2015,2호선,낙성대,840124,808668,1648792
201511,2015,2호선,사당,1170541,1338571,2509112
201511,2015,2호선,방배,595764,607151,1202915
201511,2015,2호선,서초,642786,651156,1293942
201511,2015,2호선,교대,982281,1103182,2085463
201511,2015,2호선,강남,2768407,2834361,5602768
201511,2015,2호선,역삼,1255307,1398085,2653392
201511,2015,2호선,선릉,1500553,1288654,2789207
201511,2015,2호선,삼성,1650229,1720151,3370380
201511,2015,2호선,종합운동장,349642,395126,744768
201511,2015,경인선,주안,844392,846129,1690521
201511,2015,2호선,신천,702015,686610,1388625
201511,2015,2호선,잠실,2311899,2150490,4462389
201511,2015,2호선,잠실나루,481107,455354,936461
201511,2015,2호선,강변,1404714,1402388,2807102
201511,2015,2호선,구의,636182,620701,1256883
201511,2015,2호선,건대입구,1267656,1393282,2660938
201511,2015,2호선,성수,665831,735996,1401827
201511,2015,2호선,뚝섬,427529,451728,879257
201511,2015,2호선,한양대,426537,497530,924067
201511,2015,2호선,왕십리(성동구청),588020,485431,1073451
201511,2015,2호선,상왕십리,281158,261226,542384
201511,2015,2호선,신당,361579,383057,744636
201511,2015,2호선,동대문역사문화공원,497206,582610,1079816
201511,2015,2호선,을지로4가,311438,310572,622010
201511,2015,2호선,을지로3가,546186,526933,1073119
201511,2015,2호선,을지로입구,1478643,1473780,2952423
201511,2015,2호선,시청,755972,741787,1497759
201511,2015,1호선,동묘앞,164374,181803,346177
201511,2015,1호선,청량리(지하),581563,606457,1188020
201511,2015,1호선,제기동,291233,286499,577732
201511,2015,1호선,신설동,395504,386389,781893
201511,2015,1호선,동대문,347299,414534,761833
201511,2015,1호선,종로5가,589152,599186,1188338
201511,2015,1호선,종로3가,772421,711158,1483579
201511,2015,1호선,종각,1298422,1202510,2500932
201511,2015,1호선,시청,717981,725770,1443751
201511,2015,1호선,서울역,1728236,1520608,3248844
201511,2015,경인선,제물포,213074,194265,407339
201511,2015,경인선,동인천,500079,455286,955365
201511,2015,경인선,인천,68638,69139,137777
201511,2015,경인선,구일,160614,162640,323254
201511,2015,경인선,소사,330909,325485,656394
201511,2015,경인선,부개,277030,256564,533594
201511,2015,경인선,간석,166590,158508,325098
201511,2015,경인선,도원,92669,94305,186974
201511,2015,경인선,온수,193528,181860,375388
201511,2015,경인선,중동,258981,240634,499615
201511,2015,경인선,도화,85995,76213,162208
201511,2015,경원선,이촌,118366,89753,208119
201511,2015,경원선,서빙고,54309,56032,110341
201511,2015,경원선,한남,105426,104869,210295
201511,2015,경원선,옥수,1491,961,2452
201511,2015,경원선,응봉,41895,34789,76684
201511,2015,경원선,왕십리,475202,496920,972122
201511,2015,경원선,청량리(지상),334113,386248,720361
201511,2015,경원선,외대앞,363827,342982,706809
201511,2015,경원선,신이문,245222,209927,455149
201511,2015,경원선,석계,294054,322548,616602
201511,2015,경원선,광운대,290820,269555,560375
201511,2015,경원선,월계,154773,139835,294608
201511,2015,경원선,녹천,126220,98931,225151
201511,2015,경원선,창동,5,0,5
201511,2015,경원선,방학,221023,211322,432345
201511,2015,경원선,도봉,140911,132132,273043
201511,2015,경원선,도봉산,90156,82189,172345
201511,2015,경원선,망월사,225420,227756,453176
201511,2015,경원선,회룡,291738,270785,562523
201511,2015,경원선,의정부,588704,622055,1210759
201511,2015,경원선,가능,180379,168608,348987
201511,2015,경원선,녹양,126678,111082,237760
201511,2015,경원선,양주,240473,210169,450642
201511,2015,경원선,덕계,52418,48121,100539
201511,2015,경원선,덕정,192789,185529,378318
201511,2015,경원선,지행,187992,184316,372308
201511,2015,경원선,동두천 중앙,86340,82388,168728
201511,2015,경원선,보산,47010,44720,91730
201511,2015,경원선,동두천,49697,59615,109312
201511,2015,경원선,소요산,66472,52011,118483
201511,2015,안산선,산본,464255,496449,960704
201511,2015,안산선,대야미,102365,91776,194141
201511,2015,안산선,반월,133427,122198,255625
201511,2015,안산선,상록수,592384,580051,1172435
201511,2015,안산선,한대앞,271200,263829,535029
201511,2015,안산선,중앙,479367,509331,988698
201511,2015,안산선,고잔,253336,252364,505700
201511,2015,안산선,초지,144139,142098,286237
201511,2015,안산선,안산,508260,463583,971843
201511,2015,안산선,신길온천,46396,41187,87583
201511,2015,안산선,정왕,284008,298053,582061
201511,2015,안산선,오이도,220899,213603,434502
201511,2015,안산선,수리산,115485,86642,202127
201511,2015,과천선,선바위,249077,207080,456157
201511,2015,과천선,경마공원,180343,183523,363866
201511,2015,과천선,대공원,109368,115189,224557
201511,2015,과천선,과천,135477,115189,250666
201511,2015,과천선,정부과천청사,322866,317154,640020
201511,2015,과천선,인덕원,669084,665363,1334447
201511,2015,과천선,평촌,408860,397956,806816
201511,2015,과천선,범계,871282,882557,1753839
201511,2015,분당선,선릉,235799,490471,726270
201511,2015,분당선,한티,369161,389460,758621
201511,2015,분당선,도곡,165104,176009,341113
201511,2015,분당선,구룡,50806,47674,98480
201511,2015,분당선,개포동,98020,98838,196858
201511,2015,분당선,대모산입구,97449,86735,184184
201511,2015,분당선,수서,211788,216967,428755
201511,2015,분당선,복정,1,0,1
201511,2015,분당선,수원,280037,184860,464897
201511,2015,분당선,서울숲,164250,161154,325404
201511,2015,분당선,압구정로데오,402064,458466,860530
201511,2015,분당선,강남구청,227858,269220,497078
201511,2015,분당선,선정릉,197016,220333,417349
201511,2015,분당선,가천대,316787,361453,678240
201511,2015,분당선,태평,366682,350624,717306
201511,2015,분당선,모란,613612,563050,1176662
201511,2015,분당선,야탑,720368,762447,1482815
201511,2015,분당선,서현,672381,695903,1368284
201511,2015,분당선,수내,341802,343036,684838
201511,2015,분당선,정자,435794,474736,910530
201511,2015,분당선,미금,535679,563130,1098809
201511,2015,분당선,오리,390754,327536,718290
201511,2015,분당선,이매,130087,123769,253856
201511,2015,분당선,보정,65250,49225,114475
201511,2015,분당선,죽전,596369,644119,1240488
201511,2015,분당선,구성,133372,127309,260681
201511,2015,분당선,신갈,109824,103918,213742
201511,2015,분당선,기흥,227883,215835,443718
201511,2015,분당선,상갈,134556,127272,261828
201511,2015,분당선,청명,119551,109941,229492
201511,2015,분당선,영통,257140,263472,520612
201511,2015,분당선,망포,343052,312747,655799
201511,2015,분당선,매탄권선,122293,115009,237302
201511,2015,분당선,수원시청,286616,321655,608271
201511,2015,분당선,매교,66783,64402,131185
201511,2015,일산선,원흥,141200,118156,259356
201511,2015,일산선,지축,1,0,1
201511,2015,일산선,삼송,316453,297267,613720
201511,2015,일산선,원당,303890,281950,585840
201511,2015,일산선,화정,482906,505536,988442
201511,2015,일산선,대곡,35149,25018,60167
201511,2015,일산선,백석,262393,254570,516963
201511,2015,일산선,마두,185554,194525,380079
201511,2015,일산선,정발산,216455,235343,451798
201511,2015,일산선,주엽,197933,202387,400320
201511,2015,일산선,대화,371966,287351,659317
201511,2015,중앙선,회기,870193,854774,1724967
201511,2015,중앙선,중랑,136766,128247,265013
201511,2015,중앙선,상봉,135771,133737,269508
201511,2015,중앙선,망우,185636,180752,366388
201511,2015,중앙선,양원,48444,51492,99936
201511,2015,중앙선,구리,337775,356663,694438
201511,2015,중앙선,도농,226320,196733,423053
201511,2015,중앙선,양정,18856,15647,34503
201511,2015,중앙선,덕소,150084,151484,301568
201511,2015,중앙선,도심,60037,47431,107468
201511,2015,중앙선,팔당,16268,15553,31821
201511,2015,중앙선,운길산,25329,23256,48585
201511,2015,중앙선,양수,43312,42837,86149
201511,2015,중앙선,신원,4571,3983,8554
201511,2015,중앙선,국수,18772,17758,36530
201511,2015,중앙선,아신,21088,21998,43086
201511,2015,중앙선,오빈,6445,6368,12813
201511,2015,중앙선,양평,82765,83069,165834
201511,2015,중앙선,원덕,6630,6205,12835
201511,2015,중앙선,용문,49750,49801,99551
201511,2015,장항선,봉명,31587,31284,62871
201511,2015,장항선,쌍용동,82309,76467,158776
201511,2015,장항선,아산,79285,68220,147505
201511,2015,장항선,배방,23544,21999,45543
201511,2015,장항선,온양온천,101574,102915,204489
201511,2015,장항선,신창,74017,73880,147897
201511,2015,경의선,서울역,86133,90080,176213
201511,2015,경의선,신촌,23245,30379,53624
201511,2015,경의선,공덕,43126,50587,93713
201511,2015,경의선,서강대,58887,62335,121222
201511,2015,경의선,홍대입구,37849,55426,93275
201511,2015,경의선,가좌,77028,70853,147881
201511,2015,경의선,디지털미디어시티,61155,56687,117842
201511,2015,경의선,수색,46090,49266,95356
201511,2015,경의선,화전,83738,79224,162962
201511,2015,경의선,강매,60837,51484,112321
201511,2015,경의선,행신,190664,179789,370453
201511,2015,경의선,능곡,89440,79967,169407
201511,2015,경의선,곡산,12351,12229,24580
201511,2015,경의선,백마,173591,160242,333833
201511,2015,경의선,풍산,112689,104207,216896
201511,2015,경의선,일산,235711,226919,462630
201511,2015,경의선,탄현,205295,193808,399103
201511,2015,경의선,야당,51334,49191,100525
201511,2015,경의선,운정,124383,112207,236590
201511,2015,경의선,금릉,122377,119226,241603
201511,2015,경의선,금촌,180964,173551,354515
201511,2015,경의선,월롱,62576,73446,136022
201511,2015,경의선,파주,47906,34824,82730
201511,2015,경의선,문산,150435,149404,299839
201511,2015,경춘선,신내,14404,16346,30750
201511,2015,경춘선,갈매,9253,9547,18800
201511,2015,경춘선,별내,54853,52429,107282
201511,2015,경춘선,퇴계원,85558,75058,160616
201511,2015,경춘선,사릉,94917,86865,181782
201511,2015,경춘선,금곡,30892,29453,60345
201511,2015,경춘선,평내호평,133748,130369,264117
201511,2015,경춘선,천마산,23787,21401,45188
201511,2015,경춘선,마석,80609,84971,165580
201511,2015,경춘선,대성리,20701,19185,39886
201511,2015,경춘선,청평,50142,46327,96469
201511,2015,경춘선,상천,8970,7913,16883
201511,2015,경춘선,가평,62917,64946,127863
201511,2015,경춘선,굴봉산,4190,3913,8103
201511,2015,경춘선,백양리,3923,3581,7504
201511,2015,경춘선,강촌,22116,18256,40372
201511,2015,경춘선,김유정,11270,14235,25505
201511,2015,경춘선,남춘천,76929,81636,158565
201511,2015,경춘선,춘천,57406,54046,111452
201511,2015,수인선,달월,1599,1248,2847
201511,2015,수인선,월곶,63177,57942,121119
201511,2015,수인선,소래포구,105694,97001,202695
201511,2015,수인선,인천논현,127917,133125,261042
201511,2015,수인선,호구포,70369,72157,142526
201511,2015,수인선,남동인더스파크,47155,51737,98892
201511,2015,수인선,원인재,98418,106025,204443
201511,2015,수인선,연수,89641,85575,175216
201511,2015,수인선,송도,96334,97860,194194
201511,2015,5호선,방화,189550,179091,368641
201511,2015,5호선,개화산,152576,140601,293177
201511,2015,5호선,김포공항,201142,175405,376547
201511,2015,5호선,송정,255157,245761,500918
201511,2015,5호선,마곡,86335,69191,155526
201511,2015,5호선,발산,302717,301681,604398
201511,2015,5호선,우장산,431370,419899,851269
201511,2015,5호선,화곡,766578,700712,1467290
201511,2015,5호선,까치산,779422,725170,1504592
201511,2015,5호선,신정,396998,304745,701743
201511,2015,5호선,오목교,694599,754050,1448649
201511,2015,5호선,양평,161497,161789,323286
201511,2015,5호선,영등포구청,82563,82633,165196
201511,2015,5호선,영등포시장,171551,191296,362847
201511,2015,5호선,신길,82391,95788,178179
201511,2015,5호선,여의도,632216,708042,1340258
201511,2015,5호선,여의나루,204172,222015,426187
201511,2015,5호선,마포,392990,412787,805777
201511,2015,5호선,공덕,356847,380308,737155
201511,2015,5호선,애오개,173515,175033,348548
201511,2015,5호선,충정로,127106,132651,259757
201511,2015,5호선,서대문,484228,498191,982419
201511,2015,5호선,광화문,1021283,1085129,2106412
201511,2015,5호선,종로3가,289611,281437,571048
201511,2015,5호선,을지로4가,117632,132605,250237
201511,2015,5호선,동대문역사문화공원,76767,92732,169499
201511,2015,5호선,청구,101405,97852,199257
201511,2015,5호선,신금호,129582,128556,258138
201511,2015,5호선,행당,214363,184697,399060
201511,2015,5호선,왕십리(성동구청),130096,164294,294390
201511,2015,5호선,마장,158832,154663,313495
201511,2015,5호선,답십리,427539,386073,813612
201511,2015,5호선,장한평,472232,472490,944722
201511,2015,5호선,군자,301159,329004,630163
201511,2015,5호선,아차산,370762,353318,724080
201511,2015,5호선,광나루,401969,356406,758375
201511,2015,5호선,천호,510800,545900,1056700
201511,2015,5호선,강동,515248,424294,939542
201511,2015,5호선,길동,176054,184755,360809
201511,2015,5호선,굽은다리,246931,234526,481457
201511,2015,5호선,명일,202336,202248,404584
201511,2015,5호선,고덕,212797,209970,422767
201511,2015,5호선,상일동,294330,242861,537191
201511,2015,5호선,둔촌동,342066,339424,681490
201511,2015,5호선,올림픽공원,193725,194621,388346
201511,2015,5호선,방이,177504,179861,357365
201511,2015,5호선,오금,103114,102694,205808
201511,2015,5호선,개롱,177522,175611,353133
201511,2015,5호선,거여,177566,166888,344454
201511,2015,5호선,마천,135659,133091,268750
201511,2015,6호선,응암,443822,423591,867413
201511,2015,6호선,역촌,84586,105279,189865
201511,2015,6호선,불광,136213,138063,274276
201511,2015,6호선,독바위,68607,71492,140099
201511,2015,6호선,연신내,23,0,23
201511,2015,6호선,구산,200324,132194,332518
201511,2015,6호선,새절,357339,334649,691988
201511,2015,6호선,증산,261405,248237,509642
201511,2015,6호선,디지털미디어시티,401276,437356,838632
201511,2015,6호선,월드컵경기장,171837,179879,351716
201511,2015,6호선,마포구청,344596,295533,640129
201511,2015,6호선,망원,287398,304323,591721
201511,2015,6호선,합정,361712,341569,703281
201511,2015,6호선,상수,295846,354235,650081
201511,2015,6호선,광흥창,229713,222642,452355
201511,2015,6호선,대흥,226045,239965,466010
201511,2015,6호선,공덕,474236,467865,942101
201511,2015,6호선,효창공원앞,204537,198671,403208
201511,2015,6호선,삼각지,214258,171183,385441
201511,2015,6호선,녹사평(용산구청),189653,206788,396441
201511,2015,6호선,이태원,424325,474201,898526
201511,2015,6호선,한강진,168058,208218,376276
201511,2015,6호선,버티고개,66811,59570,126381
201511,2015,6호선,약수,89590,90552,180142
201511,2015,6호선,청구,97540,101558,199098
201511,2015,6호선,신당,216887,224598,441485
201511,2015,6호선,동묘앞,217450,220285,437735
201511,2015,6호선,창신,88733,75255,163988
201511,2015,6호선,보문,231555,200475,432030
201511,2015,6호선,안암,433444,448431,881875
201511,2015,6호선,고려대,306096,295401,601497
201511,2015,6호선,월곡,345902,320218,666120
201511,2015,6호선,상월곡,173030,161190,334220
201511,2015,6호선,돌곶이,243002,216954,459956
201511,2015,6호선,석계,351945,357399,709344
201511,2015,6호선,태릉입구,135283,171012,306295
201511,2015,6호선,화랑대,389570,284861,674431
201511,2015,6호선,봉화산(서울의료원),242734,224793,467527
201511,2015,7호선,장암,69445,23207,92652
201511,2015,7호선,도봉산,314907,289628,604535
201511,2015,7호선,수락산,363907,343415,707322
201511,2015,7호선,마들,313077,279278,592355
201511,2015,7호선,노원,538836,591730,1130566
201511,2015,7호선,중계,422160,377982,800142
201511,2015,7호선,하계,551130,521063,1072193
201511,2015,7호선,공릉,356885,349819,706704
201511,2015,7호선,태릉입구,246619,235738,482357
201511,2015,7호선,뚝섬유원지,210603,200527,411130
201511,2015,7호선,청담,585866,689975,1275841
201511,2015,7호선,강남구청,446940,493242,940182
201511,2015,7호선,학동,636627,715945,1352572
201511,2015,7호선,논현,553806,614470,1168276
201511,2015,7호선,반포,175061,168631,343692
201511,2015,7호선,고속터미널,611364,517995,1129359
201511,2015,7호선,내방,377272,389538,766810
201511,2015,7호선,이수,449096,447390,896486
201511,2015,7호선,남성,295403,267934,563337
201511,2015,7호선,숭실대입구,480684,467012,947696
201511,2015,7호선,상도,305251,297771,603022
201511,2015,7호선,장승배기,253342,243088,496430
201511,2015,7호선,신대방삼거리,403560,375931,779491
201511,2015,7호선,보라매,266928,267069,533997
201511,2015,7호선,신풍,306920,287712,594632
201511,2015,7호선,대림,305689,303977,609666
201511,2015,7호선,남구로,450699,466895,917594
201511,2015,7호선,가산디지털단지,1208366,1202701,2411067
201511,2015,7호선,철산,664949,672599,1337548
201511,2015,7호선,광명사거리,714411,684989,1399400
201511,2015,7호선,천왕,206515,187236,393751
201511,2015,7호선,온수,310119,294515,604634
201511,2015,7호선,까치울,163999,144588,308587
201511,2015,7호선,부천종합운동장,151904,138022,289926
201511,2015,7호선,춘의,215583,210161,425744
201511,2015,7호선,신중동,388865,388652,777517
201511,2015,7호선,부천시청,330076,339096,669172
201511,2015,7호선,상동,383150,393717,776867
201511,2015,7호선,삼산체육관,145570,129838,275408
201511,2015,7호선,굴포천,234752,241924,476676
201511,2015,7호선,부평구청,341775,259507,601282
201511,2015,8호선,암사,449929,388773,838702
201511,2015,8호선,천호,503557,562847,1066404
201511,2015,8호선,강동구청,264764,273190,537954
201511,2015,8호선,몽촌토성,160310,173522,333832
201511,2015,8호선,잠실,309894,367170,677064
201511,2015,8호선,석촌,218573,232355,450928
201511,2015,8호선,송파,138091,140933,279024
201511,2015,8호선,가락시장,151935,185462,337397
201511,2015,8호선,문정,153245,145180,298425
201511,2015,8호선,장지,373268,361549,734817
201511,2015,8호선,복정,227615,167237,394852
201511,2015,8호선,산성,189733,182302,372035
201511,2015,8호선,남한산성입구,397427,365741,763168
201511,2015,8호선,단대오거리,339209,311422,650631
201511,2015,8호선,신흥,116998,120225,237223
201511,2015,8호선,수진,120433,108177,228610
201511,2015,8호선,모란,95250,73917,169167
201511,2015,9호선,개화,165809,101295,267104
201511,2015,9호선,김포공항,247099,306564,553663
201511,2015,9호선,공항시장,70347,78449,148796
201511,2015,9호선,신방화,198045,190557,388602
201511,2015,9호선,마곡나루,54676,50454,105130
201511,2015,9호선,양천향교,187286,184089,371375
201511,2015,9호선,가양,508123,490879,999002
201511,2015,9호선,증미,183573,186365,369938
201511,2015,9호선,등촌,246659,239914,486573
201511,2015,9호선,염창,419062,409346,828408
201511,2015,9호선,신목동,109694,93656,203350
201511,2015,9호선,선유도,175694,174067,349761
201511,2015,9호선,당산,461342,429109,890451
201511,2015,9호선,국회의사당,411627,418550,830177
201511,2015,9호선,여의도,513690,492725,1006415
201511,2015,9호선,샛강,131092,139345,270437
201511,2015,9호선,노량진,616182,657154,1273336
201511,2015,9호선,노들,118617,99302,217919
201511,2015,9호선,흑석(중앙대입구),319735,328197,647932
201511,2015,9호선,동작,47907,35186,83093
201511,2015,9호선,구반포,82769,87116,169885
201511,2015,9호선,신반포,83394,82291,165685
201511,2015,9호선,고속터미널,449101,515256,964357
201511,2015,9호선,사평,71691,66763,138454
201511,2015,9호선,신논현,825952,826075,1652027
201511,2015,공항철도 1호선,서울역,276671,233801,510472
201511,2015,공항철도 1호선,공덕,35732,42970,78702
201511,2015,공항철도 1호선,홍대입구,213648,209840,423488
201511,2015,공항철도 1호선,디지털미디어시티,303861,260138,563999
201511,2015,공항철도 1호선,김포공항,266197,175087,441284
201511,2015,공항철도 1호선,계양,295784,270068,565852
201511,2015,공항철도 1호선,검암,469349,429377,898726
201511,2015,공항철도 1호선,청라국제도시,134970,127615,262585
201511,2015,공항철도 1호선,운서,144036,145979,290015
201511,2015,공항철도 1호선,공항화물청사,62433,67159,129592
201511,2015,공항철도 1호선,인천국제공항,314222,296538,610760
201511,2015,9호선2단계,언주,189230,187602,376832
201511,2015,9호선2단계,선정릉,157583,166251,323834
201511,2015,9호선2단계,삼성중앙,111146,115974,227120
201511,2015,9호선2단계,봉은사,298203,285419,583622
201511,2015,9호선2단계,종합운동장,133598,105995,239593
201511,2015,7호선,먹골,272882,258985,531867
201511,2015,7호선,중화,307063,289659,596722
201511,2015,7호선,상봉,468626,438912,907538
201511,2015,7호선,면목,425338,405411,830749
201511,2015,7호선,사가정,418630,404830,823460
201511,2015,7호선,용마산,164671,151201,315872
201511,2015,7호선,중곡,269130,241427,510557
201511,2015,7호선,군자,381576,284828,666404
201511,2015,7호선,어린이대공원,496025,503307,999332
201511,2015,7호선,건대입구,494450,530170,1024620
201510,2015,경원선,창동,6,0,6
201510,2015,3호선,교대,361173,272702,633875
201510,2015,3호선,고속터미널,1538085,1616083,3154168
201510,2015,3호선,잠원,141768,136588,278356
201510,2015,3호선,신사,857890,961510,1819400
201510,2015,3호선,압구정,914533,1024530,1939063
201510,2015,3호선,옥수,259647,266280,525927
201510,2015,3호선,금호,191054,170811,361865
201510,2015,3호선,약수,358420,342524,700944
201510,2015,3호선,동대입구,353315,404023,757338
201510,2015,3호선,충무로,36,0,36
201510,2015,3호선,을지로3가,212516,254095,466611
201510,2015,3호선,종로3가,189610,269614,459224
201510,2015,3호선,안국,742911,805278,1548189
201510,2015,3호선,경복궁,717070,782028,1499098
201510,2015,3호선,독립문,174523,184103,358626
201510,2015,3호선,무악재,96266,92973,189239
201510,2015,3호선,홍제,487341,446022,933363
201510,2015,3호선,녹번,377781,315353,693134
201510,2015,3호선,불광,454812,496147,950959
201510,2015,3호선,연신내,1043025,968416,2011441
201510,2015,3호선,구파발,467121,379921,847042
201510,2015,3호선,지축,30383,30397,60780
201510,2015,2호선,용두,43486,46459,89945
201510,2015,2호선,신정네거리,267877,265485,533362
201510,2015,2호선,양천구청,177723,187268,364991
201510,2015,2호선,도림천,22993,26347,49340
201510,2015,2호선,신설동,83237,78603,161840
201510,2015,2호선,신답,31034,35809,66843
201510,2015,2호선,용답,61732,62694,124426
201510,2015,2호선,충정로,293750,325872,619622
201510,2015,2호선,아현,248095,235099,483194
201510,2015,2호선,이대,646710,690085,1336795
201510,2015,2호선,신촌,1395226,1435013,2830239
201510,2015,2호선,홍대입구,2122487,2298057,4420544
201510,2015,2호선,합정,951485,994055,1945540
201510,2015,2호선,당산,635086,712138,1347224
201510,2015,2호선,영등포구청,544753,550439,1095192
201510,2015,2호선,문래,504232,512771,1017003
201510,2015,2호선,신도림,1795612,1799442,3595054
201510,2015,2호선,대림,819332,853314,1672646
201510,2015,2호선,구로디지털단지,1765384,1771862,3537246
201510,2015,2호선,신대방,711940,667632,1379572
201510,2015,2호선,신림,2013715,1939384,3953099
201510,2015,2호선,봉천,572169,514852,1087021
201510,2015,2호선,서울대입구,1425473,1402307,2827780
201510,2015,2호선,낙성대,841725,800371,1642096
201510,2015,7호선,도봉산,329261,308823,638084
201510,2015,7호선,수락산,353757,334307,688064
201510,2015,7호선,마들,295361,263312,558673
201510,2015,7호선,노원,528506,589528,1118034
201510,2015,7호선,중계,399719,355883,755602
201510,2015,7호선,하계,536669,505749,1042418
201510,2015,7호선,공릉,338617,331655,670272
201510,2015,7호선,태릉입구,246022,235309,481331
201510,2015,경부선,천안,265233,217911,483144
201510,2015,경부선,두정,200552,221760,422312
201510,2015,경부선,직산,26744,30696,57440
201510,2015,경부선,성환,167021,159798,326819
201510,2015,2호선,서초,628817,632843,1261660
201510,2015,경부선,평택,411773,406354,818127
201510,2015,경부선,지제,24996,24732,49728
201510,2015,1호선,서울역,1702655,1501987,3204642
201510,2015,2호선,방배,593469,603849,1197318
201510,2015,1호선,시청,679210,687478,1366688
201510,2015,1호선,종각,1199979,1137174,2337153
201510,2015,1호선,종로3가,743633,683553,1427186
201510,2015,1호선,종로5가,565358,583054,1148412
201510,2015,1호선,동대문,343693,424762,768455
201510,2015,1호선,신설동,389625,381740,771365
201510,2015,1호선,제기동,290008,285374,575382
201510,2015,1호선,청량리(지하),587943,610295,1198238
201510,2015,1호선,동묘앞,169865,186853,356718
201510,2015,2호선,시청,714247,699742,1413989
201510,2015,2호선,을지로입구,1424089,1424840,2848929
201510,2015,2호선,을지로3가,513223,499162,1012385
201510,2015,2호선,을지로4가,301573,298270,599843
201510,2015,2호선,동대문역사문화공원,522526,609795,1132321
201510,2015,2호선,신당,356432,379526,735958
201510,2015,2호선,상왕십리,275343,255728,531071
201510,2015,2호선,왕십리(성동구청),568482,469935,1038417
201510,2015,2호선,한양대,384810,451282,836092
201510,2015,2호선,뚝섬,422508,445921,868429
201510,2015,2호선,성수,641967,716699,1358666
201510,2015,2호선,건대입구,1296956,1422646,2719602
201510,2015,2호선,구의,617908,599202,1217110
201510,2015,2호선,강변,1453991,1433481,2887472
201510,2015,2호선,잠실나루,475946,452909,928855
201510,2015,2호선,잠실,2375233,2190236,4565469
201510,2015,2호선,신천,688985,675177,1364162
201510,2015,2호선,종합운동장,533227,598531,1131758
201510,2015,2호선,삼성,1590907,1667336,3258243
201510,2015,2호선,선릉,1456421,1254593,2711014
201510,2015,2호선,역삼,1198687,1351213,2549900
201510,2015,경춘선,굴봉산,6591,6275,12866
201510,2015,경춘선,백양리,4654,4575,9229
201510,2015,경춘선,강촌,32475,25590,58065
201510,2015,경춘선,김유정,16465,21990,38455
201510,2015,경춘선,남춘천,87785,90145,177930
201510,2015,경춘선,춘천,73663,64959,138622
201510,2015,수인선,달월,1715,1415,3130
201510,2015,수인선,월곶,67136,60668,127804
201510,2015,수인선,소래포구,142592,138247,280839
201510,2015,수인선,인천논현,133942,139720,273662
201510,2015,수인선,호구포,72689,75200,147889
201510,2015,수인선,남동인더스파크,49043,53042,102085
201510,2015,수인선,원인재,104339,111507,215846
201510,2015,수인선,연수,93999,89533,183532
201510,2015,수인선,송도,102471,103025,205496
201510,2015,5호선,방화,181547,171061,352608
201510,2015,5호선,개화산,145570,134227,279797
201510,2015,5호선,김포공항,202192,176750,378942
201510,2015,5호선,송정,259927,246641,506568
201510,2015,5호선,마곡,83969,67283,151252
201510,2015,5호선,발산,301822,300865,602687
201510,2015,5호선,우장산,419748,402137,821885
201510,2015,5호선,화곡,761306,690632,1451938
201510,2015,5호선,까치산,762823,703441,1466264
201510,2015,5호선,신정,391897,297683,689580
201510,2015,5호선,목동,500560,528812,1029372
201510,2015,5호선,오목교,704379,766358,1470737
201510,2015,2호선,강남,2737524,2809821,5547345
201510,2015,5호선,양평,155405,155288,310693
201510,2015,5호선,영등포구청,83816,84938,168754
201510,2015,5호선,영등포시장,168269,186762,355031
201510,2015,5호선,신길,84130,96104,180234
201510,2015,5호선,여의도,644590,715412,1360002
201510,2015,5호선,여의나루,332031,425519,757550
201510,2015,5호선,마포,401831,418484,820315
201510,2015,5호선,공덕,350753,374484,725237
201510,2015,5호선,애오개,168236,168298,336534
201510,2015,5호선,충정로,123130,129623,252753
201510,2015,5호선,서대문,461524,478734,940258
201510,2015,5호선,광화문,1004028,1069459,2073487
201510,2015,5호선,종로3가,283562,281132,564694
201510,2015,5호선,을지로4가,109942,125962,235904
201510,2015,5호선,동대문역사문화공원,73789,91272,165061
201510,2015,5호선,청구,99591,97511,197102
201510,2015,5호선,신금호,128570,126737,255307
201510,2015,5호선,행당,208704,178086,386790
201510,2015,5호선,왕십리(성동구청),127494,160931,288425
201510,2015,5호선,마장,149975,146038,296013
201510,2015,5호선,답십리,419975,376940,796915
201510,2015,5호선,장한평,469402,467015,936417
201510,2015,5호선,군자,295796,321885,617681
201510,2015,5호선,아차산,380971,359485,740456
201510,2015,5호선,광나루,418888,372869,791757
201510,2015,5호선,천호,511799,548328,1060127
201510,2015,5호선,강동,514307,420635,934942
201510,2015,5호선,길동,168430,174813,343243
201510,2015,5호선,굽은다리,234833,221396,456229
201510,2015,5호선,명일,196538,194177,390715
201510,2015,5호선,고덕,201749,199095,400844
201510,2015,5호선,상일동,287382,233552,520934
201510,2015,5호선,둔촌동,331960,325666,657626
201510,2015,5호선,올림픽공원,216833,217979,434812
201510,2015,5호선,방이,170569,173081,343650
201510,2015,경부선,서정리,156559,152036,308595
201510,2015,5호선,오금,100665,100973,201638
201510,2015,5호선,개롱,170801,168024,338825
201510,2015,5호선,거여,171873,160026,331899
201510,2015,5호선,마천,132515,130126,262641
201510,2015,6호선,응암,440921,418037,858958
201510,2015,6호선,역촌,81630,103908,185538
201510,2015,6호선,불광,135940,138706,274646
201510,2015,6호선,독바위,68588,73841,142429
201510,2015,6호선,연신내,23,0,23
201510,2015,6호선,구산,198563,126134,324697
201510,2015,과천선,경마공원,200515,204791,405306
201510,2015,과천선,선바위,253770,211300,465070
201510,2015,안산선,수리산,119687,91607,211294
201510,2015,안산선,오이도,237972,230402,468374
201510,2015,안산선,정왕,292211,305248,597459
201510,2015,안산선,신길온천,49077,44435,93512
201510,2015,안산선,안산,529124,480439,1009563
201510,2015,7호선,남성,289564,260936,550500
201510,2015,7호선,숭실대입구,474239,460476,934715
201510,2015,7호선,상도,302740,290548,593288
201510,2015,7호선,장승배기,251461,240252,491713
201510,2015,7호선,신대방삼거리,400593,370365,770958
201510,2015,7호선,보라매,260692,260943,521635
201510,2015,7호선,신풍,298500,279513,578013
201510,2015,7호선,대림,287261,286793,574054
201510,2015,7호선,남구로,424695,442753,867448
201510,2015,7호선,가산디지털단지,1143773,1154323,2298096
201510,2015,7호선,철산,672611,677263,1349874
201510,2015,7호선,광명사거리,715548,678858,1394406
201510,2015,7호선,천왕,203459,185604,389063
201510,2015,7호선,온수,315586,298146,613732
201510,2015,7호선,까치울,178210,156630,334840
201510,2015,7호선,부천종합운동장,163293,147320,310613
201510,2015,7호선,춘의,218093,212507,430600
201510,2015,7호선,신중동,396180,394687,790867
201510,2015,7호선,부천시청,339680,346968,686648
201510,2015,7호선,상동,387599,399594,787193
201510,2015,7호선,삼산체육관,155419,139391,294810
201510,2015,7호선,굴포천,237523,242173,479696
201510,2015,과천선,대공원,248854,258611,507465
201510,2015,과천선,과천,143111,120647,263758
201510,2015,과천선,정부과천청사,316231,310965,627196
201510,2015,과천선,인덕원,683239,673319,1356558
201510,2015,과천선,평촌,412290,399185,811475
201510,2015,과천선,범계,902398,911143,1813541
201510,2015,분당선,선릉,223737,471786,695523
201510,2015,분당선,한티,348205,368378,716583
201510,2015,분당선,도곡,154503,165495,319998
201510,2015,분당선,구룡,49049,45968,95017
201510,2015,분당선,개포동,100133,100191,200324
201510,2015,분당선,대모산입구,96553,85121,181674
201510,2015,분당선,수서,209514,215526,425040
201510,2015,분당선,복정,5,0,5
201510,2015,분당선,수원,282933,184502,467435
201510,2015,분당선,서울숲,177063,174141,351204
201510,2015,분당선,압구정로데오,391249,454744,845993
201510,2015,분당선,강남구청,221804,263183,484987
201510,2015,분당선,선정릉,189875,216806,406681
201510,2015,분당선,가천대,343671,390088,733759
201510,2015,분당선,태평,369903,347874,717777
201510,2015,분당선,모란,646270,588331,1234601
201510,2015,분당선,야탑,728022,771364,1499386
201510,2015,분당선,서현,669440,693804,1363244
201510,2015,분당선,수내,341256,341485,682741
201510,2015,분당선,정자,428554,469667,898221
201510,2015,분당선,미금,539122,566125,1105247
201510,2015,분당선,오리,391745,324967,716712
201510,2015,분당선,이매,131136,125305,256441
201510,2015,분당선,보정,66033,49236,115269
201510,2015,분당선,죽전,607420,654369,1261789
201510,2015,분당선,구성,137586,130162,267748
201510,2015,분당선,신갈,111908,106636,218544
201510,2015,분당선,기흥,234691,219869,454560
201510,2015,분당선,상갈,142951,134716,277667
201510,2015,분당선,청명,121217,110978,232195
201510,2015,분당선,영통,257516,262912,520428
201510,2015,분당선,망포,345405,314135,659540
201510,2015,분당선,매탄권선,122324,113271,235595
201510,2015,분당선,수원시청,288336,327941,616277
201510,2015,분당선,매교,66115,64470,130585
201510,2015,일산선,원흥,140620,117311,257931
201510,2015,일산선,삼송,323274,299888,623162
201510,2015,일산선,원당,313744,290008,603752
201510,2015,일산선,화정,499388,520595,1019983
201510,2015,일산선,대곡,37611,26766,64377
201510,2015,일산선,백석,265050,257555,522605
201510,2015,일산선,마두,187440,195133,382573
201510,2015,일산선,정발산,233747,254268,488015
201510,2015,일산선,주엽,202859,205504,408363
201510,2015,일산선,대화,398412,307695,706107
201510,2015,중앙선,회기,837244,816579,1653823
201510,2015,중앙선,중랑,134043,124630,258673
201510,2015,중앙선,상봉,140689,136893,277582
201510,2015,중앙선,망우,191649,185228,376877
201510,2015,중앙선,양원,47904,51451,99355
201510,2015,중앙선,구리,360338,379094,739432
201510,2015,중앙선,도농,236600,203709,440309
201510,2015,중앙선,양정,20231,16972,37203
201510,2015,중앙선,덕소,156342,157519,313861
201510,2015,중앙선,도심,63602,50434,114036
201510,2015,중앙선,팔당,26876,27102,53978
201510,2015,중앙선,운길산,35565,32911,68476
201510,2015,중앙선,양수,48940,48014,96954
201510,2015,중앙선,신원,6257,4819,11076
201510,2015,중앙선,국수,21302,19868,41170
201510,2015,중앙선,아신,23826,23568,47394
201510,2015,중앙선,오빈,7272,7081,14353
201510,2015,중앙선,양평,90810,90351,181161
201510,2015,중앙선,원덕,7378,6957,14335
201510,2015,중앙선,용문,62279,62276,124555
201510,2015,장항선,봉명,32170,31040,63210
201510,2015,장항선,쌍용동,85252,78261,163513
201510,2015,장항선,아산,78911,68975,147886
201510,2015,장항선,배방,23831,22370,46201
201510,2015,장항선,온양온천,104926,105364,210290
201510,2015,장항선,신창,78022,73357,151379
201510,2015,경의선,서울역,87878,92114,179992
201510,2015,경의선,신촌,25173,31405,56578
201510,2015,경의선,공덕,44799,54191,98990
201510,2015,경의선,서강대,56944,59834,116778
201510,2015,경의선,홍대입구,40990,61126,102116
201510,2015,경의선,가좌,68929,64179,133108
201510,2015,경의선,디지털미디어시티,64310,58921,123231
201510,2015,경의선,수색,46877,50051,96928
201510,2015,경의선,화전,81680,77043,158723
201510,2015,경의선,강매,62216,52554,114770
201510,2015,경의선,행신,196506,184078,380584
201510,2015,경의선,능곡,93512,83552,177064
201510,2015,경의선,곡산,13006,12819,25825
201510,2015,경의선,백마,180794,164560,345354
201510,2015,경의선,풍산,115613,106476,222089
201510,2015,경의선,일산,242354,231716,474070
201510,2015,경의선,탄현,220518,209383,429901
201510,2015,경의선,야당,1448,1397,2845
201510,2015,경의선,운정,153003,134953,287956
201510,2015,경의선,금릉,128923,125770,254693
201510,2015,경의선,금촌,187500,178640,366140
201510,2015,경의선,월롱,66364,75448,141812
201510,2015,경의선,파주,50431,36563,86994
201510,2015,경의선,문산,158770,156230,315000
201510,2015,경춘선,신내,14828,17917,32745
201510,2015,경춘선,갈매,9764,10201,19965
201510,2015,경춘선,별내,58451,55408,113859
201510,2015,경춘선,퇴계원,90379,79473,169852
201510,2015,경춘선,사릉,101875,93702,195577
201510,2015,경춘선,금곡,33407,32257,65664
201510,2015,경춘선,평내호평,143208,139685,282893
201510,2015,경춘선,천마산,25683,23189,48872
201510,2015,경춘선,마석,87560,92741,180301
201510,2015,경춘선,대성리,22317,23707,46024
201510,2015,경춘선,청평,57593,55226,112819
201510,2015,경춘선,상천,13497,11806,25303
201510,2015,경춘선,가평,89339,94155,183494
201510,2015,7호선,먹골,266996,252201,519197
201510,2015,7호선,중화,304707,284378,589085
201510,2015,7호선,상봉,473381,441648,915029
201510,2015,7호선,면목,425931,403718,829649
201510,2015,7호선,사가정,416978,400996,817974
201510,2015,7호선,용마산,162174,149206,311380
201510,2015,7호선,중곡,267914,237210,505124
201510,2015,7호선,군자,373725,274344,648069
201510,2015,7호선,어린이대공원,510900,518616,1029516
201510,2015,7호선,건대입구,476393,521863,998256
201510,2015,7호선,뚝섬유원지,256748,244235,500983
201510,2015,7호선,청담,567535,672514,1240049
201510,2015,7호선,강남구청,438759,487794,926553
201510,2015,7호선,이수,437644,436049,873693
201510,2015,7호선,내방,367365,379171,746536
201510,2015,7호선,고속터미널,601343,514272,1115615
201510,2015,7호선,반포,162212,153067,315279
201510,2015,7호선,논현,545202,606111,1151313
201510,2015,7호선,학동,615657,697726,1313383
201510,2015,경부선,송탄,134811,130943,265754
201510,2015,경부선,진위,46958,41052,88010
201510,2015,경부선,오산,299875,282380,582255
201510,2015,경부선,오산대,91112,92995,184107
201510,2015,경부선,세마,69943,62230,132173
201510,2015,경부선,병점,482342,476596,958938
201510,2015,경부선,세류,119247,110052,229299
201510,2015,경부선,독산,422284,441094,863378
201510,2015,경부선,수원,1354627,1447406,2802033
201510,2015,경부선,화서,241368,240484,481852
201510,2015,경부선,성균관대,499474,469917,969391
201510,2015,경부선,의왕,240434,225844,466278
201510,2015,경부선,군포,193883,178817,372700
201510,2015,경부선,금정,837659,827222,1664881
201510,2015,경부선,명학,314501,317229,631730
201510,2015,경부선,안양,854598,853708,1708306
201510,2015,경부선,관악,235682,215197,450879
201510,2015,경부선,석수,341980,305273,647253
201510,2015,경원선,녹천,122563,95051,217614
201510,2015,경원선,월계,155443,139892,295335
201510,2015,경원선,광운대,271988,249205,521193
201510,2015,2호선,교대,975571,1086740,2062311
201510,2015,경원선,석계,298181,322894,621075
201510,2015,경원선,신이문,240148,204470,444618
201510,2015,경원선,외대앞,341093,315194,656287
201510,2015,경원선,청량리(지상),343724,393932,737656
201510,2015,경원선,왕십리,459050,481173,940223
201510,2015,경원선,응봉,43530,36404,79934
201510,2015,2호선,사당,1181443,1355565,2537008
201510,2015,경원선,옥수,1480,1041,2521
201510,2015,경원선,한남,106950,106217,213167
201510,2015,경원선,서빙고,57461,55861,113322
201510,2015,경원선,이촌,132097,99413,231510
201510,2015,경인선,도화,88786,78105,166891
201510,2015,경인선,중동,262901,242907,505808
201510,2015,경인선,온수,197386,185200,382586
201510,2015,경인선,도원,95537,97409,192946
201510,2015,경인선,간석,171475,162978,334453
201510,2015,경인선,부개,285112,263678,548790
201510,2015,경인선,소사,344885,337832,682717
201510,2015,경부선,금천구청,295962,272494,568456
201510,2015,경부선,가산디지털단지,474779,565553,1040332
201510,2015,경부선,구로,600777,635395,1236172
201510,2015,경부선,신길,295158,235930,531088
201510,2015,경부선,신도림,103045,103143,206188
201510,2015,경부선,영등포,1319314,1420357,2739671
201510,2015,경부선,대방,435692,421444,857136
201510,2015,4호선,남태령,32016,20166,52182
201510,2015,경부선,노량진,1178695,1162070,2340765
201510,2015,경부선,용산,1062121,1069662,2131783
201510,2015,경부선,남영,323541,354168,677709
201510,2015,경부선,서울역,43,0,43
201510,2015,경인선,구일,163519,166765,330284
201510,2015,경인선,인천,96118,98630,194748
201510,2015,경인선,동인천,524723,477631,1002354
201510,2015,경인선,제물포,222033,202090,424123
201510,2015,경인선,주안,865069,861451,1726520
201510,2015,경인선,동암,687591,667300,1354891
201510,2015,경인선,백운,241246,237165,478411
201510,2015,경인선,부평,1098566,1232364,2330930
201510,2015,경인선,송내,1001492,976070,1977562
201510,2015,경인선,부천,1169579,1146918,2316497
201510,2015,경인선,역곡,859745,821104,1680849
201510,2015,경인선,오류동,297607,268345,565952
201510,2015,경인선,개봉,572354,562978,1135332
201510,2015,경부선,광명,23866,20179,44045
201510,2015,경부선,서동탄,44487,40282,84769
201510,2015,경부선,당정,221040,214181,435221
201510,2015,6호선,상수,296994,361952,658946
201510,2015,6호선,광흥창,231241,221326,452567
201510,2015,6호선,대흥,218658,232313,450971
201510,2015,6호선,공덕,482480,472400,954880
201510,2015,6호선,효창공원앞,204517,195817,400334
201510,2015,6호선,삼각지,237335,184200,421535
201510,2015,6호선,녹사평(용산구청),242007,264609,506616
201510,2015,6호선,이태원,505706,615053,1120759
201510,2015,6호선,한강진,182359,220819,403178
201510,2015,6호선,버티고개,66563,59176,125739
201510,2015,6호선,약수,88021,89240,177261
201510,2015,6호선,청구,96817,99194,196011
201510,2015,6호선,신당,218585,223021,441606
201510,2015,6호선,동묘앞,217587,218939,436526
201510,2015,6호선,창신,87442,73704,161146
201510,2015,6호선,보문,226725,194858,421583
201510,2015,6호선,안암,396920,406374,803294
201510,2015,6호선,고려대,292587,280881,573468
201510,2015,6호선,월곡,342522,314673,657195
201510,2015,6호선,상월곡,164917,150421,315338
201510,2015,6호선,돌곶이,239351,211951,451302
201510,2015,6호선,석계,341918,351124,693042
201510,2015,6호선,태릉입구,133657,167791,301448
201510,2015,6호선,화랑대,381143,275250,656393
201510,2015,6호선,봉화산(서울의료원),237672,219518,457190
201510,2015,7호선,장암,73798,26489,100287
201510,2015,4호선,사당,948665,740101,1688766
201510,2015,4호선,총신대입구,562009,632048,1194057
201510,2015,4호선,동작,73595,78989,152584
201510,2015,4호선,이촌,250615,295529,546144
201510,2015,4호선,신용산,359338,384731,744069
201510,2015,4호선,삼각지,123602,167363,290965
201510,2015,4호선,숙대입구,501222,495221,996443
201510,2015,4호선,서울역,317720,613182,930902
201510,2015,4호선,회현,699998,764962,1464960
201510,2015,4호선,명동,1199331,1307333,2506664
201510,2015,4호선,충무로,899309,930577,1829886
201510,2015,4호선,동대문역사문화공원,645581,596391,1241972
201510,2015,4호선,동대문,654415,664938,1319353
201510,2015,4호선,혜화,1242479,1305540,2548019
201510,2015,4호선,한성대입구,482589,460587,943176
201510,2015,4호선,성신여대입구,754352,677615,1431967
201510,2015,4호선,길음,763530,723712,1487242
201510,2015,4호선,미아사거리,863887,827649,1691536
201510,2015,4호선,미아,474215,421654,895869
201510,2015,4호선,수유(강북구청),1198612,1147618,2346230
201510,2015,4호선,쌍문,871386,727671,1599057
201510,2015,4호선,창동,742415,811669,1554084
201510,2015,4호선,노원,631094,718703,1349797
201510,2015,4호선,상계,559909,490389,1050298
201510,2015,4호선,당고개,325898,300171,626069
201510,2015,7호선,부평구청,350865,266637,617502
201510,2015,6호선,새절,355071,330461,685532
201510,2015,6호선,증산,256463,242282,498745
201510,2015,6호선,디지털미디어시티,408485,438516,847001
201510,2015,6호선,월드컵경기장,366027,394814,760841
201510,2015,6호선,마포구청,350553,295453,646006
201510,2015,6호선,망원,285694,298938,584632
201510,2015,6호선,합정,378266,361922,740188
201510,2015,3호선,오금,181273,159021,340294
201510,2015,3호선,경찰병원,185280,181327,366607
201510,2015,3호선,가락시장,203975,186755,390730
201510,2015,3호선,수서,288331,299854,588185
201510,2015,3호선,일원,219393,223490,442883
201510,2015,3호선,대청,272481,238713,511194
201510,2015,3호선,학여울,74377,76902,151279
201510,2015,3호선,대치,299214,279896,579110
201510,2015,3호선,도곡,194162,183420,377582
201510,2015,3호선,매봉,301412,289089,590501
201510,2015,3호선,양재,1131082,1216266,2347348
201510,2015,8호선,암사,445705,385566,831271
201510,2015,8호선,천호,504635,561409,1066044
201510,2015,8호선,강동구청,258912,265880,524792
201510,2015,8호선,몽촌토성,186636,198225,384861
201510,2015,8호선,잠실,303094,364999,668093
201510,2015,8호선,석촌,212900,225257,438157
201510,2015,8호선,송파,130799,132041,262840
201510,2015,8호선,가락시장,149352,182054,331406
201510,2015,8호선,문정,157799,149006,306805
201510,2015,8호선,장지,366741,355312,722053
201510,2015,8호선,복정,233582,170927,404509
201510,2015,8호선,산성,196016,187213,383229
201510,2015,8호선,남한산성입구,406168,373508,779676
201510,2015,8호선,단대오거리,344630,311412,656042
201510,2015,8호선,신흥,115774,119226,235000
201510,2015,8호선,수진,118517,105540,224057
201510,2015,8호선,모란,100684,79750,180434
201510,2015,9호선,개화,174875,104528,279403
201510,2015,9호선,김포공항,251272,310358,561630
201510,2015,9호선,공항시장,68447,76493,144940
201510,2015,9호선,신방화,197499,188094,385593
201510,2015,9호선,마곡나루,52700,48607,101307
201510,2015,9호선,양천향교,184552,180996,365548
201510,2015,9호선,가양,502272,482891,985163
201510,2015,9호선,증미,180171,182722,362893
201510,2015,9호선,등촌,251898,240156,492054
201510,2015,9호선,염창,423230,409680,832910
201510,2015,9호선,신목동,110509,95055,205564
201510,2015,9호선,선유도,176436,176095,352531
201510,2015,9호선,당산,459305,427433,886738
201510,2015,9호선,국회의사당,401514,406514,808028
201510,2015,9호선,여의도,526152,511335,1037487
201510,2015,9호선,샛강,141849,146644,288493
201510,2015,9호선,노량진,919089,974361,1893450
201510,2015,9호선,노들,129147,105995,235142
201510,2015,9호선,흑석(중앙대입구),293883,299975,593858
201510,2015,9호선,동작,54470,39517,93987
201510,2015,9호선,구반포,80530,85076,165606
201510,2015,3호선,남부터미널,992682,1025205,2017887
201510,2015,9호선,신반포,82223,80931,163154
201510,2015,9호선,고속터미널,454631,520296,974927
201510,2015,9호선,사평,71024,65390,136414
201510,2015,9호선,신논현,831048,829753,1660801
201510,2015,공항철도 1호선,서울역,285663,240546,526209
201510,2015,공항철도 1호선,공덕,36771,42263,79034
201510,2015,공항철도 1호선,홍대입구,229127,217745,446872
201510,2015,공항철도 1호선,디지털미디어시티,301911,261784,563695
201510,2015,공항철도 1호선,김포공항,272250,180460,452710
201510,2015,공항철도 1호선,계양,314401,285941,600342
201510,2015,공항철도 1호선,검암,500638,456728,957366
201510,2015,공항철도 1호선,청라국제도시,135193,126096,261289
201510,2015,공항철도 1호선,운서,155331,156435,311766
201510,2015,공항철도 1호선,공항화물청사,64626,69266,133892
201510,2015,공항철도 1호선,인천국제공항,337297,314700,651997
201510,2015,9호선2단계,언주,182044,180396,362440
201510,2015,9호선2단계,선정릉,154368,161721,316089
201510,2015,9호선2단계,삼성중앙,107057,111053,218110
201510,2015,9호선2단계,봉은사,280453,264531,544984
201510,2015,9호선2단계,종합운동장,133142,105330,238472
201510,2015,안산선,초지,150587,147627,298214
201510,2015,안산선,고잔,269194,266684,535878
201510,2015,안산선,중앙,514626,547265,1061891
201510,2015,안산선,한대앞,286115,275639,561754
201510,2015,안산선,상록수,619779,603265,1223044
201510,2015,안산선,반월,141306,128254,269560
201510,2015,안산선,대야미,107302,95554,202856
201510,2015,안산선,산본,481693,516716,998409
201510,2015,경원선,소요산,90526,75522,166048
201510,2015,경원선,동두천,51666,62627,114293
201510,2015,경원선,보산,50790,46486,97276
201510,2015,경원선,동두천 중앙,89493,83785,173278
201510,2015,경원선,지행,189678,186040,375718
201510,2015,경원선,덕정,206005,195929,401934
201510,2015,경원선,덕계,53846,49771,103617
201510,2015,경원선,양주,252798,219928,472726
201510,2015,경원선,녹양,131037,114573,245610
201510,2015,경원선,가능,187325,174217,361542
201510,2015,경원선,의정부,615560,649799,1265359
201510,2015,경원선,회룡,301254,277447,578701
201510,2015,경원선,망월사,228000,229956,457956
201510,2015,경원선,도봉산,100093,93046,193139
201510,2015,경원선,도봉,138050,128896,266946
201510,2015,경원선,방학,216757,204548,421305
201509,2015,5호선,을지로4가,99535,112294,211829
201509,2015,경부선,서울역,29,0,29
201509,2015,경부선,남영,304163,332632,636795
201509,2015,경부선,용산,995136,1006373,2001509
201509,2015,경부선,노량진,1077573,1061042,2138615
201509,2015,경부선,대방,386950,379183,766133
201509,2015,경부선,영등포,1213372,1311028,2524400
201509,2015,경부선,신도림,95118,90409,185527
201509,2015,경부선,신길,269895,215018,484913
201509,2015,경부선,구로,554259,589076,1143335
201509,2015,경부선,가산디지털단지,443782,523654,967436
201509,2015,경부선,금천구청,271694,250954,522648
201509,2015,경부선,석수,316923,283573,600496
201509,2015,경부선,관악,217163,197648,414811
201509,2015,경부선,안양,790751,793572,1584323
201509,2015,경부선,명학,288484,290377,578861
201509,2015,경부선,금정,781997,773066,1555063
201509,2015,경부선,군포,183888,168846,352734
201509,2015,경부선,의왕,227423,213151,440574
201509,2015,경부선,성균관대,472316,448204,920520
201509,2015,경부선,화서,223828,224063,447891
201509,2015,6호선,약수,80788,82228,163016
201509,2015,6호선,청구,88111,89767,177878
201509,2015,6호선,신당,185557,194112,379669
201509,2015,6호선,동묘앞,195749,198938,394687
201509,2015,6호선,창신,81063,67957,149020
201509,2015,6호선,보문,209766,181159,390925
201509,2015,6호선,안암,395009,402196,797205
201509,2015,6호선,고려대,267389,259840,527229
201509,2015,6호선,월곡,321165,295240,616405
201509,2015,6호선,상월곡,156069,143339,299408
201509,2015,6호선,돌곶이,222127,196601,418728
201509,2015,6호선,석계,319660,326755,646415
201509,2015,6호선,태릉입구,124216,156546,280762
201509,2015,6호선,화랑대,350997,254673,605670
201509,2015,6호선,봉화산(서울의료원),219816,202148,421964
201509,2015,7호선,장암,68820,24550,93370
201509,2015,7호선,도봉산,296672,276332,573004
201509,2015,7호선,수락산,324971,308755,633726
201509,2015,7호선,마들,275893,245337,521230
201509,2015,7호선,노원,489797,548300,1038097
201509,2015,7호선,중계,370939,331145,702084
201509,2015,7호선,하계,493102,460980,954082
201509,2015,7호선,공릉,314210,309316,623526
201509,2015,7호선,태릉입구,232022,221000,453022
201509,2015,7호선,먹골,244165,230242,474407
201509,2015,7호선,중화,285214,265206,550420
201509,2015,7호선,상봉,435780,407450,843230
201509,2015,7호선,면목,398412,377788,776200
201509,2015,7호선,사가정,386255,370701,756956
201509,2015,7호선,용마산,149184,137263,286447
201509,2015,7호선,중곡,240690,212303,452993
201509,2015,7호선,군자,345272,251938,597210
201509,2015,7호선,어린이대공원,462972,475002,937974
201509,2015,7호선,건대입구,434397,477998,912395
201509,2015,7호선,뚝섬유원지,268307,254768,523075
201509,2015,7호선,청담,517152,609132,1126284
201509,2015,7호선,강남구청,396106,440215,836321
201509,2015,7호선,학동,554916,627969,1182885
201509,2015,7호선,논현,503275,557955,1061230
201509,2015,7호선,반포,150014,142686,292700
201509,2015,7호선,고속터미널,558879,474902,1033781
201509,2015,7호선,내방,338709,349755,688464
201509,2015,7호선,이수,406071,408190,814261
201509,2015,7호선,남성,269865,242905,512770
201509,2015,7호선,숭실대입구,442414,430770,873184
201509,2015,7호선,상도,283919,275344,559263
201509,2015,7호선,장승배기,235569,224096,459665
201509,2015,7호선,신대방삼거리,371059,342376,713435
201509,2015,7호선,보라매,235548,236528,472076
201509,2015,7호선,신풍,278644,260637,539281
201509,2015,7호선,대림,287063,286910,573973
201509,2015,7호선,남구로,407617,422554,830171
201509,2015,7호선,가산디지털단지,1045001,1057688,2102689
201509,2015,7호선,철산,618875,622733,1241608
201509,2015,7호선,광명사거리,667588,635392,1302980
201509,2015,7호선,천왕,188306,170639,358945
201509,2015,7호선,온수,294097,278122,572219
201509,2015,7호선,까치울,158547,139048,297595
201509,2015,7호선,부천종합운동장,146083,132006,278089
201509,2015,7호선,춘의,201356,195521,396877
201509,2015,7호선,신중동,361414,363550,724964
201509,2015,7호선,부천시청,314859,323574,638433
201509,2015,7호선,상동,350696,365682,716378
201509,2015,7호선,삼산체육관,138837,125088,263925
201509,2015,7호선,굴포천,218905,224309,443214
201509,2015,7호선,부평구청,324989,250231,575220
201509,2015,8호선,암사,409384,350902,760286
201509,2015,8호선,천호,463588,513855,977443
201509,2015,8호선,강동구청,235316,240774,476090
201509,2015,8호선,몽촌토성,186738,207003,393741
201509,2015,8호선,잠실,270983,326625,597608
201509,2015,8호선,석촌,194379,204891,399270
201509,2015,8호선,송파,118598,119624,238222
201509,2015,8호선,가락시장,137561,168095,305656
201509,2015,8호선,문정,142374,133413,275787
201509,2015,8호선,장지,327725,318141,645866
201509,2015,8호선,복정,206857,148780,355637
201509,2015,8호선,산성,178509,169860,348369
201509,2015,8호선,남한산성입구,375030,345925,720955
201509,2015,8호선,단대오거리,319639,288468,608107
201509,2015,8호선,신흥,108823,110499,219322
201509,2015,8호선,수진,109232,96915,206147
201509,2015,8호선,모란,87291,69445,156736
201509,2015,9호선,개화,161757,95166,256923
201509,2015,9호선,김포공항,237859,290443,528302
201509,2015,9호선,공항시장,64224,71548,135772
201509,2015,9호선,신방화,181941,172511,354452
201509,2015,9호선,마곡나루,47853,43570,91423
201509,2015,9호선,양천향교,168528,166333,334861
201509,2015,안산선,중앙,471313,502148,973461
201509,2015,안산선,고잔,245853,242117,487970
201509,2015,안산선,초지,140074,137427,277501
201509,2015,안산선,안산,526316,480892,1007208
201509,2015,안산선,신길온천,46195,42022,88217
201509,2015,안산선,정왕,282149,295410,577559
201509,2015,안산선,오이도,216732,211538,428270
201509,2015,안산선,수리산,111709,85150,196859
201509,2015,과천선,선바위,227409,189524,416933
201509,2015,과천선,경마공원,136442,140454,276896
201509,2015,과천선,대공원,160424,165486,325910
201509,2015,과천선,과천,131289,109560,240849
201509,2015,과천선,정부과천청사,289037,286079,575116
201509,2015,과천선,인덕원,615791,612566,1228357
201509,2015,과천선,평촌,372493,363282,735775
201509,2015,과천선,범계,822108,828882,1650990
201509,2015,분당선,선릉,207922,433067,640989
201509,2015,분당선,한티,324380,342785,667165
201509,2015,분당선,도곡,139645,150175,289820
201509,2015,분당선,구룡,46670,43787,90457
201509,2015,분당선,개포동,92270,91943,184213
201509,2015,분당선,대모산입구,88080,78009,166089
201509,2015,분당선,수서,194663,199868,394531
201509,2015,분당선,복정,3,0,3
201509,2015,분당선,수원,261575,170940,432515
201509,2015,분당선,서울숲,156019,151502,307521
201509,2015,분당선,압구정로데오,359775,416570,776345
201509,2015,분당선,강남구청,200577,236921,437498
201509,2015,분당선,선정릉,172601,196092,368693
201509,2015,분당선,가천대,305034,349029,654063
201509,2015,분당선,태평,345146,322496,667642
201509,2015,분당선,모란,578503,530151,1108654
201509,2015,분당선,야탑,661406,700729,1362135
201509,2015,분당선,서현,618085,644172,1262257
201509,2015,분당선,수내,310097,314465,624562
201509,2015,분당선,정자,395740,434389,830129
201509,2015,분당선,미금,495498,522465,1017963
201509,2015,분당선,오리,366320,307266,673586
201509,2015,분당선,이매,121538,114635,236173
201509,2015,분당선,보정,61552,46476,108028
201509,2015,분당선,죽전,560972,607556,1168528
201509,2015,분당선,구성,122198,117938,240136
201509,2015,분당선,신갈,104462,99348,203810
201509,2015,분당선,기흥,217149,205211,422360
201509,2015,분당선,상갈,128843,122171,251014
201509,2015,분당선,청명,111835,103020,214855
201509,2015,분당선,영통,239368,245984,485352
201509,2015,분당선,망포,319436,289114,608550
201509,2015,분당선,매탄권선,114178,103844,218022
201509,2015,분당선,수원시청,260109,296298,556407
201509,2015,분당선,매교,63135,60945,124080
201509,2015,일산선,원흥,124075,104954,229029
201509,2015,일산선,지축,1,0,1
201509,2015,일산선,삼송,292939,271359,564298
201509,2015,일산선,원당,291069,269616,560685
201509,2015,일산선,화정,456916,475617,932533
201509,2015,일산선,대곡,34396,24501,58897
201509,2015,일산선,백석,244108,236884,480992
201509,2015,일산선,마두,172885,181405,354290
201509,2015,일산선,정발산,206439,226510,432949
201509,2015,일산선,주엽,185739,188671,374410
201509,2015,일산선,대화,354795,271376,626171
201509,2015,9호선,가양,464646,446081,910727
201509,2015,9호선,증미,166826,169854,336680
201509,2015,9호선,등촌,228823,220184,449007
201509,2015,9호선,염창,387683,375310,762993
201509,2015,중앙선,회기,779643,763545,1543188
201509,2015,중앙선,중랑,128483,118714,247197
201509,2015,중앙선,상봉,130937,128040,258977
201509,2015,중앙선,망우,175738,169615,345353
201509,2015,중앙선,양원,46193,49853,96046
201509,2015,중앙선,구리,327337,344916,672253
201509,2015,중앙선,도농,215942,185882,401824
201509,2015,중앙선,양정,18468,15458,33926
201509,2015,중앙선,덕소,146811,148088,294899
201509,2015,중앙선,도심,59238,46990,106228
201509,2015,중앙선,팔당,25102,25587,50689
201509,2015,중앙선,운길산,31606,28135,59741
201509,2015,중앙선,양수,47602,47191,94793
201509,2015,중앙선,신원,6271,4932,11203
201509,2015,중앙선,국수,20615,19270,39885
201509,2015,중앙선,아신,22679,22948,45627
201509,2015,중앙선,오빈,6731,6720,13451
201509,2015,중앙선,양평,88429,87960,176389
201509,2015,중앙선,원덕,7942,7073,15015
201509,2015,중앙선,용문,56597,55597,112194
201509,2015,장항선,봉명,31911,31185,63096
201509,2015,장항선,쌍용동,78907,73404,152311
201509,2015,장항선,아산,73404,63320,136724
201509,2015,장항선,배방,22213,20922,43135
201509,2015,장항선,온양온천,102839,103421,206260
201509,2015,장항선,신창,81314,80134,161448
201509,2015,경의선,서울역,83680,86988,170668
201509,2015,경의선,신촌,22394,28993,51387
201509,2015,경의선,공덕,41081,49873,90954
201509,2015,경의선,서강대,54845,56591,111436
201509,2015,경의선,홍대입구,37345,53261,90606
201509,2015,경의선,가좌,62543,58280,120823
201509,2015,경의선,디지털미디어시티,58876,54014,112890
201509,2015,경의선,수색,43155,46424,89579
201509,2015,경부선,수원,1315980,1405534,2721514
201509,2015,경부선,독산,392460,408201,800661
201509,2015,경부선,세류,114339,105924,220263
201509,2015,경부선,병점,448805,446920,895725
201509,2015,경부선,세마,65573,58742,124315
201509,2015,경부선,오산대,84351,85940,170291
201509,2015,경부선,오산,289192,271624,560816
201509,2015,경부선,진위,45019,39393,84412
201509,2015,경부선,송탄,128198,124173,252371
201509,2015,경부선,서정리,148435,145471,293906
201509,2015,경부선,지제,22622,22260,44882
201509,2015,경부선,평택,401581,400408,801989
201509,2015,경부선,성환,163538,159039,322577
201509,2015,경부선,직산,26617,30441,57058
201509,2015,경부선,두정,188911,215761,404672
201509,2015,경부선,천안,269877,224088,493965
201509,2015,경부선,당정,203915,199010,402925
201509,2015,경부선,서동탄,40485,36845,77330
201509,2015,경부선,광명,21905,18511,40416
201509,2015,경인선,개봉,525388,513300,1038688
201509,2015,경인선,오류동,273941,244834,518775
201509,2015,경인선,역곡,790918,756128,1547046
201509,2015,경인선,부천,1086912,1072863,2159775
201509,2015,경인선,송내,904562,876779,1781341
201509,2015,경인선,부평,1026052,1154189,2180241
201509,2015,경인선,백운,219246,210766,430012
201509,2015,경인선,동암,637881,610127,1248008
201509,2015,경인선,주안,795269,791603,1586872
201509,2015,경인선,제물포,204841,187114,391955
201509,2015,경인선,동인천,477439,436573,914012
201509,2015,경인선,인천,84765,86438,171203
201509,2015,경인선,구일,140136,137748,277884
201509,2015,경인선,소사,321734,317382,639116
201509,2015,경인선,부개,260371,237953,498324
201509,2015,경인선,간석,157436,147715,305151
201509,2015,경인선,도원,87531,90494,178025
201509,2015,경인선,온수,184111,171982,356093
201509,2015,경인선,중동,239421,220322,459743
201509,2015,경인선,도화,82575,72498,155073
201509,2015,경원선,이촌,113168,83065,196233
201509,2015,경원선,서빙고,50977,51094,102071
201509,2015,경원선,한남,97401,95870,193271
201509,2015,경원선,옥수,1523,1032,2555
201509,2015,경원선,응봉,40441,33683,74124
201509,2015,경원선,왕십리,435821,455460,891281
201509,2015,경원선,청량리(지상),317591,365547,683138
201509,2015,경원선,외대앞,324089,299973,624062
201509,2015,경원선,신이문,225829,192528,418357
201509,2015,경원선,석계,281721,302596,584317
201509,2015,경원선,광운대,261746,239901,501647
201509,2015,경원선,월계,146275,133087,279362
201509,2015,경원선,녹천,115831,90543,206374
201509,2015,경원선,창동,6,0,6
201509,2015,경원선,방학,202014,190933,392947
201509,2015,경원선,도봉,129194,120042,249236
201509,2015,경원선,도봉산,90245,83230,173475
201509,2015,경원선,망월사,208243,208981,417224
201509,2015,경원선,회룡,278728,258241,536969
201509,2015,경원선,의정부,575551,608784,1184335
201509,2015,경원선,가능,178242,164194,342436
201509,2015,경원선,녹양,122422,105832,228254
201509,2015,경원선,양주,239784,208926,448710
201509,2015,경원선,덕계,50631,47181,97812
201509,2015,경원선,덕정,195625,183974,379599
201509,2015,경원선,지행,178837,177680,356517
201509,2015,경원선,동두천 중앙,85629,81504,167133
201509,2015,경원선,보산,48608,45249,93857
201509,2015,경원선,동두천,49545,60305,109850
201509,2015,경원선,소요산,69461,53513,122974
201509,2015,안산선,산본,440696,473360,914056
201509,2015,안산선,대야미,101553,90720,192273
201509,2015,안산선,반월,132512,120277,252789
201509,2015,안산선,상록수,580955,566084,1147039
201509,2015,안산선,한대앞,264923,258596,523519
201509,2015,5호선,광나루,375302,332977,708279
201509,2015,5호선,천호,463601,502727,966328
201509,2015,5호선,강동,464119,383421,847540
201509,2015,5호선,길동,154633,160899,315532
201509,2015,5호선,굽은다리,218792,207465,426257
201509,2015,경의선,화전,81229,78030,159259
201509,2015,경의선,강매,55871,47266,103137
201509,2015,경의선,행신,180702,168658,349360
201509,2015,경의선,능곡,85566,75878,161444
201509,2015,경의선,곡산,11622,11313,22935
201509,2015,경의선,백마,166482,151199,317681
201509,2015,경의선,풍산,107064,99032,206096
201509,2015,경의선,일산,225634,216807,442441
201509,2015,경의선,탄현,203812,192877,396689
201509,2015,경의선,운정,138104,122587,260691
201509,2015,경의선,금릉,119043,115424,234467
201509,2015,경의선,금촌,176658,168363,345021
201509,2015,경의선,월롱,63024,71079,134103
201509,2015,경의선,파주,48585,35850,84435
201509,2015,경의선,문산,149840,147670,297510
201509,2015,경춘선,신내,13950,16775,30725
201509,2015,경춘선,갈매,7945,8723,16668
201509,2015,경춘선,별내,53775,51224,104999
201509,2015,경춘선,퇴계원,85025,74082,159107
201509,2015,경춘선,사릉,94027,87079,181106
201509,2015,경춘선,금곡,31930,30560,62490
201509,2015,경춘선,평내호평,133665,129952,263617
201509,2015,경춘선,천마산,24035,22563,46598
201509,2015,경춘선,마석,83027,88928,171955
201509,2015,경춘선,대성리,24243,24094,48337
201509,2015,경춘선,청평,54075,52186,106261
201509,2015,경춘선,상천,10893,9374,20267
201509,2015,경춘선,가평,64369,66577,130946
201509,2015,경춘선,굴봉산,5870,5714,11584
201509,2015,경춘선,백양리,3569,3196,6765
201509,2015,경춘선,강촌,26178,21324,47502
201509,2015,경춘선,김유정,13099,15988,29087
201509,2015,경춘선,남춘천,82195,86422,168617
201509,2015,경춘선,춘천,66294,59156,125450
201509,2015,수인선,달월,1664,1342,3006
201509,2015,수인선,월곶,61952,55619,117571
201509,2015,수인선,소래포구,118531,113724,232255
201509,2015,수인선,인천논현,123381,128270,251651
201509,2015,수인선,호구포,68668,70538,139206
201509,2015,수인선,남동인더스파크,47453,51816,99269
201509,2015,수인선,원인재,95669,102170,197839
201509,2015,수인선,연수,88625,83615,172240
201509,2015,수인선,송도,94817,96276,191093
201509,2015,5호선,방화,166484,157912,324396
201509,2015,5호선,개화산,136559,125092,261651
201509,2015,5호선,김포공항,187683,166657,354340
201509,2015,5호선,송정,243913,232793,476706
201509,2015,5호선,마곡,76152,60132,136284
201509,2015,5호선,발산,260309,258034,518343
201509,2015,5호선,우장산,392091,377697,769788
201509,2015,5호선,화곡,702275,637259,1339534
201509,2015,5호선,까치산,710707,656056,1366763
201509,2015,5호선,신정,364160,277414,641574
201509,2015,5호선,목동,464023,487627,951650
201509,2015,5호선,오목교,663487,720577,1384064
201509,2015,5호선,양평,143803,143287,287090
201509,2015,5호선,영등포구청,77363,78158,155521
201509,2015,5호선,영등포시장,150776,168647,319423
201509,2015,5호선,신길,76025,87425,163450
201509,2015,5호선,여의도,553070,632360,1185430
201509,2015,5호선,여의나루,304542,323917,628459
201509,2015,5호선,마포,351600,370642,722242
201509,2015,5호선,공덕,317640,341173,658813
201509,2015,5호선,애오개,153747,154676,308423
201509,2015,5호선,충정로,115996,122992,238988
201509,2015,5호선,서대문,418563,431702,850265
201509,2015,5호선,광화문,891696,955108,1846804
201509,2015,5호선,종로3가,254061,254895,508956
201509,2015,5호선,명일,181635,179061,360696
201509,2015,5호선,고덕,188106,185116,373222
201509,2015,5호선,상일동,262869,212149,475018
201509,2015,5호선,둔촌동,302189,295361,597550
201509,2015,5호선,올림픽공원,202727,210016,412743
201509,2015,5호선,방이,160124,161288,321412
201509,2015,5호선,오금,91803,92553,184356
201509,2015,5호선,개롱,157469,154955,312424
201509,2015,5호선,거여,159454,147869,307323
201509,2015,5호선,마천,121996,119249,241245
201509,2015,6호선,응암,407924,385796,793720
201509,2015,6호선,역촌,75387,95153,170540
201509,2015,6호선,불광,124469,126203,250672
201509,2015,6호선,독바위,64100,67669,131769
201509,2015,6호선,연신내,27,0,27
201509,2015,6호선,구산,184929,118070,302999
201509,2015,6호선,새절,329723,307030,636753
201509,2015,6호선,증산,238247,223935,462182
201509,2015,6호선,디지털미디어시티,376466,414916,791382
201509,2015,6호선,월드컵경기장,175572,195491,371063
201509,2015,6호선,마포구청,315644,269892,585536
201509,2015,5호선,동대문역사문화공원,68693,84146,152839
201509,2015,5호선,청구,92100,89378,181478
201509,2015,5호선,신금호,118508,116822,235330
201509,2015,5호선,행당,193237,164249,357486
201509,2015,5호선,왕십리(성동구청),117999,148603,266602
201509,2015,5호선,마장,141780,138192,279972
201509,2015,5호선,답십리,387004,347372,734376
201509,2015,5호선,장한평,428332,426088,854420
201509,2015,5호선,군자,265548,291154,556702
201509,2015,5호선,아차산,347635,325757,673392
201509,2015,9호선,신목동,102506,87909,190415
201509,2015,9호선,선유도,160627,161410,322037
201509,2015,9호선,당산,422292,394567,816859
201509,2015,9호선,국회의사당,347210,358804,706014
201509,2015,9호선,여의도,469650,456882,926532
201509,2015,9호선,샛강,119473,128816,248289
201509,2015,9호선,노량진,837477,885275,1722752
201509,2015,9호선,노들,113922,91681,205603
201509,2015,9호선,흑석(중앙대입구),284521,287061,571582
201509,2015,9호선,동작,52543,38633,91176
201509,2015,9호선,구반포,72801,77404,150205
201509,2015,9호선,신반포,73900,73200,147100
201509,2015,9호선,고속터미널,416142,475697,891839
201509,2015,9호선,사평,65550,59636,125186
201509,2015,9호선,신논현,769422,763082,1532504
201509,2015,공항철도 1호선,서울역,271455,227659,499114
201509,2015,공항철도 1호선,공덕,34142,39224,73366
201509,2015,공항철도 1호선,홍대입구,218156,199034,417190
201509,2015,공항철도 1호선,디지털미디어시티,282705,241229,523934
201509,2015,공항철도 1호선,김포공항,252271,169065,421336
201509,2015,공항철도 1호선,계양,288353,264652,553005
201509,2015,공항철도 1호선,검암,454857,414371,869228
201509,2015,공항철도 1호선,청라국제도시,122601,114304,236905
201509,2015,공항철도 1호선,운서,142365,144477,286842
201509,2015,공항철도 1호선,공항화물청사,59117,63094,122211
201509,2015,공항철도 1호선,인천국제공항,314697,302646,617343
201509,2015,9호선2단계,언주,160692,159116,319808
201509,2015,9호선2단계,선정릉,137422,143466,280888
201509,2015,9호선2단계,삼성중앙,96376,100232,196608
201509,2015,9호선2단계,봉은사,232359,218194,450553
201509,2015,9호선2단계,종합운동장,116996,94021,211017
201509,2015,6호선,망원,263436,276516,539952
201509,2015,1호선,서울역,1551005,1394245,2945250
201509,2015,1호선,시청,596008,598763,1194771
201509,2015,1호선,종각,1096919,1051591,2148510
201509,2015,1호선,종로3가,681715,633118,1314833
201509,2015,1호선,종로5가,502095,520277,1022372
201509,2015,1호선,동대문,341314,401036,742350
201509,2015,1호선,신설동,362680,353456,716136
201509,2015,1호선,제기동,268854,267216,536070
201509,2015,1호선,청량리(지하),553427,575512,1128939
201509,2015,1호선,동묘앞,156375,172742,329117
201509,2015,2호선,시청,638717,627569,1266286
201509,2015,2호선,을지로입구,1298526,1302678,2601204
201509,2015,2호선,을지로3가,468979,453281,922260
201509,2015,2호선,을지로4가,269088,268223,537311
201509,2015,2호선,동대문역사문화공원,451070,528861,979931
201509,2015,2호선,신당,325705,342223,667928
201509,2015,2호선,상왕십리,254878,236296,491174
201509,2015,2호선,왕십리(성동구청),535477,438082,973559
201509,2015,2호선,한양대,353848,424284,778132
201509,2015,2호선,뚝섬,371336,394270,765606
201509,2015,2호선,성수,585266,649633,1234899
201509,2015,2호선,건대입구,1197986,1318206,2516192
201509,2015,2호선,구의,569234,552084,1121318
201509,2015,2호선,강변,1366763,1362399,2729162
201509,2015,2호선,잠실나루,435462,415971,851433
201509,2015,2호선,잠실,2111101,1934210,4045311
201509,2015,2호선,신천,635599,622038,1257637
201509,2015,2호선,종합운동장,463531,523935,987466
201509,2015,2호선,삼성,1392551,1459858,2852409
201509,2015,2호선,선릉,1335392,1149606,2484998
201509,2015,2호선,역삼,1100472,1240890,2341362
201509,2015,2호선,강남,2559307,2621178,5180485
201509,2015,2호선,교대,903236,1006417,1909653
201509,2015,2호선,서초,567204,582237,1149441
201509,2015,2호선,방배,547044,558253,1105297
201509,2015,2호선,사당,1087150,1235983,2323133
201509,2015,2호선,낙성대,771550,735555,1507105
201509,2015,2호선,서울대입구,1335938,1308199,2644137
201509,2015,2호선,봉천,533083,475911,1008994
201509,2015,2호선,신림,1846460,1782994,3629454
201509,2015,2호선,신대방,662067,619334,1281401
201509,2015,2호선,구로디지털단지,1629699,1635677,3265376
201509,2015,2호선,대림,774134,808921,1583055
201509,2015,2호선,신도림,1638248,1637042,3275290
201509,2015,2호선,문래,462683,471140,933823
201509,2015,2호선,영등포구청,501866,505836,1007702
201509,2015,2호선,당산,582100,649687,1231787
201509,2015,2호선,합정,862152,892712,1754864
201509,2015,2호선,홍대입구,1900085,2057473,3957558
201509,2015,2호선,신촌,1304749,1343118,2647867
201509,2015,2호선,이대,583879,628839,1212718
201509,2015,2호선,아현,227971,214376,442347
201509,2015,2호선,충정로,268487,296151,564638
201509,2015,2호선,용답,58475,59695,118170
201509,2015,2호선,신답,29568,34028,63596
201509,2015,2호선,신설동,73919,71147,145066
201509,2015,2호선,도림천,21096,24388,45484
201509,2015,2호선,양천구청,163542,171992,335534
201509,2015,2호선,신정네거리,250857,246670,497527
201509,2015,2호선,용두,41455,43363,84818
201509,2015,3호선,지축,27061,27260,54321
201509,2015,3호선,구파발,425600,342635,768235
201509,2015,3호선,연신내,969794,899484,1869278
201509,2015,3호선,불광,420164,452148,872312
201509,2015,3호선,녹번,353609,295529,649138
201509,2015,3호선,홍제,451733,415571,867304
201509,2015,3호선,무악재,89781,86800,176581
201509,2015,3호선,독립문,157570,162684,320254
201509,2015,3호선,경복궁,621011,673296,1294307
201509,2015,3호선,안국,630327,693111,1323438
201509,2015,3호선,종로3가,170015,239687,409702
201509,2015,3호선,을지로3가,191981,230527,422508
201509,2015,3호선,충무로,36,0,36
201509,2015,3호선,동대입구,302047,348080,650127
201509,2015,3호선,약수,332575,315619,648194
201509,2015,3호선,금호,177453,158793,336246
201509,2015,3호선,옥수,241425,247829,489254
201509,2015,3호선,압구정,838434,938497,1776931
201509,2015,3호선,신사,786139,880614,1666753
201509,2015,3호선,잠원,130821,125985,256806
201509,2015,3호선,고속터미널,1405079,1498888,2903967
201509,2015,3호선,교대,333398,252376,585774
201509,2015,3호선,남부터미널,921166,964871,1886037
201509,2015,3호선,양재,1032089,1106228,2138317
201509,2015,3호선,매봉,277144,264697,541841
201509,2015,3호선,도곡,178131,166818,344949
201509,2015,3호선,대치,276515,257717,534232
201509,2015,3호선,학여울,61978,64548,126526
201509,2015,3호선,대청,253775,220395,474170
201509,2015,3호선,일원,205912,210451,416363
201509,2015,3호선,수서,268251,277154,545405
201509,2015,3호선,가락시장,189896,174599,364495
201509,2015,3호선,경찰병원,170109,167082,337191
201509,2015,3호선,오금,167748,146668,314416
201509,2015,4호선,당고개,304839,280272,585111
201509,2015,4호선,상계,524378,459688,984066
201509,2015,4호선,노원,590119,673259,1263378
201509,2015,4호선,창동,697114,762440,1459554
201509,2015,4호선,쌍문,810089,675203,1485292
201509,2015,4호선,수유(강북구청),1118790,1071862,2190652
201509,2015,4호선,미아,438663,389209,827872
201509,2015,4호선,미아사거리,799536,762486,1562022
201509,2015,4호선,길음,716979,680233,1397212
201509,2015,4호선,성신여대입구,707524,638764,1346288
201509,2015,4호선,한성대입구,441762,415422,857184
201509,2015,4호선,혜화,1089855,1155982,2245837
201509,2015,4호선,동대문,552383,572126,1124509
201509,2015,4호선,동대문역사문화공원,565037,525186,1090223
201509,2015,4호선,충무로,830272,865234,1695506
201509,2015,4호선,명동,1083834,1185765,2269599
201509,2015,4호선,회현,620591,679451,1300042
201509,2015,4호선,서울역,287570,543420,830990
201509,2015,4호선,숙대입구,467844,461630,929474
201509,2015,4호선,삼각지,111856,144975,256831
201509,2015,4호선,신용산,328844,353128,681972
201509,2015,4호선,이촌,209098,241907,451005
201509,2015,4호선,동작,64724,70293,135017
201509,2015,4호선,총신대입구,517003,579015,1096018
201509,2015,4호선,사당,869512,675334,1544846
201509,2015,6호선,합정,336818,320924,657742
201509,2015,6호선,상수,268051,325925,593976
201509,2015,6호선,광흥창,212802,203667,416469
201509,2015,6호선,대흥,200774,214742,415516
201509,2015,6호선,공덕,436493,429450,865943
201509,2015,6호선,효창공원앞,185451,178062,363513
201509,2015,6호선,삼각지,198302,156821,355123
201509,2015,6호선,녹사평(용산구청),199577,218486,418063
201509,2015,6호선,이태원,417671,486560,904231
201509,2015,6호선,한강진,165906,203732,369638
201509,2015,6호선,버티고개,61095,54089,115184
201509,2015,4호선,남태령,27617,18545,46162
201508,2015,4호선,상계,504374,441749,946123
201508,2015,경원선,녹양,115149,100131,215280
201508,2015,경원선,가능,167562,154480,322042
201508,2015,경원선,의정부,565924,600278,1166202
201508,2015,경원선,회룡,267598,248669,516267
201508,2015,경원선,망월사,163017,163130,326147
201508,2015,경원선,도봉산,85436,79588,165024
201508,2015,경원선,도봉,124569,116069,240638
201508,2015,경원선,방학,192639,182503,375142
201508,2015,경원선,창동,12,0,12
201508,2015,경원선,녹천,109771,86227,195998
201508,2015,경원선,월계,97268,87717,184985
201508,2015,경원선,광운대,207910,187090,395000
201508,2015,경원선,석계,259786,280693,540479
201508,2015,경원선,신이문,218323,186276,404599
201508,2015,경원선,외대앞,267890,243428,511318
201508,2015,경원선,청량리(지상),335270,374976,710246
201508,2015,경원선,왕십리,419405,454389,873794
201508,2015,경원선,응봉,37317,31171,68488
201508,2015,경원선,옥수,1416,1018,2434
201508,2015,경원선,한남,94932,94130,189062
201508,2015,경원선,서빙고,48962,49191,98153
201508,2015,경원선,이촌,110106,82316,192422
201508,2015,경인선,도화,78351,68606,146957
201508,2015,경인선,중동,232080,215328,447408
201508,2015,경인선,온수,161955,152834,314789
201508,2015,경인선,도원,77770,78239,156009
201508,2015,경인선,간석,153345,145978,299323
201508,2015,경인선,부개,251629,232631,484260
201508,2015,경인선,소사,296969,289423,586392
201508,2015,경인선,구일,123012,121189,244201
201508,2015,경인선,인천,111060,115675,226735
201508,2015,경인선,동인천,484473,442973,927446
201508,2015,경인선,제물포,176489,162645,339134
201508,2015,경인선,주안,731595,724964,1456559
201508,2015,경인선,동암,625049,605152,1230201
201508,2015,경인선,백운,207024,204064,411088
201508,2015,경인선,부평,1059126,1160020,2219146
201508,2015,경인선,송내,866679,834534,1701213
201508,2015,경인선,부천,1050982,1028495,2079477
201508,2015,경인선,역곡,704998,676045,1381043
201508,2015,경인선,오류동,263643,236475,500118
201508,2015,경인선,개봉,499819,491194,991013
201508,2015,경부선,광명,23254,17393,40647
201508,2015,경부선,서동탄,39194,35873,75067
201508,2015,경부선,당정,174189,168771,342960
201508,2015,경부선,천안,191668,177237,368905
201508,2015,경부선,두정,147029,156690,303719
201508,2015,경부선,직산,24928,26964,51892
201508,2015,경부선,성환,104447,104269,208716
201508,2015,경부선,평택,348870,345567,694437
201508,2015,경부선,지제,20929,20416,41345
201508,2015,경부선,서정리,113380,113235,226615
201508,2015,경부선,송탄,116819,114251,231070
201508,2015,경부선,진위,39456,35589,75045
201508,2015,경부선,오산,263060,254658,517718
201508,2015,경부선,오산대,64371,61719,126090
201508,2015,경부선,세마,61299,55085,116384
201508,2015,경부선,병점,361714,364467,726181
201508,2015,경부선,세류,104570,98320,202890
201508,2015,경부선,독산,371521,386759,758280
201508,2015,경부선,수원,1203289,1280705,2483994
201508,2015,경부선,화서,204230,200768,404998
201508,2015,경부선,성균관대,407939,389011,796950
201508,2015,경부선,의왕,205556,193840,399396
201508,2015,경부선,군포,173269,160427,333696
201508,2015,경부선,금정,740062,727803,1467865
201508,2015,경부선,명학,242536,242112,484648
201508,2015,경부선,안양,675515,671310,1346825
201508,2015,경부선,관악,206871,195412,402283
201508,2015,경부선,석수,285340,255423,540763
201508,2015,경부선,금천구청,252344,237160,489504
201508,2015,경부선,가산디지털단지,419401,496648,916049
201508,2015,경부선,구로,540639,568811,1109450
201508,2015,경부선,신길,261247,205064,466311
201508,2015,경부선,신도림,88085,81363,169448
201508,2015,경부선,영등포,1257927,1338478,2596405
201508,2015,경부선,대방,375506,369864,745370
201508,2015,경부선,노량진,1052417,1033514,2085931
201508,2015,경부선,용산,1030693,1054007,2084700
201508,2015,경부선,남영,261197,276505,537702
201508,2015,경부선,서울역,47,0,47
201508,2015,4호선,남태령,21394,17196,38590
201508,2015,4호선,사당,845566,640121,1485687
201508,2015,4호선,총신대입구,505545,564747,1070292
201508,2015,4호선,동작,53624,57956,111580
201508,2015,4호선,이촌,256501,285756,542257
201508,2015,4호선,신용산,325619,348871,674490
201508,2015,4호선,삼각지,107533,141849,249382
201508,2015,4호선,숙대입구,390071,383551,773622
201508,2015,4호선,서울역,272132,542040,814172
201508,2015,4호선,회현,592792,642781,1235573
201508,2015,4호선,명동,1027125,1131371,2158496
201508,2015,4호선,충무로,746974,790249,1537223
201508,2015,4호선,동대문역사문화공원,600036,550129,1150165
201508,2015,4호선,동대문,540882,545301,1086183
201508,2015,4호선,혜화,1114452,1191139,2305591
201508,2015,4호선,한성대입구,365716,341912,707628
201508,2015,4호선,성신여대입구,635639,579932,1215571
201508,2015,4호선,길음,631181,586243,1217424
201508,2015,4호선,미아사거리,779180,745395,1524575
201508,2015,4호선,미아,404101,354850,758951
201508,2015,7호선,하계,471201,440230,911431
201508,2015,7호선,중계,349872,310401,660273
201508,2015,7호선,노원,512403,564343,1076746
201508,2015,7호선,마들,263482,236328,499810
201508,2015,7호선,수락산,324439,315058,639497
201508,2015,7호선,도봉산,279198,256604,535802
201508,2015,7호선,장암,75162,34578,109740
201508,2015,6호선,봉화산(서울의료원),212807,196566,409373
201508,2015,6호선,화랑대,300213,220564,520777
201508,2015,6호선,태릉입구,114062,129748,243810
201508,2015,6호선,석계,294384,300373,594757
201508,2015,6호선,돌곶이,208766,185510,394276
201508,2015,6호선,상월곡,140358,124910,265268
201508,2015,6호선,월곡,280134,262486,542620
201508,2015,6호선,고려대,219823,209309,429132
201508,2015,6호선,안암,296997,303874,600871
201508,2015,6호선,보문,196711,170696,367407
201508,2015,6호선,창신,72706,57389,130095
201508,2015,6호선,동묘앞,186738,187211,373949
201508,2015,6호선,신당,174137,178750,352887
201508,2015,6호선,청구,83916,83913,167829
201508,2015,6호선,약수,78610,79981,158591
201508,2015,6호선,버티고개,55084,51462,106546
201508,2015,6호선,한강진,157650,190254,347904
201508,2015,6호선,이태원,451001,522893,973894
201508,2015,6호선,녹사평(용산구청),209247,228135,437382
201508,2015,6호선,삼각지,193142,148444,341586
201508,2015,6호선,효창공원앞,164830,154113,318943
201508,2015,6호선,공덕,421383,413973,835356
201508,2015,6호선,대흥,176017,184889,360906
201508,2015,6호선,광흥창,208942,199815,408757
201508,2015,6호선,상수,269343,324651,593994
201508,2015,6호선,합정,336011,321926,657937
201508,2015,6호선,망원,262807,277878,540685
201508,2015,6호선,마포구청,306092,263667,569759
201508,2015,6호선,월드컵경기장,162968,182777,345745
201508,2015,6호선,디지털미디어시티,353751,388417,742168
201508,2015,6호선,증산,226642,207888,434530
201508,2015,6호선,새절,295660,275601,571261
201508,2015,6호선,구산,176990,117913,294903
201508,2015,6호선,연신내,17,0,17
201508,2015,6호선,독바위,61474,64965,126439
201508,2015,6호선,불광,132849,127498,260347
201508,2015,6호선,역촌,75335,92829,168164
201508,2015,6호선,응암,393147,374552,767699
201508,2015,5호선,마천,116787,115309,232096
201508,2015,5호선,거여,154853,143922,298775
201508,2015,5호선,개롱,153183,151133,304316
201508,2015,5호선,오금,88906,89187,178093
201508,2015,5호선,방이,154130,156477,310607
201508,2015,5호선,올림픽공원,177477,176857,354334
201508,2015,5호선,둔촌동,289803,286562,576365
201508,2015,5호선,상일동,252828,207040,459868
201508,2015,5호선,고덕,181358,180353,361711
201508,2015,5호선,명일,177909,175425,353334
201508,2015,5호선,굽은다리,221869,213769,435638
201508,2015,5호선,길동,154812,162112,316924
201508,2015,5호선,강동,449066,372186,821252
201508,2015,5호선,천호,473113,504393,977506
201508,2015,5호선,광나루,351832,313803,665635
201508,2015,5호선,아차산,330919,309864,640783
201508,2015,5호선,군자,258665,287372,546037
201508,2015,5호선,장한평,422811,421737,844548
201508,2015,5호선,답십리,377266,338414,715680
201508,2015,5호선,마장,126481,118323,244804
201508,2015,5호선,왕십리(성동구청),118340,150180,268520
201508,2015,5호선,행당,188396,161298,349694
201508,2015,5호선,신금호,111927,109492,221419
201508,2015,5호선,청구,88501,87812,176313
201508,2015,5호선,동대문역사문화공원,70178,85295,155473
201508,2015,5호선,을지로4가,94700,107406,202106
201508,2015,5호선,종로3가,272059,273173,545232
201508,2015,5호선,광화문,944201,980602,1924803
201508,2015,5호선,서대문,390170,400127,790297
201508,2015,5호선,충정로,108390,109631,218021
201508,2015,5호선,애오개,150597,150707,301304
201508,2015,5호선,공덕,306970,328887,635857
201508,2015,5호선,마포,350271,372911,723182
201508,2015,5호선,여의나루,339814,365505,705319
201508,2015,5호선,여의도,551600,632476,1184076
201508,2015,5호선,신길,75192,85376,160568
201508,2015,5호선,영등포시장,152785,169213,321998
201508,2015,5호선,영등포구청,74588,74430,149018
201508,2015,5호선,양평,143026,142865,285891
201508,2015,5호선,오목교,666500,722567,1389067
201508,2015,5호선,목동,452149,475701,927850
201508,2015,5호선,신정,352621,273279,625900
201508,2015,5호선,까치산,697293,648266,1345559
201508,2015,5호선,화곡,691207,632046,1323253
201508,2015,5호선,우장산,375588,363428,739016
201508,2015,5호선,발산,249431,249847,499278
201508,2015,5호선,마곡,72351,58695,131046
201508,2015,5호선,송정,237439,228396,465835
201508,2015,5호선,김포공항,204660,180896,385556
201508,2015,5호선,개화산,134355,123176,257531
201508,2015,5호선,방화,163500,155277,318777
201508,2015,수인선,송도,82622,82635,165257
201508,2015,수인선,연수,86669,83439,170108
201508,2015,수인선,원인재,89691,94191,183882
201508,2015,수인선,남동인더스파크,46776,51045,97821
201508,2015,수인선,호구포,69138,71452,140590
201508,2015,수인선,인천논현,120999,125397,246396
201508,2015,수인선,소래포구,96791,89841,186632
201508,2015,수인선,월곶,58037,52619,110656
201508,2015,수인선,달월,1533,1258,2791
201508,2015,경춘선,춘천,64119,57310,121429
201508,2015,경춘선,남춘천,77675,84251,161926
201508,2015,경춘선,김유정,17234,19925,37159
201508,2015,경춘선,강촌,30145,24156,54301
201508,2015,경춘선,백양리,5479,4314,9793
201508,2015,경춘선,굴봉산,12003,10762,22765
201508,2015,경춘선,가평,116035,118893,234928
201508,2015,경춘선,상천,12589,9942,22531
201508,2015,경춘선,청평,92042,89910,181952
201508,2015,경춘선,대성리,38414,37429,75843
201508,2015,경춘선,마석,80261,86890,167151
201508,2015,경춘선,천마산,22036,21442,43478
201508,2015,경춘선,평내호평,129279,125706,254985
201508,2015,경춘선,금곡,29314,27684,56998
201508,2015,경춘선,사릉,84951,78884,163835
201508,2015,경춘선,퇴계원,79591,70846,150437
201508,2015,경춘선,별내,51425,50148,101573
201508,2015,경춘선,갈매,6982,7007,13989
201508,2015,경춘선,신내,13059,15246,28305
201508,2015,경의선,검암,2,0,2
201508,2015,4호선,수유(강북구청),1056432,1014092,2070524
201508,2015,4호선,쌍문,792418,660646,1453064
201508,2015,4호선,창동,675228,735549,1410777
201508,2015,4호선,노원,585086,668148,1253234
201508,2015,4호선,당고개,300838,280861,581699
201508,2015,3호선,오금,162631,143784,306415
201508,2015,3호선,경찰병원,168155,166798,334953
201508,2015,3호선,가락시장,185389,170848,356237
201508,2015,3호선,수서,259326,268202,527528
201508,2015,3호선,일원,195508,200196,395704
201508,2015,3호선,대청,245947,216982,462929
201508,2015,3호선,학여울,75673,78193,153866
201508,2015,3호선,대치,283416,263071,546487
201508,2015,3호선,도곡,167060,158179,325239
201508,2015,3호선,매봉,274605,264617,539222
201508,2015,3호선,양재,982851,1068226,2051077
201508,2015,3호선,남부터미널,944202,976432,1920634
201508,2015,3호선,교대,318238,239527,557765
201508,2015,3호선,고속터미널,1508283,1591264,3099547
201508,2015,3호선,잠원,126992,124576,251568
201508,2015,3호선,신사,817572,906902,1724474
201508,2015,3호선,압구정,883605,981056,1864661
201508,2015,3호선,옥수,235243,243132,478375
201508,2015,3호선,금호,173834,156018,329852
201508,2015,3호선,약수,326474,309085,635559
201508,2015,3호선,동대입구,246639,273735,520374
201508,2015,3호선,충무로,31,0,31
201508,2015,3호선,을지로3가,184921,219933,404854
201508,2015,3호선,종로3가,173494,247548,421042
201508,2015,3호선,안국,637981,700444,1338425
201508,2015,3호선,경복궁,597132,637798,1234930
201508,2015,3호선,독립문,175210,177302,352512
201508,2015,3호선,무악재,87167,83420,170587
201508,2015,3호선,홍제,426534,388713,815247
201508,2015,3호선,녹번,340176,282898,623074
201508,2015,3호선,불광,401992,443567,845559
201508,2015,3호선,연신내,953323,887563,1840886
201508,2015,3호선,구파발,414020,336945,750965
201508,2015,3호선,지축,27275,28411,55686
201508,2015,2호선,용두,41024,42872,83896
201508,2015,2호선,신정네거리,245618,242531,488149
201508,2015,2호선,양천구청,158298,166810,325108
201508,2015,2호선,도림천,21934,24189,46123
201508,2015,2호선,신설동,76757,73273,150030
201508,2015,2호선,신답,28153,32571,60724
201508,2015,2호선,용답,54348,53340,107688
201508,2015,2호선,충정로,259628,279449,539077
201508,2015,2호선,아현,208375,192211,400586
201508,2015,2호선,이대,490391,512292,1002683
201508,2015,2호선,신촌,1305569,1351502,2657071
201508,2015,2호선,홍대입구,2061285,2247705,4308990
201508,2015,2호선,합정,890591,911191,1801782
201508,2015,2호선,당산,553367,613742,1167109
201508,2015,2호선,영등포구청,487148,491867,979015
201508,2015,2호선,문래,455615,460921,916536
201508,2015,2호선,신도림,1630745,1633661,3264406
201508,2015,2호선,대림,755362,785398,1540760
201508,2015,2호선,구로디지털단지,1619507,1625584,3245091
201508,2015,2호선,신대방,650388,610479,1260867
201508,2015,2호선,신림,1870838,1815174,3686012
201508,2015,2호선,봉천,525935,475386,1001321
201508,2015,2호선,서울대입구,1304507,1288194,2592701
201508,2015,2호선,낙성대,770277,726358,1496635
201508,2015,2호선,사당,1068261,1217466,2285727
201508,2015,2호선,방배,484256,490322,974578
201508,2015,2호선,서초,555734,567188,1122922
201508,2015,2호선,교대,908144,999517,1907661
201508,2015,2호선,강남,2870951,2935195,5806146
201508,2015,2호선,역삼,1118716,1258410,2377126
201508,2015,2호선,선릉,1356808,1164502,2521310
201508,2015,2호선,삼성,1551599,1595246,3146845
201508,2015,2호선,종합운동장,483208,531533,1014741
201508,2015,2호선,신천,654760,648470,1303230
201508,2015,2호선,잠실,2275439,2085177,4360616
201508,2015,2호선,잠실나루,424158,404786,828944
201508,2015,2호선,강변,1424893,1431422,2856315
201508,2015,2호선,구의,563992,546850,1110842
201508,2015,2호선,건대입구,1205453,1346084,2551537
201508,2015,2호선,성수,567638,628651,1196289
201508,2015,2호선,뚝섬,355287,377081,732368
201508,2015,2호선,한양대,212041,237668,449709
201508,2015,2호선,왕십리(성동구청),493437,430382,923819
201508,2015,2호선,상왕십리,244662,226493,471155
201508,2015,2호선,신당,315197,332087,647284
201508,2015,2호선,동대문역사문화공원,465899,542744,1008643
201508,2015,2호선,을지로4가,259467,256858,516325
201508,2015,2호선,을지로3가,445355,432025,877380
201508,2015,2호선,을지로입구,1272154,1267305,2539459
201508,2015,2호선,시청,648469,632143,1280612
201508,2015,1호선,동묘앞,146080,160120,306200
201508,2015,1호선,청량리(지하),529522,557446,1086968
201508,2015,1호선,제기동,253773,250835,504608
201508,2015,1호선,신설동,343060,333316,676376
201508,2015,1호선,동대문,321487,386055,707542
201508,2015,1호선,종로5가,495065,509842,1004907
201508,2015,1호선,종로3가,735171,699930,1435101
201508,2015,1호선,종각,1157791,1110675,2268466
201508,2015,1호선,시청,605929,608009,1213938
201508,2015,1호선,서울역,1579775,1378184,2957959
201508,2015,9호선2단계,종합운동장,113730,90210,203940
201508,2015,9호선2단계,봉은사,214033,214692,428725
201508,2015,9호선2단계,삼성중앙,99130,101264,200394
201508,2015,9호선2단계,선정릉,132341,137549,269890
201508,2015,9호선2단계,언주,162506,158828,321334
201508,2015,공항철도 1호선,인천국제공항,388941,359364,748305
201508,2015,공항철도 1호선,공항화물청사,60792,64611,125403
201508,2015,공항철도 1호선,운서,151698,156330,308028
201508,2015,공항철도 1호선,청라국제도시,121454,114057,235511
201508,2015,공항철도 1호선,검암,447443,411772,859215
201508,2015,공항철도 1호선,계양,279841,258897,538738
201508,2015,공항철도 1호선,김포공항,264947,178629,443576
201508,2015,공항철도 1호선,디지털미디어시티,251195,220892,472087
201508,2015,공항철도 1호선,홍대입구,221765,201005,422770
201508,2015,공항철도 1호선,공덕,34558,39142,73700
201508,2015,공항철도 1호선,서울역,279022,240421,519443
201508,2015,9호선,신논현,806412,801886,1608298
201508,2015,9호선,사평,64032,59689,123721
201508,2015,9호선,고속터미널,438724,505287,944011
201508,2015,9호선,신반포,71947,72679,144626
201508,2015,9호선,구반포,72874,76336,149210
201508,2015,9호선,동작,44449,32366,76815
201508,2015,9호선,흑석(중앙대입구),222261,228103,450364
201508,2015,9호선,노들,114051,92127,206178
201508,2015,9호선,노량진,846424,887869,1734293
201508,2015,9호선,샛강,128470,135478,263948
201508,2015,9호선,여의도,475949,463935,939884
201508,2015,9호선,국회의사당,348259,355483,703742
201508,2015,9호선,당산,419344,386619,805963
201508,2015,9호선,선유도,158598,159394,317992
201508,2015,9호선,신목동,98328,84064,182392
201508,2015,9호선,염창,380169,366790,746959
201508,2015,9호선,등촌,229939,221945,451884
201508,2015,9호선,증미,167286,171811,339097
201508,2015,9호선,가양,459239,442065,901304
201508,2015,9호선,양천향교,164210,162062,326272
201508,2015,9호선,마곡나루,46681,42964,89645
201508,2015,9호선,신방화,172382,163894,336276
201508,2015,9호선,공항시장,66094,72423,138517
201508,2015,9호선,김포공항,260611,315724,576335
201508,2015,9호선,개화,149716,92461,242177
201508,2015,8호선,모란,85400,68673,154073
201508,2015,8호선,수진,110315,97487,207802
201508,2015,8호선,신흥,112752,115196,227948
201508,2015,8호선,단대오거리,293393,275401,568794
201508,2015,8호선,남한산성입구,328166,287252,615418
201508,2015,8호선,산성,175164,166869,342033
201508,2015,8호선,복정,180732,129035,309767
201508,2015,8호선,장지,326396,320294,646690
201508,2015,8호선,문정,137200,130072,267272
201508,2015,8호선,가락시장,133253,162567,295820
201508,2015,8호선,송파,114898,116172,231070
201508,2015,8호선,석촌,195363,207256,402619
201508,2015,8호선,잠실,282996,341656,624652
201508,2015,8호선,몽촌토성,159568,172198,331766
201508,2015,8호선,강동구청,231775,238002,469777
201508,2015,8호선,천호,459974,513318,973292
201508,2015,8호선,암사,400722,346935,747657
201508,2015,7호선,부평구청,309294,234586,543880
201508,2015,7호선,굴포천,214225,218659,432884
201508,2015,7호선,삼산체육관,145746,130617,276363
201508,2015,7호선,상동,353507,362798,716305
201508,2015,7호선,부천시청,315360,322089,637449
201508,2015,7호선,신중동,352117,351063,703180
201508,2015,7호선,춘의,196275,191160,387435
201508,2015,7호선,부천종합운동장,138278,124418,262696
201508,2015,7호선,까치울,148702,131668,280370
201508,2015,7호선,온수,267449,247663,515112
201508,2015,7호선,천왕,182265,164219,346484
201508,2015,7호선,광명사거리,649492,618082,1267574
201508,2015,7호선,철산,612214,614296,1226510
201508,2015,7호선,가산디지털단지,1016533,1027635,2044168
201508,2015,7호선,남구로,395774,408469,804243
201508,2015,7호선,대림,281532,280798,562330
201508,2015,7호선,신풍,271293,253471,524764
201508,2015,7호선,보라매,227427,228874,456301
201508,2015,7호선,신대방삼거리,361115,336054,697169
201508,2015,7호선,장승배기,232472,221931,454403
201508,2015,7호선,상도,252441,234061,486502
201508,2015,7호선,숭실대입구,334446,323614,658060
201508,2015,7호선,남성,258786,234380,493166
201508,2015,7호선,이수,408354,409126,817480
201508,2015,7호선,내방,325478,337778,663256
201508,2015,7호선,고속터미널,598640,478735,1077375
201508,2015,7호선,반포,147246,140648,287894
201508,2015,7호선,논현,499090,554331,1053421
201508,2015,7호선,학동,542521,613396,1155917
201508,2015,7호선,강남구청,393863,436986,830849
201508,2015,7호선,청담,516835,606338,1123173
201508,2015,7호선,뚝섬유원지,288659,275127,563786
201508,2015,7호선,건대입구,426522,469988,896510
201508,2015,7호선,어린이대공원,356806,350606,707412
201508,2015,7호선,군자,347562,256311,603873
201508,2015,7호선,중곡,229258,203713,432971
201508,2015,7호선,용마산,144036,131854,275890
201508,2015,7호선,사가정,380170,365690,745860
201508,2015,7호선,면목,352323,331369,683692
201508,2015,7호선,상봉,437401,407008,844409
201508,2015,7호선,중화,279742,259760,539502
201508,2015,7호선,먹골,239070,225572,464642
201508,2015,7호선,태릉입구,193566,181996,375562
201508,2015,7호선,공릉,278988,276220,555208
201508,2015,경의선,계양,6,0,6
201508,2015,경의선,김포공항,3,0,3
201508,2015,경의선,서울역,2,0,2
201508,2015,경의선,문산,145767,143075,288842
201508,2015,경의선,파주,29844,21116,50960
201508,2015,경의선,월롱,49543,55838,105381
201508,2015,경의선,금촌,169604,162839,332443
201508,2015,경의선,금릉,114773,110892,225665
201508,2015,경의선,운정,125390,113368,238758
201508,2015,경의선,탄현,191549,183639,375188
201508,2015,경의선,일산,205542,197434,402976
201508,2015,경의선,풍산,101794,94596,196390
201508,2015,경의선,백마,153153,139175,292328
201508,2015,경의선,곡산,10950,10907,21857
201508,2015,경의선,능곡,79508,72829,152337
201508,2015,경의선,행신,168947,158083,327030
201508,2015,경의선,강매,50557,43437,93994
201508,2015,경의선,화전,38745,36644,75389
201508,2015,경의선,수색,39526,42500,82026
201508,2015,경의선,디지털미디어시티,53554,48121,101675
201508,2015,경의선,가좌,56476,53099,109575
201508,2015,경의선,홍대입구,36410,54813,91223
201508,2015,경의선,서강대,50314,50181,100495
201508,2015,경의선,공덕,39274,47184,86458
201508,2015,경의선,신촌,19962,24896,44858
201508,2015,경의선,서울역,79510,80761,160271
201508,2015,장항선,신창,36263,37993,74256
201508,2015,장항선,온양온천,95158,95920,191078
201508,2015,장항선,배방,20178,19709,39887
201508,2015,장항선,아산,60317,54533,114850
201508,2015,장항선,쌍용동,52605,48749,101354
201508,2015,장항선,봉명,28941,28531,57472
201508,2015,중앙선,용문,72939,71175,144114
201508,2015,중앙선,원덕,7587,7007,14594
201508,2015,중앙선,양평,92663,91712,184375
201508,2015,중앙선,오빈,7613,7709,15322
201508,2015,중앙선,아신,22386,22218,44604
201508,2015,중앙선,국수,19012,17390,36402
201508,2015,중앙선,신원,5500,4227,9727
201508,2015,중앙선,양수,52739,52265,105004
201508,2015,중앙선,운길산,31478,29003,60481
201508,2015,중앙선,팔당,24912,24030,48942
201508,2015,중앙선,도심,56389,45527,101916
201508,2015,중앙선,덕소,141211,143683,284894
201508,2015,중앙선,양정,18252,15171,33423
201508,2015,중앙선,도농,207876,178267,386143
201508,2015,중앙선,구리,323943,340384,664327
201508,2015,중앙선,양원,41714,44506,86220
201508,2015,중앙선,망우,177363,167935,345298
201508,2015,중앙선,상봉,134478,134032,268510
201508,2015,중앙선,중랑,126303,117421,243724
201508,2015,중앙선,회기,682990,666258,1349248
201508,2015,일산선,대화,334703,260646,595349
201508,2015,일산선,주엽,192777,196477,389254
201508,2015,일산선,정발산,215877,236106,451983
201508,2015,일산선,마두,172068,179542,351610
201508,2015,일산선,백석,242254,236082,478336
201508,2015,일산선,대곡,31261,23190,54451
201508,2015,일산선,화정,456992,476111,933103
201508,2015,일산선,원당,277396,258322,535718
201508,2015,일산선,삼송,265243,250367,515610
201508,2015,일산선,원흥,115293,97414,212707
201508,2015,분당선,매교,58165,56333,114498
201508,2015,분당선,수원시청,261495,294336,555831
201508,2015,분당선,매탄권선,106065,98420,204485
201508,2015,분당선,망포,305884,279153,585037
201508,2015,분당선,영통,222712,229230,451942
201508,2015,분당선,청명,106783,98084,204867
201508,2015,분당선,상갈,122885,118377,241262
201508,2015,분당선,기흥,183224,174538,357762
201508,2015,분당선,신갈,106683,101034,207717
201508,2015,분당선,구성,114288,112939,227227
201508,2015,분당선,죽전,513923,572223,1086146
201508,2015,분당선,보정,59502,45234,104736
201508,2015,분당선,이매,127788,121755,249543
201508,2015,분당선,오리,365566,306865,672431
201508,2015,분당선,미금,509081,527264,1036345
201508,2015,분당선,정자,406241,442866,849107
201508,2015,분당선,수내,326834,325870,652704
201508,2015,분당선,서현,661061,683834,1344895
201508,2015,분당선,야탑,668307,699225,1367532
201508,2015,분당선,모란,563929,518588,1082517
201508,2015,분당선,태평,347050,325166,672216
201508,2015,분당선,가천대,169365,204956,374321
201508,2015,분당선,선정릉,171166,193015,364181
201508,2015,분당선,강남구청,195821,232330,428151
201508,2015,분당선,압구정로데오,376532,431738,808270
201508,2015,분당선,서울숲,143518,137516,281034
201508,2015,분당선,수원,240691,154780,395471
201508,2015,분당선,복정,1,0,1
201508,2015,분당선,수서,188682,191731,380413
201508,2015,분당선,대모산입구,83697,75259,158956
201508,2015,분당선,개포동,88588,88382,176970
201508,2015,분당선,구룡,39738,38402,78140
201508,2015,분당선,도곡,133132,141597,274729
201508,2015,분당선,한티,342554,357626,700180
201508,2015,분당선,선릉,211316,433194,644510
201508,2015,과천선,범계,812496,807834,1620330
201508,2015,과천선,평촌,362827,356738,719565
201508,2015,과천선,인덕원,584894,583212,1168106
201508,2015,과천선,정부과천청사,293202,289129,582331
201508,2015,과천선,과천,130006,109271,239277
201508,2015,과천선,대공원,159026,165657,324683
201508,2015,과천선,경마공원,201510,207526,409036
201508,2015,과천선,선바위,213117,181145,394262
201508,2015,안산선,수리산,105386,79313,184699
201508,2015,안산선,오이도,205415,199249,404664
201508,2015,안산선,정왕,224879,241805,466684
201508,2015,안산선,신길온천,43108,40108,83216
201508,2015,안산선,안산,506709,463353,970062
201508,2015,안산선,초지,115296,109182,224478
201508,2015,안산선,고잔,231506,228411,459917
201508,2015,안산선,중앙,450545,477575,928120
201508,2015,안산선,한대앞,229077,221926,451003
201508,2015,안산선,상록수,533175,520121,1053296
201508,2015,안산선,반월,127422,117090,244512
201508,2015,안산선,대야미,97770,88391,186161
201508,2015,안산선,산본,431928,465849,897777
201508,2015,경원선,소요산,72090,55166,127256
201508,2015,경원선,동두천,47848,58660,106508
201508,2015,경원선,보산,44483,41264,85747
201508,2015,경원선,동두천 중앙,82142,77088,159230
201508,2015,경원선,지행,165323,162005,327328
201508,2015,경원선,덕정,164752,156888,321640
201508,2015,경원선,덕계,48264,44002,92266
201508,2015,경원선,양주,224490,193493,417983
201507,2015,6호선,월곡,286741,267547,554288
201507,2015,6호선,고려대,234565,222297,456862
201507,2015,경인선,도화,83764,73035,156799
201507,2015,경원선,이촌,115268,86654,201922
201507,2015,경원선,서빙고,51784,52407,104191
201507,2015,경원선,한남,96576,96541,193117
201507,2015,경원선,옥수,1178,828,2006
201507,2015,경원선,응봉,39823,33444,73267
201507,2015,경원선,왕십리,428561,463357,891918
201507,2015,경원선,청량리(지상),312268,360997,673265
201507,2015,경원선,외대앞,283881,257195,541076
201507,2015,경원선,신이문,231073,196019,427092
201507,2015,경원선,석계,270179,293434,563613
201507,2015,경원선,광운대,222040,198409,420449
201507,2015,경원선,월계,102602,92705,195307
201507,2015,경원선,녹천,119001,93236,212237
201507,2015,경원선,창동,2,0,2
201507,2015,경원선,방학,204188,193261,397449
201507,2015,경원선,도봉,131272,123086,254358
201507,2015,경원선,도봉산,83971,76652,160623
201507,2015,경원선,망월사,169169,169653,338822
201507,2015,경원선,회룡,282203,260312,542515
201507,2015,경원선,의정부,567617,604386,1172003
201507,2015,경원선,가능,176109,163858,339967
201507,2015,경원선,녹양,121430,105343,226773
201507,2015,경원선,양주,230072,197033,427105
201507,2015,경원선,덕계,50534,45960,96494
201507,2015,경원선,덕정,161356,153202,314558
201507,2015,경원선,지행,169707,165086,334793
201507,2015,경원선,동두천 중앙,83422,78111,161533
201507,2015,경원선,보산,47859,44215,92074
201507,2015,경원선,동두천,48322,58763,107085
201507,2015,경원선,소요산,66392,49929,116321
201507,2015,안산선,산본,456852,490185,947037
201507,2015,안산선,대야미,103665,93920,197585
201507,2015,안산선,반월,135331,124320,259651
201507,2015,안산선,상록수,549574,533929,1083503
201507,2015,안산선,한대앞,244084,236118,480202
201507,2015,안산선,중앙,455313,484254,939567
201507,2015,안산선,고잔,243920,242313,486233
201507,2015,안산선,초지,110756,104509,215265
201507,2015,안산선,안산,505692,458289,963981
201507,2015,안산선,신길온천,45286,42937,88223
201507,2015,안산선,정왕,231311,250870,482181
201507,2015,안산선,오이도,201443,199196,400639
201507,2015,안산선,수리산,113902,86076,199978
201507,2015,과천선,선바위,230220,193211,423431
201507,2015,과천선,경마공원,184663,189518,374181
201507,2015,과천선,대공원,114672,121922,236594
201507,2015,과천선,과천,135444,114527,249971
201507,2015,과천선,정부과천청사,308855,303882,612737
201507,2015,과천선,인덕원,623921,618574,1242495
201507,2015,과천선,평촌,391468,385381,776849
201507,2015,과천선,범계,852107,847773,1699880
201507,2015,분당선,선릉,240139,495560,735699
201507,2015,분당선,한티,372597,389873,762470
201507,2015,분당선,도곡,144839,152761,297600
201507,2015,분당선,구룡,43484,42180,85664
201507,2015,경부선,석수,301783,267797,569580
201507,2015,경부선,관악,212999,195545,408544
201507,2015,경부선,안양,683939,676151,1360090
201507,2015,경부선,명학,262220,263678,525898
201507,2015,경부선,금정,786745,772363,1559108
201507,2015,경부선,군포,186563,173166,359729
201507,2015,경부선,의왕,222633,209316,431949
201507,2015,경부선,성균관대,424114,400984,825098
201507,2015,경부선,화서,215485,211407,426892
201507,2015,경부선,수원,1116853,1208322,2325175
201507,2015,경부선,독산,402987,422247,825234
201507,2015,경부선,세류,106947,99645,206592
201507,2015,경부선,병점,366601,365564,732165
201507,2015,경부선,세마,63344,56467,119811
201507,2015,경부선,오산대,59802,55150,114952
201507,2015,경부선,오산,256722,248227,504949
201507,2015,경부선,진위,40978,37560,78538
201507,2015,경부선,송탄,115301,112364,227665
201507,2015,경부선,서정리,110635,111011,221646
201507,2015,경부선,지제,21859,21210,43069
201507,2015,경부선,평택,323806,320721,644527
201507,2015,분당선,개포동,95410,95451,190861
201507,2015,분당선,대모산입구,92218,82042,174260
201507,2015,분당선,수서,202441,206905,409346
201507,2015,분당선,복정,4,0,4
201507,2015,분당선,수원,244101,158760,402861
201507,2015,분당선,서울숲,153065,146793,299858
201507,2015,분당선,압구정로데오,392855,457579,850434
201507,2015,분당선,강남구청,213201,254941,468142
201507,2015,분당선,선정릉,189859,218548,408407
201507,2015,분당선,가천대,182828,215595,398423
201507,2015,6호선,안암,317937,322893,640830
201507,2015,7호선,노원,533401,589821,1123222
201507,2015,7호선,마들,280839,250599,531438
201507,2015,7호선,수락산,334263,322803,657066
201507,2015,7호선,도봉산,285315,256902,542217
201507,2015,7호선,장암,73293,28419,101712
201507,2015,6호선,봉화산(서울의료원),228905,209471,438376
201507,2015,6호선,화랑대,322024,232910,554934
201507,2015,6호선,태릉입구,120591,135265,255856
201507,2015,7호선,중계,373843,329582,703425
201507,2015,6호선,석계,314756,319207,633963
201507,2015,6호선,돌곶이,225477,198591,424068
201507,2015,6호선,보문,209523,181652,391175
201507,2015,6호선,창신,78947,62604,141551
201507,2015,6호선,동묘앞,196341,198282,394623
201507,2015,6호선,신당,207241,216770,424011
201507,2015,6호선,청구,90208,91582,181790
201507,2015,6호선,약수,83149,85836,168985
201507,2015,6호선,버티고개,59937,55825,115762
201507,2015,6호선,한강진,153272,188186,341458
201507,2015,6호선,이태원,412896,478067,890963
201507,2015,6호선,녹사평(용산구청),197691,218016,415707
201507,2015,6호선,삼각지,197833,157395,355228
201507,2015,6호선,효창공원앞,184308,174589,358897
201507,2015,6호선,공덕,461452,454599,916051
201507,2015,6호선,대흥,195604,207256,402860
201507,2015,6호선,광흥창,226674,217129,443803
201507,2015,6호선,상수,269625,325362,594987
201507,2015,6호선,합정,344994,336355,681349
201507,2015,6호선,망원,273974,289355,563329
201507,2015,6호선,마포구청,328006,281378,609384
201507,2015,6호선,월드컵경기장,147543,164275,311818
201507,2015,6호선,디지털미디어시티,383767,423860,807627
201507,2015,6호선,증산,243477,221812,465289
201507,2015,6호선,새절,310808,283719,594527
201507,2015,6호선,구산,191683,124987,316670
201507,2015,6호선,연신내,21,0,21
201507,2015,6호선,독바위,64618,67020,131638
201507,2015,6호선,불광,137016,133721,270737
201507,2015,6호선,역촌,78249,95991,174240
201507,2015,6호선,응암,417956,396330,814286
201507,2015,5호선,마천,124014,121673,245687
201507,2015,5호선,거여,166502,153817,320319
201507,2015,5호선,개롱,163127,160597,323724
201507,2015,5호선,오금,97268,97911,195179
201507,2015,5호선,방이,164732,168232,332964
201507,2015,5호선,올림픽공원,154528,148564,303092
201507,2015,5호선,둔촌동,309177,305424,614601
201507,2015,5호선,상일동,274702,221408,496110
201507,2015,5호선,고덕,186262,182173,368435
201507,2015,5호선,명일,188884,184757,373641
201507,2015,5호선,굽은다리,231131,220210,451341
201507,2015,5호선,길동,164749,172465,337214
201507,2015,5호선,강동,466981,383167,850148
201507,2015,5호선,천호,484466,520755,1005221
201507,2015,5호선,광나루,367929,327426,695355
201507,2015,5호선,개화산,142387,129763,272150
201507,2015,5호선,김포공항,196928,176425,373353
201507,2015,5호선,송정,248072,236303,484375
201507,2015,5호선,마곡,76972,61610,138582
201507,2015,5호선,발산,258980,261582,520562
201507,2015,5호선,우장산,403342,382789,786131
201507,2015,5호선,화곡,731769,665050,1396819
201507,2015,5호선,까치산,739010,681365,1420375
201507,2015,5호선,신정,382506,290607,673113
201507,2015,5호선,목동,482837,507217,990054
201507,2015,5호선,오목교,695737,755607,1451344
201507,2015,5호선,양평,154207,156057,310264
201507,2015,5호선,영등포구청,82198,82752,164950
201507,2015,5호선,영등포시장,162735,181085,343820
201507,2015,5호선,신길,78614,90390,169004
201507,2015,5호선,여의도,606640,694750,1301390
201507,2015,5호선,여의나루,274823,296742,571565
201507,2015,5호선,마포,370462,394464,764926
201507,2015,5호선,공덕,343451,369458,712909
201507,2015,5호선,애오개,164151,164643,328794
201507,2015,7호선,하계,499070,464666,963736
201507,2015,7호선,공릉,301874,295330,597204
201507,2015,7호선,태릉입구,202010,190623,392633
201507,2015,7호선,먹골,251658,236652,488310
201507,2015,7호선,중화,294203,273685,567888
201507,2015,7호선,상봉,458329,425295,883624
201507,2015,7호선,면목,369877,346403,716280
201507,2015,7호선,사가정,401164,385942,787106
201507,2015,7호선,용마산,154016,139838,293854
201507,2015,7호선,중곡,246465,218347,464812
201507,2015,7호선,군자,366149,268805,634954
201507,2015,7호선,어린이대공원,359101,350938,710039
201507,2015,7호선,건대입구,414095,459546,873641
201507,2015,7호선,뚝섬유원지,256268,242940,499208
201507,2015,7호선,청담,559248,664157,1223405
201507,2015,7호선,강남구청,425904,475795,901699
201507,2015,7호선,학동,608420,692224,1300644
201507,2015,7호선,논현,547554,609066,1156620
201507,2015,7호선,반포,155058,148937,303995
201507,2015,7호선,고속터미널,558609,471553,1030162
201507,2015,7호선,내방,356076,369586,725662
201507,2015,7호선,이수,435808,436269,872077
201507,2015,5호선,청구,95692,94166,189858
201507,2015,5호선,신금호,124536,121718,246254
201507,2015,5호선,행당,203576,173486,377062
201507,2015,5호선,왕십리(성동구청),125931,159221,285152
201507,2015,5호선,마장,135625,127079,262704
201507,2015,5호선,답십리,407134,363300,770434
201507,2015,5호선,장한평,456825,457328,914153
201507,2015,5호선,군자,276912,304843,581755
201507,2015,경인선,인천,84718,86950,171668
201507,2015,경인선,동인천,496452,452934,949386
201507,2015,경인선,제물포,183168,168270,351438
201507,2015,경인선,주안,761051,754433,1515484
201507,2015,경인선,동암,649442,629539,1278981
201507,2015,경인선,백운,219128,216418,435546
201507,2015,경인선,부평,1085162,1189681,2274843
201507,2015,경인선,송내,916671,883780,1800451
201507,2015,경인선,부천,1080775,1055988,2136763
201507,2015,경인선,역곡,742503,706262,1448765
201507,2015,경인선,오류동,275681,247441,523122
201507,2015,경인선,개봉,525245,515722,1040967
201507,2015,경부선,광명,22683,19960,42643
201507,2015,경부선,서동탄,39850,36297,76147
201507,2015,경부선,당정,183456,177780,361236
201507,2015,경부선,천안,167158,163094,330252
201507,2015,경부선,두정,142779,144677,287456
201507,2015,경부선,직산,24924,26803,51727
201507,2015,경부선,성환,84651,83646,168297
201507,2015,경부선,금천구청,267169,248019,515188
201507,2015,경부선,가산디지털단지,472875,553369,1026244
201507,2015,경부선,구로,568884,599957,1168841
201507,2015,경부선,신길,279041,217359,496400
201507,2015,경부선,신도림,93435,83197,176632
201507,2015,경부선,영등포,1250197,1341070,2591267
201507,2015,경부선,대방,396511,392391,788902
201507,2015,경부선,노량진,1072349,1047472,2119821
201507,2015,경부선,용산,953634,979898,1933532
201507,2015,경부선,남영,283186,299627,582813
201507,2015,경부선,서울역,37,0,37
201507,2015,4호선,남태령,22174,18527,40701
201507,2015,4호선,사당,889429,677595,1567024
201507,2015,4호선,총신대입구,542364,606664,1149028
201507,2015,4호선,동작,55813,59743,115556
201507,2015,4호선,이촌,236442,267280,503722
201507,2015,4호선,신용산,343277,370882,714159
201507,2015,4호선,삼각지,117095,150218,267313
201507,2015,4호선,숙대입구,420098,415103,835201
201507,2015,4호선,서울역,282835,513913,796748
201507,2015,4호선,회현,623089,685962,1309051
201507,2015,4호선,명동,909260,1006197,1915457
201507,2015,4호선,충무로,789196,837526,1626722
201507,2015,4호선,동대문역사문화공원,568227,534290,1102517
201507,2015,4호선,동대문,578704,598387,1177091
201507,2015,4호선,혜화,1078805,1146924,2225729
201507,2015,4호선,한성대입구,387056,361676,748732
201507,2015,4호선,성신여대입구,656491,598826,1255317
201507,2015,4호선,길음,666907,612116,1279023
201507,2015,4호선,미아사거리,810958,777625,1588583
201507,2015,4호선,미아,433768,378420,812188
201507,2015,2호선,충정로,280645,304158,584803
201507,2015,2호선,용답,56971,55344,112315
201507,2015,2호선,신답,32059,36161,68220
201507,2015,2호선,신설동,80767,78970,159737
201507,2015,2호선,도림천,22807,25569,48376
201507,2015,2호선,양천구청,169984,178298,348282
201507,2015,2호선,신정네거리,259548,256945,516493
201507,2015,2호선,용두,43207,45744,88951
201507,2015,3호선,지축,29451,30027,59478
201507,2015,3호선,구파발,432696,345178,777874
201507,2015,3호선,연신내,998489,926677,1925166
201507,2015,3호선,불광,421465,456455,877920
201507,2015,3호선,녹번,357922,296557,654479
201507,2015,3호선,홍제,452531,407168,859699
201507,2015,3호선,무악재,92516,87801,180317
201507,2015,3호선,독립문,156772,158081,314853
201507,2015,3호선,경복궁,571246,611762,1183008
201507,2015,3호선,안국,626323,687188,1313511
201507,2015,3호선,종로3가,188644,259675,448319
201507,2015,3호선,을지로3가,201207,242173,443380
201507,2015,3호선,충무로,34,0,34
201507,2015,3호선,동대입구,249875,276541,526416
201507,2015,3호선,약수,349754,331021,680775
201507,2015,3호선,금호,184568,165231,349799
201507,2015,4호선,수유(강북구청),1107465,1059447,2166912
201507,2015,3호선,옥수,253013,261279,514292
201507,2015,3호선,압구정,952468,1060129,2012597
201507,2015,3호선,신사,848799,943866,1792665
201507,2015,3호선,잠원,137062,131892,268954
201507,2015,3호선,고속터미널,1441305,1531032,2972337
201507,2015,3호선,교대,357134,268498,625632
201507,2015,3호선,남부터미널,942317,981101,1923418
201507,2015,3호선,양재,1074895,1174344,2249239
201507,2015,3호선,매봉,302016,293277,595293
201507,2015,3호선,도곡,180710,169980,350690
201507,2015,3호선,대치,297313,277516,574829
201507,2015,3호선,학여울,81178,84523,165701
201507,2015,3호선,대청,256845,234676,491521
201507,2015,3호선,일원,170428,158125,328553
201507,2015,3호선,수서,283354,291753,575107
201507,2015,3호선,가락시장,202530,183684,386214
201507,2015,3호선,경찰병원,181492,179038,360530
201507,2015,3호선,오금,176330,153721,330051
201507,2015,4호선,당고개,306134,283556,589690
201507,2015,4호선,상계,537825,466550,1004375
201507,2015,4호선,노원,606758,696356,1303114
201507,2015,4호선,창동,714888,779701,1494589
201507,2015,4호선,쌍문,842425,700261,1542686
201507,2015,7호선,남성,276652,246933,523585
201507,2015,7호선,숭실대입구,366346,351152,717498
201507,2015,7호선,상도,269308,248683,517991
201507,2015,7호선,장승배기,246814,233346,480160
201507,2015,7호선,신대방삼거리,385168,357777,742945
201507,2015,7호선,보라매,244325,247569,491894
201507,2015,7호선,신풍,284099,265674,549773
201507,2015,7호선,대림,266166,264872,531038
201507,2015,7호선,남구로,420993,440630,861623
201507,2015,7호선,가산디지털단지,1145229,1172556,2317785
201507,2015,7호선,철산,647654,649525,1297179
201507,2015,7호선,광명사거리,687883,650145,1338028
201507,2015,7호선,천왕,198337,177776,376113
201507,2015,7호선,온수,288473,263564,552037
201507,2015,7호선,까치울,156568,137118,293686
201507,2015,7호선,부천종합운동장,145293,131262,276555
201507,2015,7호선,춘의,207169,201593,408762
201507,2015,7호선,신중동,375531,373206,748737
201507,2015,7호선,부천시청,333503,341203,674706
201507,2015,7호선,상동,368050,381022,749072
201507,2015,7호선,삼산체육관,144568,128723,273291
201507,2015,7호선,굴포천,225020,229779,454799
201507,2015,7호선,부평구청,330912,248071,578983
201507,2015,8호선,암사,426337,366110,792447
201507,2015,8호선,천호,484966,539447,1024413
201507,2015,8호선,강동구청,250666,259483,510149
201507,2015,8호선,몽촌토성,162485,179373,341858
201507,2015,8호선,잠실,276584,344416,621000
201507,2015,8호선,석촌,212064,224414,436478
201507,2015,8호선,송파,127447,128428,255875
201507,2015,8호선,가락시장,144669,177530,322199
201507,2015,8호선,문정,148600,140971,289571
201507,2015,8호선,장지,335299,326663,661962
201507,2015,8호선,복정,187336,133193,320529
201507,2015,8호선,산성,179521,170777,350298
201507,2015,8호선,남한산성입구,352103,305482,657585
201507,2015,8호선,단대오거리,310255,290258,600513
201507,2015,8호선,신흥,117154,120459,237613
201507,2015,8호선,수진,118474,105118,223592
201507,2015,8호선,모란,90140,70883,161023
201507,2015,9호선,개화,161096,97133,258229
201507,2015,9호선,김포공항,249759,304962,554721
201507,2015,9호선,공항시장,68904,75307,144211
201507,2015,9호선,신방화,182932,174821,357753
201507,2015,9호선,마곡나루,49492,45248,94740
201507,2015,9호선,양천향교,172160,169888,342048
201507,2015,9호선,가양,489993,470376,960369
201507,2015,9호선,증미,182025,186775,368800
201507,2015,5호선,아차산,340733,317982,658715
201507,2015,1호선,서울역,1516950,1353937,2870887
201507,2015,1호선,시청,596984,610354,1207338
201507,2015,1호선,종각,1211949,1187589,2399538
201507,2015,1호선,종로3가,770449,742344,1512793
201507,2015,1호선,종로5가,510403,531880,1042283
201507,2015,1호선,동대문,321376,369573,690949
201507,2015,1호선,신설동,364157,357387,721544
201507,2015,1호선,제기동,271001,267140,538141
201507,2015,1호선,청량리(지하),537188,560114,1097302
201507,2015,1호선,동묘앞,145254,159145,304399
201507,2015,2호선,시청,668226,667665,1335891
201507,2015,2호선,을지로입구,1295764,1318732,2614496
201507,2015,2호선,을지로3가,478235,472913,951148
201507,2015,2호선,을지로4가,271670,277293,548963
201507,2015,2호선,동대문역사문화공원,450730,522621,973351
201507,2015,2호선,신당,335015,354375,689390
201507,2015,2호선,상왕십리,260255,243468,503723
201507,2015,2호선,왕십리(성동구청),524103,450839,974942
201507,2015,2호선,한양대,244908,274849,519757
201507,2015,2호선,뚝섬,381479,405849,787328
201507,2015,2호선,성수,636765,708103,1344868
201507,2015,2호선,건대입구,1221890,1356167,2578057
201507,2015,2호선,구의,606676,589112,1195788
201507,2015,2호선,강변,1375082,1387900,2762982
201507,2015,2호선,잠실나루,447361,423056,870417
201507,2015,2호선,잠실,2289553,2103444,4392997
201507,2015,2호선,신천,688626,676849,1365475
201507,2015,2호선,종합운동장,469256,514709,983965
201507,2015,2호선,삼성,1656196,1717944,3374140
201507,2015,2호선,선릉,1520616,1314260,2834876
201507,2015,2호선,역삼,1241706,1403541,2645247
201507,2015,2호선,강남,3129660,3196576,6326236
201507,2015,2호선,교대,994427,1100759,2095186
201507,2015,2호선,서초,601581,619938,1221519
201507,2015,2호선,방배,510603,517226,1027829
201507,2015,2호선,사당,1144593,1296492,2441085
201507,2015,2호선,낙성대,819428,773221,1592649
201507,2015,2호선,서울대입구,1397509,1368148,2765657
201507,2015,2호선,봉천,560818,503402,1064220
201507,2015,2호선,신림,1962115,1897460,3859575
201507,2015,2호선,신대방,678070,635782,1313852
201507,2015,2호선,구로디지털단지,1751699,1759693,3511392
201507,2015,2호선,대림,779506,807780,1587286
201507,2015,2호선,신도림,1671459,1674131,3345590
201507,2015,2호선,문래,498245,505401,1003646
201507,2015,2호선,영등포구청,537168,541089,1078257
201507,2015,2호선,당산,601742,665995,1267737
201507,2015,2호선,합정,922764,944672,1867436
201507,2015,2호선,홍대입구,1974537,2152124,4126661
201507,2015,2호선,신촌,1337052,1392450,2729502
201507,2015,2호선,이대,495070,510341,1005411
201507,2015,2호선,아현,224571,208874,433445
201507,2015,9호선,등촌,253214,242602,495816
201507,2015,9호선,염창,398634,387932,786566
201507,2015,9호선,신목동,106806,90533,197339
201507,2015,9호선,선유도,172043,173211,345254
201507,2015,9호선,당산,440903,407847,848750
201507,2015,9호선,국회의사당,383532,398195,781727
201507,2015,9호선,여의도,520015,504327,1024342
201507,2015,9호선,샛강,136638,148813,285451
201507,2015,9호선,노량진,865887,907093,1772980
201507,2015,9호선,노들,120281,97308,217589
201507,2015,9호선,흑석(중앙대입구),237960,242669,480629
201507,2015,9호선,동작,45465,32628,78093
201507,2015,9호선,구반포,76656,81617,158273
201507,2015,9호선,신반포,75850,75165,151015
201507,2015,9호선,고속터미널,420886,478394,899280
201507,2015,9호선,사평,68719,63542,132261
201507,2015,9호선,신논현,861507,852070,1713577
201507,2015,공항철도 1호선,서울역,252941,225501,478442
201507,2015,공항철도 1호선,공덕,35358,40240,75598
201507,2015,공항철도 1호선,홍대입구,208274,189749,398023
201507,2015,공항철도 1호선,디지털미디어시티,279733,244304,524037
201507,2015,공항철도 1호선,김포공항,254831,176079,430910
201507,2015,공항철도 1호선,계양,291909,266960,558869
201507,2015,공항철도 1호선,검암,458077,418299,876376
201507,2015,공항철도 1호선,청라국제도시,123920,115240,239160
201507,2015,공항철도 1호선,운서,153126,154147,307273
201507,2015,공항철도 1호선,공항화물청사,64291,68809,133100
201507,2015,공항철도 1호선,인천국제공항,316891,311612,628503
201507,2015,9호선2단계,언주,168196,164340,332536
201507,2015,9호선2단계,선정릉,139500,145195,284695
201507,2015,9호선2단계,삼성중앙,101303,104632,205935
201507,2015,9호선2단계,봉은사,218025,220104,438129
201507,2015,9호선2단계,종합운동장,113890,90377,204267
201507,2015,경인선,중동,244437,227067,471504
201507,2015,경인선,온수,170584,161038,331622
201507,2015,경인선,도원,86758,87673,174431
201507,2015,경인선,간석,164224,155875,320099
201507,2015,경인선,부개,265166,245634,510800
201507,2015,경인선,소사,303463,295973,599436
201507,2015,경인선,구일,135525,132840,268365
201507,2015,5호선,충정로,115742,119392,235134
201507,2015,5호선,서대문,411515,427608,839123
201507,2015,5호선,광화문,943473,1002902,1946375
201507,2015,5호선,종로3가,279820,287938,567758
201507,2015,5호선,을지로4가,104733,118600,223333
201507,2015,5호선,동대문역사문화공원,71619,89742,161361
201507,2015,5호선,방화,177697,168105,345802
201507,2015,수인선,송도,86269,85018,171287
201507,2015,수인선,연수,88408,85711,174119
201507,2015,수인선,원인재,93572,98529,192101
201507,2015,수인선,남동인더스파크,49334,55600,104934
201507,2015,수인선,호구포,73396,75790,149186
201507,2015,수인선,인천논현,125456,129461,254917
201507,2015,수인선,소래포구,92417,84738,177155
201507,2015,수인선,월곶,58008,53082,111090
201507,2015,수인선,달월,1685,1455,3140
201507,2015,경춘선,춘천,45284,41172,86456
201507,2015,경춘선,남춘천,69396,73156,142552
201507,2015,경춘선,김유정,12541,14812,27353
201507,2015,경춘선,강촌,21384,17920,39304
201507,2015,경춘선,백양리,4673,3876,8549
201507,2015,경춘선,굴봉산,7461,7352,14813
201507,2015,경춘선,가평,82287,85102,167389
201507,2015,경춘선,상천,10118,8646,18764
201507,2015,경춘선,청평,71017,70675,141692
201507,2015,경춘선,대성리,27343,27783,55126
201507,2015,경춘선,마석,76558,83159,159717
201507,2015,경춘선,천마산,22097,20921,43018
201507,2015,경춘선,평내호평,129524,125515,255039
201507,2015,경춘선,금곡,29924,28969,58893
201507,2015,경춘선,사릉,88648,82546,171194
201507,2015,경춘선,퇴계원,82075,71977,154052
201507,2015,경춘선,별내,51961,50396,102357
201507,2015,경춘선,갈매,7871,7697,15568
201507,2015,경춘선,신내,13181,15349,28530
201507,2015,경의선,검암,2,0,2
201507,2015,경의선,계양,9,0,9
201507,2015,경의선,김포공항,3,0,3
201507,2015,경의선,공덕,1,0,1
201507,2015,경의선,서울역,6,0,6
201507,2015,경의선,문산,146504,143917,290421
201507,2015,경의선,파주,29473,20383,49856
201507,2015,경의선,월롱,50696,56419,107115
201507,2015,경의선,금촌,173469,164768,338237
201507,2015,경의선,금릉,118932,114580,233512
201507,2015,경의선,운정,130148,116249,246397
201507,2015,경의선,탄현,202185,192830,395015
201507,2015,경의선,일산,218385,207311,425696
201507,2015,경의선,풍산,104663,96477,201140
201507,2015,경의선,백마,161098,145223,306321
201507,2015,경의선,곡산,11589,12106,23695
201507,2015,경의선,능곡,81615,73908,155523
201507,2015,경의선,행신,176649,164825,341474
201507,2015,경의선,강매,53487,45218,98705
201507,2015,경의선,화전,47439,44232,91671
201507,2015,경의선,수색,44172,47967,92139
201507,2015,경의선,디지털미디어시티,53759,48302,102061
201507,2015,경의선,가좌,58561,53496,112057
201507,2015,경의선,홍대입구,35177,51595,86772
201507,2015,경의선,서강대,49663,49323,98986
201507,2015,경의선,공덕,40625,48551,89176
201507,2015,경의선,신촌,20793,26647,47440
201507,2015,경의선,서울역,80996,87004,168000
201507,2015,장항선,신창,32339,32363,64702
201507,2015,장항선,온양온천,88440,89109,177549
201507,2015,장항선,배방,20459,19823,40282
201507,2015,장항선,아산,56815,52127,108942
201507,2015,장항선,쌍용동,53794,49015,102809
201507,2015,장항선,봉명,29215,28986,58201
201507,2015,중앙선,용문,57184,58462,115646
201507,2015,중앙선,원덕,6909,6578,13487
201507,2015,중앙선,양평,87792,87787,175579
201507,2015,중앙선,오빈,6934,6997,13931
201507,2015,중앙선,아신,18244,18400,36644
201507,2015,중앙선,국수,19757,18133,37890
201507,2015,중앙선,신원,5277,4368,9645
201507,2015,중앙선,양수,57378,57432,114810
201507,2015,중앙선,운길산,29469,27135,56604
201507,2015,중앙선,팔당,21976,20535,42511
201507,2015,중앙선,도심,59093,47040,106133
201507,2015,중앙선,덕소,146105,148632,294737
201507,2015,중앙선,양정,19390,16184,35574
201507,2015,중앙선,도농,219134,187782,406916
201507,2015,중앙선,구리,332349,348405,680754
201507,2015,중앙선,양원,45476,48500,93976
201507,2015,중앙선,망우,180914,169789,350703
201507,2015,중앙선,상봉,134032,132555,266587
201507,2015,중앙선,중랑,131710,121175,252885
201507,2015,중앙선,회기,708050,686470,1394520
201507,2015,일산선,대화,341962,259611,601573
201507,2015,일산선,주엽,197031,201040,398071
201507,2015,일산선,정발산,219399,241544,460943
201507,2015,일산선,마두,183632,191031,374663
201507,2015,일산선,백석,251015,244215,495230
201507,2015,일산선,대곡,32923,23850,56773
201507,2015,일산선,화정,475129,492597,967726
201507,2015,일산선,원당,294989,274577,569566
201507,2015,일산선,삼송,280221,264727,544948
201507,2015,일산선,지축,1,0,1
201507,2015,일산선,원흥,106953,90077,197030
201507,2015,분당선,매교,61819,60475,122294
201507,2015,분당선,수원시청,267636,304721,572357
201507,2015,분당선,매탄권선,110794,102611,213405
201507,2015,분당선,망포,324471,295490,619961
201507,2015,분당선,영통,230066,237213,467279
201507,2015,분당선,청명,110386,100456,210842
201507,2015,분당선,상갈,124275,117512,241787
201507,2015,분당선,기흥,189091,179081,368172
201507,2015,분당선,신갈,110733,104672,215405
201507,2015,분당선,구성,125309,121869,247178
201507,2015,분당선,죽전,542765,596768,1139533
201507,2015,분당선,보정,65129,49359,114488
201507,2015,분당선,이매,146060,140512,286572
201507,2015,분당선,오리,393468,329884,723352
201507,2015,분당선,미금,536392,555722,1092114
201507,2015,분당선,정자,423859,468640,892499
201507,2015,분당선,수내,347496,348770,696266
201507,2015,분당선,서현,690456,714290,1404746
201507,2015,분당선,야탑,702698,742212,1444910
201507,2015,분당선,모란,586456,538353,1124809
201507,2015,분당선,태평,362086,338185,700271
201507,2015,6호선,상월곡,148106,128487,276593
201506,2015,2호선,을지로입구,1209982,1242564,2452546
201506,2015,9호선,여의도,469537,458576,928113
201506,2015,9호선,국회의사당,357263,372864,730127
201506,2015,9호선,당산,412226,386879,799105
201506,2015,9호선,선유도,162831,162064,324895
201506,2015,9호선,신목동,97387,83013,180400
201506,2015,9호선,염창,372775,364526,737301
201506,2015,9호선,등촌,235334,227851,463185
201506,2015,9호선,증미,169978,174516,344494
201506,2015,9호선,가양,462046,447006,909052
201506,2015,9호선,양천향교,163623,162981,326604
201506,2015,9호선,마곡나루,46735,42787,89522
201506,2015,9호선,신방화,172800,165498,338298
201506,2015,9호선,공항시장,65195,71634,136829
201506,2015,9호선,김포공항,211973,253968,465941
201506,2015,9호선,개화,153653,91267,244920
201506,2015,8호선,모란,84881,65265,150146
201506,2015,8호선,수진,109205,98386,207591
201506,2015,8호선,신흥,109480,111251,220731
201506,2015,8호선,단대오거리,311233,284551,595784
201506,2015,8호선,남한산성입구,361587,329093,690680
201506,2015,8호선,산성,178670,170768,349438
201506,2015,8호선,복정,206861,151528,358389
201506,2015,8호선,장지,296048,284357,580405
201506,2015,8호선,문정,141112,133523,274635
201506,2015,8호선,가락시장,136967,167127,304094
201506,2015,8호선,송파,124929,127325,252254
201506,2015,8호선,석촌,199606,210870,410476
201506,2015,8호선,잠실,235594,293735,529329
201506,2015,8호선,몽촌토성,144571,160577,305148
201506,2015,8호선,강동구청,237529,246791,484320
201506,2015,8호선,천호,456050,500963,957013
201506,2015,8호선,암사,406890,350183,757073
201506,2015,7호선,부평구청,312275,235127,547402
201506,2015,7호선,굴포천,208650,213668,422318
201506,2015,7호선,삼산체육관,130964,115791,246755
201506,2015,7호선,상동,334340,346843,681183
201506,2015,7호선,부천시청,291688,299766,591454
201506,2015,7호선,신중동,350851,349430,700281
201506,2015,7호선,춘의,202360,198109,400469
201506,2015,7호선,부천종합운동장,140591,127726,268317
201506,2015,7호선,까치울,148023,128941,276964
201506,2015,7호선,온수,290901,268508,559409
201506,2015,7호선,천왕,189072,170512,359584
201506,2015,7호선,광명사거리,657570,620377,1277947
201506,2015,7호선,철산,609783,611702,1221485
201506,2015,7호선,가산디지털단지,1080770,1111208,2191978
201506,2015,7호선,남구로,401761,420402,822163
201506,2015,7호선,대림,234665,231713,466378
201506,2015,6호선,효창공원앞,187353,181813,369166
201506,2015,6호선,삼각지,193074,155136,348210
201506,2015,6호선,녹사평(용산구청),177297,195721,373018
201506,2015,6호선,이태원,379410,433415,812825
201506,2015,6호선,한강진,139702,174462,314164
201506,2015,6호선,버티고개,60883,54991,115874
201506,2015,6호선,약수,80354,83018,163372
201506,2015,6호선,청구,86895,88671,175566
201506,2015,6호선,신당,196485,208598,405083
201506,2015,6호선,동묘앞,187549,191261,378810
201506,2015,6호선,창신,81364,68617,149981
201506,2015,6호선,보문,208159,181979,390138
201506,2015,6호선,안암,342504,354314,696818
201506,2015,6호선,고려대,253693,242908,496601
201506,2015,6호선,월곡,308467,282990,591457
201506,2015,6호선,상월곡,153729,141026,294755
201506,2015,6호선,돌곶이,224799,198654,423453
201506,2015,6호선,석계,315896,322535,638431
201506,2015,6호선,태릉입구,121573,146927,268500
201506,2015,6호선,화랑대,332293,238672,570965
201506,2015,6호선,봉화산(서울의료원),219673,200144,419817
201506,2015,7호선,장암,69587,24104,93691
201506,2015,7호선,도봉산,288608,266065,554673
201506,2015,7호선,수락산,323057,312251,635308
201506,2015,7호선,마들,268451,241128,509579
201506,2015,7호선,노원,483772,537880,1021652
201506,2015,7호선,중계,363743,322346,686089
201506,2015,7호선,하계,480650,448105,928755
201506,2015,7호선,공릉,313090,305578,618668
201506,2015,7호선,태릉입구,215314,206348,421662
201506,2015,7호선,먹골,241512,228181,469693
201506,2015,7호선,중화,288196,268652,556848
201506,2015,7호선,상봉,438517,405795,844312
201506,2015,7호선,면목,391333,370939,762272
201506,2015,7호선,사가정,387203,372541,759744
201506,2015,7호선,용마산,148679,137032,285711
201506,2015,7호선,중곡,236061,210545,446606
201506,2015,7호선,군자,345256,256046,601302
201506,2015,7호선,어린이대공원,415979,420938,836917
201506,2015,7호선,건대입구,376458,414473,790931
201506,2015,7호선,뚝섬유원지,236018,224375,460393
201506,2015,7호선,청담,538942,635914,1174856
201506,2015,7호선,강남구청,411510,458668,870178
201506,2015,7호선,학동,588756,670310,1259066
201506,2015,7호선,신풍,275994,256965,532959
201506,2015,7호선,보라매,237270,238681,475951
201506,2015,7호선,신대방삼거리,369618,343815,713433
201506,2015,7호선,장승배기,235361,223096,458457
201506,2015,7호선,상도,278263,266703,544966
201506,2015,7호선,숭실대입구,422389,409477,831866
201506,2015,7호선,남성,271098,243144,514242
201506,2015,7호선,이수,408774,409193,817967
201506,2015,7호선,내방,342766,356185,698951
201506,2015,7호선,고속터미널,437710,397462,835172
201506,2015,7호선,반포,145645,140788,286433
201506,2015,7호선,논현,514604,570165,1084769
201506,2015,6호선,공덕,446249,439962,886211
201506,2015,6호선,대흥,208807,222940,431747
201506,2015,6호선,광흥창,218177,209174,427351
201506,2015,6호선,상수,264379,317251,581630
201506,2015,6호선,합정,327734,322525,650259
201506,2015,6호선,망원,266430,281696,548126
201506,2015,6호선,마포구청,319083,272506,591589
201506,2015,6호선,월드컵경기장,139668,155960,295628
201506,2015,6호선,디지털미디어시티,376023,413223,789246
201506,2015,6호선,증산,240797,224128,464925
201506,2015,6호선,새절,327196,305027,632223
201506,2015,6호선,구산,185290,118188,303478
201506,2015,6호선,연신내,18,0,18
201506,2015,6호선,독바위,62924,66951,129875
201506,2015,6호선,불광,121432,123467,244899
201506,2015,6호선,역촌,73479,92725,166204
201506,2015,6호선,응암,406476,385534,792010
201506,2015,5호선,마천,123403,120016,243419
201506,2015,5호선,거여,162983,151993,314976
201506,2015,5호선,개롱,151106,148910,300016
201506,2015,5호선,오금,96438,96893,193331
201506,2015,5호선,방이,157167,161593,318760
201506,2015,5호선,올림픽공원,149316,143693,293009
201506,2015,5호선,둔촌동,301032,295116,596148
201506,2015,5호선,상일동,267167,215768,482935
201506,2015,5호선,고덕,173016,171696,344712
201506,2015,5호선,명일,182425,180736,363161
201506,2015,5호선,굽은다리,212051,198494,410545
201506,2015,5호선,길동,157592,165277,322869
201506,2015,5호선,강동,454569,371475,826044
201506,2015,5호선,천호,438613,477628,916241
201506,2015,5호선,광나루,361229,321697,682926
201506,2015,5호선,아차산,335091,313156,648247
201506,2015,5호선,군자,266926,290909,557835
201506,2015,5호선,장한평,436427,436401,872828
201506,2015,5호선,답십리,394295,354208,748503
201506,2015,5호선,마장,136402,131186,267588
201506,2015,5호선,왕십리(성동구청),118472,149085,267557
201506,2015,5호선,행당,191774,164299,356073
201506,2015,5호선,신금호,123140,120867,244007
201506,2015,5호선,청구,93421,91601,185022
201506,2015,5호선,동대문역사문화공원,70165,85991,156156
201506,2015,5호선,을지로4가,100705,113490,214195
201506,2015,5호선,종로3가,240431,245132,485563
201506,2015,5호선,광화문,847981,911431,1759412
201506,2015,5호선,서대문,413262,430045,843307
201506,2015,5호선,충정로,117264,124094,241358
201506,2015,5호선,애오개,154629,157843,312472
201506,2015,5호선,공덕,329558,355337,684895
201506,2015,5호선,마포,348948,370752,719700
201506,2015,5호선,여의나루,238169,257360,495529
201506,2015,5호선,여의도,561666,637084,1198750
201506,2015,5호선,신길,76353,89227,165580
201506,2015,5호선,영등포시장,150825,167194,318019
201506,2015,5호선,영등포구청,79914,80779,160693
201506,2015,5호선,양평,148049,150562,298611
201506,2015,5호선,오목교,622120,680508,1302628
201506,2015,5호선,목동,460271,484362,944633
201506,2015,5호선,신정,367302,278035,645337
201506,2015,5호선,까치산,705500,649681,1355181
201506,2015,5호선,화곡,692617,627923,1320540
201506,2015,5호선,우장산,380225,363906,744131
201506,2015,5호선,발산,253906,254943,508849
201506,2015,5호선,마곡,72919,58032,130951
201506,2015,5호선,송정,237950,225735,463685
201506,2015,5호선,김포공항,167047,147753,314800
201506,2015,5호선,개화산,134908,123605,258513
201506,2015,5호선,방화,165290,156849,322139
201506,2015,4호선,남태령,21935,17750,39685
201506,2015,4호선,사당,845219,659895,1505114
201506,2015,4호선,총신대입구,510574,572889,1083463
201506,2015,4호선,동작,59568,64160,123728
201506,2015,4호선,이촌,190979,222270,413249
201506,2015,4호선,신용산,321896,347310,669206
201506,2015,4호선,삼각지,115892,146226,262118
201506,2015,4호선,숙대입구,456261,447772,904033
201506,2015,4호선,서울역,270347,449000,719347
201506,2015,4호선,회현,575932,637720,1213652
201506,2015,4호선,명동,859989,943006,1802995
201506,2015,4호선,충무로,810788,843725,1654513
201506,2015,4호선,동대문역사문화공원,498352,475140,973492
201506,2015,4호선,동대문,515327,543970,1059297
201506,2015,4호선,혜화,954393,1010975,1965368
201506,2015,4호선,한성대입구,415170,392077,807247
201506,2015,4호선,성신여대입구,664965,601675,1266640
201506,2015,4호선,길음,679196,642995,1322191
201506,2015,4호선,미아사거리,776277,740517,1516794
201506,2015,4호선,미아,434936,386499,821435
201506,2015,4호선,수유(강북구청),1095049,1050993,2146042
201506,2015,4호선,쌍문,808668,674867,1483535
201506,2015,4호선,창동,682918,748936,1431854
201506,2015,4호선,노원,570552,653035,1223587
201506,2015,4호선,상계,519971,454052,974023
201506,2015,4호선,당고개,294665,272478,567143
201506,2015,3호선,오금,166870,145956,312826
201506,2015,3호선,경찰병원,169741,167596,337337
201506,2015,3호선,가락시장,184869,168039,352908
201506,2015,3호선,수서,263674,274136,537810
201506,2015,3호선,일원,158705,150626,309331
201506,2015,3호선,대청,248851,223117,471968
201506,2015,3호선,학여울,47654,49831,97485
201506,2015,3호선,대치,258680,241955,500635
201506,2015,3호선,도곡,166628,154757,321385
201506,2015,3호선,매봉,278067,268131,546198
201506,2015,3호선,양재,1020532,1109983,2130515
201506,2015,3호선,남부터미널,832882,875332,1708214
201506,2015,3호선,교대,338019,257293,595312
201506,2015,3호선,고속터미널,1168310,1209314,2377624
201506,2015,3호선,잠원,127018,123210,250228
201506,2015,3호선,신사,775158,861814,1636972
201506,2015,3호선,압구정,841983,942953,1784936
201506,2015,3호선,옥수,236233,243635,479868
201506,2015,3호선,금호,176207,158368,334575
201506,2015,3호선,약수,332753,316009,648762
201506,2015,3호선,동대입구,277064,315709,592773
201506,2015,3호선,충무로,22,0,22
201506,2015,3호선,을지로3가,193188,230292,423480
201506,2015,3호선,종로3가,168814,231028,399842
201506,2015,3호선,안국,575069,635723,1210792
201506,2015,3호선,경복궁,549686,578700,1128386
201506,2015,3호선,독립문,144758,149456,294214
201506,2015,3호선,무악재,88064,83722,171786
201506,2015,3호선,홍제,447712,406483,854195
201506,2015,3호선,녹번,346650,288078,634728
201506,2015,3호선,불광,403841,434637,838478
201506,2015,3호선,연신내,956973,886043,1843016
201506,2015,3호선,구파발,414345,330631,744976
201506,2015,3호선,지축,27442,27736,55178
201506,2015,2호선,용두,40133,42588,82721
201506,2015,2호선,신정네거리,243687,239706,483393
201506,2015,2호선,양천구청,160397,168672,329069
201506,2015,2호선,도림천,22297,25175,47472
201506,2015,2호선,신설동,77342,75243,152585
201506,2015,2호선,신답,29399,33361,62760
201506,2015,2호선,용답,56035,56933,112968
201506,2015,2호선,충정로,271838,299644,571482
201506,2015,2호선,아현,226264,214565,440829
201506,2015,2호선,이대,519790,548127,1067917
201506,2015,2호선,신촌,1196078,1238733,2434811
201506,2015,2호선,홍대입구,1777825,1906801,3684626
201506,2015,2호선,합정,875371,896174,1771545
201506,2015,2호선,당산,592471,655200,1247671
201506,2015,2호선,영등포구청,514091,519494,1033585
201506,2015,2호선,문래,467868,475079,942947
201506,2015,2호선,신도림,1576715,1584317,3161032
201506,2015,2호선,대림,739048,760963,1500011
201506,2015,2호선,구로디지털단지,1660161,1669390,3329551
201506,2015,2호선,신대방,644350,607006,1251356
201506,2015,2호선,신림,1846928,1779497,3626425
201506,2015,2호선,봉천,535537,479355,1014892
201506,2015,2호선,서울대입구,1303870,1278696,2582566
201506,2015,2호선,낙성대,767261,729159,1496420
201506,2015,2호선,사당,1056990,1185795,2242785
201506,2015,2호선,방배,526567,536729,1063296
201506,2015,2호선,서초,565769,586111,1151880
201506,2015,2호선,교대,920558,1023348,1943906
201506,2015,2호선,강남,2566181,2614786,5180967
201506,2015,2호선,역삼,1149283,1302142,2451425
201506,2015,2호선,선릉,1404763,1213995,2618758
201506,2015,2호선,삼성,1401372,1473924,2875296
201506,2015,2호선,종합운동장,402446,462622,865068
201506,2015,2호선,신천,623824,608569,1232393
201506,2015,2호선,잠실,1952347,1782341,3734688
201506,2015,2호선,잠실나루,398304,375371,773675
201506,2015,2호선,강변,1194283,1188130,2382413
201506,2015,2호선,구의,574051,557533,1131584
201506,2015,2호선,건대입구,1131555,1241913,2373468
201506,2015,2호선,성수,612230,682312,1294542
201506,2015,2호선,뚝섬,376155,399204,775359
201506,2015,2호선,한양대,334929,391176,726105
201506,2015,2호선,왕십리(성동구청),513922,422621,936543
201506,2015,2호선,상왕십리,247416,231787,479203
201506,2015,2호선,신당,317677,335996,653673
201506,2015,2호선,동대문역사문화공원,404325,468768,873093
201506,2015,2호선,을지로4가,258533,263145,521678
201506,2015,2호선,을지로3가,454666,451155,905821
201506,2015,9호선,샛강,122523,134041,256564
201506,2015,2호선,시청,626643,630508,1257151
201506,2015,1호선,동묘앞,143755,157967,301722
201506,2015,1호선,청량리(지하),510979,526815,1037794
201506,2015,1호선,제기동,257425,253997,511422
201506,2015,1호선,신설동,355417,350781,706198
201506,2015,1호선,동대문,298461,334109,632570
201506,2015,1호선,종로5가,465263,487087,952350
201506,2015,1호선,종로3가,631309,587196,1218505
201506,2015,1호선,종각,1057792,1041329,2099121
201506,2015,1호선,시청,558388,569150,1127538
201506,2015,1호선,서울역,1305795,1195679,2501474
201506,2015,9호선,종합운동장,100832,81245,182077
201506,2015,9호선,봉은사,181664,181156,362820
201506,2015,9호선,삼성중앙,87108,89528,176636
201506,2015,9호선,선정릉,121297,129329,250626
201506,2015,9호선,언주,145586,141923,287509
201506,2015,9호선,신논현,756040,741171,1497211
201506,2015,9호선,사평,62406,57840,120246
201506,2015,9호선,고속터미널,345049,380002,725051
201506,2015,9호선,신반포,68991,69854,138845
201506,2015,9호선,구반포,71267,75774,147041
201506,2015,9호선,동작,49319,37227,86546
201506,2015,9호선,흑석(중앙대입구),268102,271250,539352
201506,2015,9호선,노들,112304,91742,204046
201506,2015,9호선,노량진,778195,818189,1596384
201505,2015,8호선,강동구청,255476,263819,519295
201505,2015,8호선,몽촌토성,213214,232730,445944
201505,2015,8호선,잠실,277431,350073,627504
201505,2015,8호선,석촌,217815,228096,445911
201505,2015,8호선,송파,132635,132426,265061
201505,2015,8호선,가락시장,146333,177422,323755
201505,2015,8호선,문정,150689,141525,292214
201505,2015,8호선,장지,335361,319941,655302
201505,2015,8호선,복정,226311,167864,394175
201505,2015,8호선,산성,200625,190363,390988
201505,2015,8호선,남한산성입구,399974,367629,767603
201505,2015,8호선,단대오거리,349726,315495,665221
201505,2015,8호선,신흥,122967,128258,251225
201505,2015,8호선,수진,123651,110874,234525
201505,2015,8호선,모란,102842,79391,182233
201505,2015,9호선,개화,166969,101432,268401
201505,2015,9호선,김포공항,257328,305267,562595
201505,2015,9호선,공항시장,70512,78026,148538
201505,2015,9호선,신방화,183979,175297,359276
201505,2015,9호선,마곡나루,48994,44433,93427
201505,2015,9호선,양천향교,172172,169112,341284
201505,2015,9호선,가양,503937,481524,985461
201505,2015,9호선,증미,175643,178288,353931
201505,2015,9호선,등촌,253308,244768,498076
201505,2015,9호선,염창,402219,391849,794068
201505,2015,9호선,신목동,110465,93505,203970
201505,2015,9호선,선유도,174310,173212,347522
201505,2015,9호선,당산,449922,417433,867355
201505,2015,9호선,국회의사당,377230,386249,763479
201505,2015,9호선,여의도,482265,465663,947928
201505,2015,9호선,샛강,131385,138171,269556
201505,2015,9호선,노량진,894471,944713,1839184
201505,2015,9호선,노들,121435,97618,219053
201505,2015,9호선,흑석(중앙대입구),332958,334496,667454
201505,2015,9호선,동작,62517,46837,109354
201505,2015,9호선,구반포,81883,88447,170330
201505,2015,9호선,신반포,83122,83369,166491
201505,2015,9호선,고속터미널,472267,534383,1006650
201505,2015,9호선,사평,72297,66174,138471
201505,2015,9호선,신논현,812443,794043,1606486
201505,2015,9호선,언주,140837,133298,274135
201505,2015,9호선,선정릉,115713,124352,240065
201505,2015,9호선,삼성중앙,84616,83449,168065
201505,2015,9호선,봉은사,203730,203323,407053
201505,2015,9호선,종합운동장,108983,81155,190138
201505,2015,6호선,독바위,68393,75868,144261
201505,2015,6호선,불광,138408,137817,276225
201505,2015,6호선,역촌,79493,99260,178753
201505,2015,6호선,응암,435080,417124,852204
201505,2015,5호선,마천,137533,136413,273946
201505,2015,5호선,거여,175994,163262,339256
201505,2015,5호선,개롱,169253,166567,335820
201505,2015,5호선,오금,100100,99602,199702
201505,2015,5호선,방이,172274,174506,346780
201505,2015,5호선,올림픽공원,241619,243459,485078
201505,2015,5호선,둔촌동,333182,327948,661130
201505,2015,5호선,상일동,298186,240803,538989
201505,2015,5호선,고덕,206750,207524,414274
201505,2015,5호선,명일,213762,208710,422472
201505,2015,5호선,굽은다리,234131,219552,453683
201505,2015,5호선,길동,173186,180735,353921
201505,2015,5호선,강동,508961,418791,927752
201505,2015,5호선,천호,533181,574350,1107531
201505,2015,5호선,광나루,415436,370812,786248
201505,2015,5호선,아차산,420914,395143,816057
201505,2015,5호선,군자,288118,318721,606839
201505,2015,5호선,장한평,462345,460159,922504
201505,2015,5호선,답십리,418879,380475,799354
201505,2015,5호선,마장,149004,145425,294429
201505,2015,5호선,왕십리(성동구청),130241,168238,298479
201505,2015,5호선,행당,208369,177945,386314
201505,2015,5호선,신금호,131489,129103,260592
201505,2015,5호선,청구,100928,98407,199335
201505,2015,5호선,동대문역사문화공원,71434,87405,158839
201505,2015,5호선,을지로4가,104165,118861,223026
201505,2015,5호선,종로3가,295868,293599,589467
201505,2015,5호선,광화문,1005638,1043972,2049610
201505,2015,5호선,서대문,436616,447267,883883
201505,2015,5호선,충정로,126131,129087,255218
201505,2015,5호선,애오개,155152,158276,313428
201505,2015,5호선,공덕,336863,357841,694704
201505,2015,5호선,마포,361992,378059,740051
201505,2015,5호선,여의나루,382195,409682,791877
201505,2015,5호선,여의도,580860,663911,1244771
201505,2015,5호선,신길,78376,91428,169804
201505,2015,5호선,영등포시장,164956,184229,349185
201505,2015,5호선,영등포구청,79130,80951,160081
201505,2015,5호선,양평,150022,151272,301294
201505,2015,5호선,오목교,729575,792787,1522362
201505,2015,5호선,목동,506079,525531,1031610
201505,2015,5호선,신정,386179,298067,684246
201505,2015,6호선,망원,281985,296272,578257
201505,2015,6호선,합정,374123,359338,733461
201505,2015,6호선,상수,304785,361759,666544
201505,2015,6호선,광흥창,226468,215594,442062
201505,2015,6호선,대흥,229707,244898,474605
201505,2015,6호선,공덕,455822,446958,902780
201505,2015,6호선,효창공원앞,203757,196654,400411
201505,2015,6호선,삼각지,231676,178252,409928
201505,2015,6호선,녹사평(용산구청),230863,260911,491774
201505,2015,6호선,이태원,500935,565470,1066405
201505,2015,6호선,한강진,165058,200211,365269
201505,2015,6호선,버티고개,65347,60054,125401
201505,2015,6호선,약수,85265,87949,173214
201505,2015,6호선,청구,92756,94060,186816
201505,2015,6호선,신당,223174,224671,447845
201505,2015,6호선,동묘앞,223071,224738,447809
201505,2015,6호선,창신,84630,72655,157285
201505,2015,6호선,보문,226089,197285,423374
201505,2015,6호선,안암,445710,455509,901219
201505,2015,6호선,고려대,298120,290661,588781
201505,2015,6호선,월곡,342447,315892,658339
201505,2015,6호선,상월곡,164239,151857,316096
201505,2015,6호선,돌곶이,241566,215508,457074
201505,2015,6호선,석계,348561,354467,703028
201505,2015,6호선,태릉입구,136772,172786,309558
201505,2015,6호선,화랑대,375690,275678,651368
201505,2015,6호선,봉화산(서울의료원),237218,220072,457290
201505,2015,7호선,장암,73813,28065,101878
201505,2015,7호선,도봉산,326072,311342,637414
201505,2015,7호선,수락산,365561,348780,714341
201505,2015,7호선,마들,297614,263778,561392
201505,2015,7호선,노원,552505,617370,1169875
201505,2015,7호선,중계,402108,358876,760984
201505,2015,7호선,하계,547132,515499,1062631
201505,2015,7호선,공릉,355623,348842,704465
201505,2015,7호선,태릉입구,261068,247798,508866
201505,2015,7호선,먹골,264701,252054,516755
201505,2015,7호선,중화,313219,292223,605442
201505,2015,7호선,상봉,486798,455343,942141
201505,2015,7호선,면목,430595,407924,838519
201505,2015,7호선,사가정,426952,408774,835726
201505,2015,7호선,용마산,160765,148760,309525
201505,2015,7호선,중곡,250451,223931,474382
201505,2015,7호선,군자,371749,271487,643236
201505,2015,7호선,어린이대공원,616590,638013,1254603
201505,2015,7호선,건대입구,525546,576046,1101592
201505,2015,7호선,뚝섬유원지,338571,328372,666943
201505,2015,7호선,청담,562398,655019,1217417
201505,2015,7호선,강남구청,433245,477579,910824
201505,2015,7호선,학동,585298,658227,1243525
201505,2015,7호선,논현,516059,568765,1084824
201505,2015,7호선,반포,165951,158587,324538
201505,2015,7호선,고속터미널,609008,527956,1136964
201505,2015,7호선,내방,354593,367567,722160
201505,2015,7호선,이수,440104,436141,876245
201505,2015,7호선,남성,292760,263478,556238
201505,2015,7호선,숭실대입구,489444,476122,965566
201505,2015,7호선,상도,312369,303148,615517
201505,2015,7호선,장승배기,251831,238895,490726
201505,2015,5호선,까치산,768158,711694,1479852
201505,2015,5호선,화곡,752363,684378,1436741
201505,2015,5호선,우장산,420259,403579,823838
201505,2015,5호선,발산,292372,294372,586744
201505,2015,5호선,마곡,76675,62055,138730
201505,2015,5호선,송정,266920,257827,524747
201505,2015,5호선,김포공항,213505,188252,401757
201505,2015,5호선,개화산,142243,131412,273655
201505,2015,5호선,방화,181536,171565,353101
201505,2015,4호선,남태령,28305,20762,49067
201505,2015,4호선,사당,968066,764702,1732768
201505,2015,2호선,강변,1519351,1510610,3029961
201505,2015,2호선,구의,601905,581349,1183254
201505,2015,2호선,건대입구,1406733,1544439,2951172
201505,2015,2호선,성수,593944,661332,1255276
201505,2015,2호선,뚝섬,403834,424435,828269
201505,2015,2호선,한양대,394535,468744,863279
201505,2015,2호선,왕십리(성동구청),586421,491377,1077798
201505,2015,2호선,상왕십리,260880,244362,505242
201505,2015,2호선,신당,351999,377442,729441
201505,2015,2호선,동대문역사문화공원,534508,619440,1153948
201505,2015,2호선,을지로4가,282434,282854,565288
201505,2015,2호선,을지로3가,473299,453915,927214
201505,2015,2호선,을지로입구,1405078,1390758,2795836
201505,2015,2호선,시청,664804,643971,1308775
201505,2015,1호선,동묘앞,177919,194702,372621
201505,2015,1호선,청량리(지하),608639,634437,1243076
201505,2015,1호선,제기동,291242,287105,578347
201505,2015,1호선,신설동,386026,377405,763431
201505,2015,1호선,동대문,388574,463901,852475
201505,2015,1호선,종로5가,566242,574821,1141063
201505,2015,1호선,종로3가,770906,699029,1469935
201505,2015,1호선,종각,1233184,1152644,2385828
201505,2015,1호선,시청,640658,642361,1283019
201505,2015,1호선,서울역,1729959,1528601,3258560
201505,2015,4호선,총신대입구,565362,636381,1201743
201505,2015,4호선,동작,75063,83587,158650
201505,2015,4호선,이촌,254475,291457,545932
201505,2015,4호선,신용산,351775,375671,727446
201505,2015,4호선,삼각지,134564,179186,313750
201505,2015,4호선,숙대입구,521097,509935,1031032
201505,2015,4호선,서울역,296476,592310,888786
201505,2015,4호선,회현,708296,768125,1476421
201505,2015,4호선,명동,1251770,1374243,2626013
201505,2015,4호선,충무로,904302,920328,1824630
201505,2015,4호선,동대문역사문화공원,660117,612163,1272280
201505,2015,4호선,동대문,650034,671695,1321729
201505,2015,4호선,혜화,1322018,1391468,2713486
201505,2015,4호선,한성대입구,488673,469459,958132
201505,2015,4호선,성신여대입구,766998,690003,1457001
201505,2015,4호선,길음,778073,747351,1525424
201505,2015,4호선,미아사거리,870876,833270,1704146
201505,2015,4호선,미아,475612,426839,902451
201505,2015,4호선,수유(강북구청),1214544,1166921,2381465
201505,2015,4호선,쌍문,877855,734696,1612551
201505,2015,2호선,서초,588377,599228,1187605
201505,2015,2호선,방배,580326,587990,1168316
201505,2015,2호선,사당,1169760,1341015,2510775
201505,2015,2호선,낙성대,833073,795805,1628878
201505,2015,2호선,서울대입구,1443031,1420487,2863518
201505,2015,2호선,봉천,569487,512027,1081514
201505,2015,2호선,신림,2002688,1940276,3942964
201505,2015,2호선,신대방,703382,664458,1367840
201505,2015,2호선,구로디지털단지,1717315,1710862,3428177
201505,2015,2호선,대림,832579,866146,1698725
201505,2015,2호선,신도림,1822804,1829793,3652597
201505,2015,2호선,문래,478116,484496,962612
201505,2015,2호선,영등포구청,523794,527940,1051734
201505,2015,2호선,당산,639746,700523,1340269
201505,2015,2호선,합정,978617,1005599,1984216
201505,2015,2호선,홍대입구,2268675,2453034,4721709
201505,2015,2호선,신촌,1518822,1553722,3072544
201505,2015,2호선,이대,702526,749299,1451825
201505,2015,2호선,아현,247713,213785,461498
201505,2015,2호선,충정로,276189,302850,579039
201505,2015,4호선,창동,751719,821480,1573199
201505,2015,4호선,노원,649428,735946,1385374
201505,2015,4호선,상계,563643,491760,1055403
201505,2015,4호선,당고개,328298,305154,633452
201505,2015,3호선,오금,177835,157043,334878
201505,2015,3호선,경찰병원,180425,176435,356860
201505,2015,3호선,가락시장,206135,185826,391961
201505,2015,3호선,수서,285228,293057,578285
201505,2015,3호선,일원,225516,234768,460284
201505,2015,3호선,대청,283767,245480,529247
201505,2015,3호선,학여울,69334,71894,141228
201505,2015,3호선,대치,302511,279774,582285
201505,2015,3호선,도곡,191800,178205,370005
201505,2015,3호선,매봉,288517,274499,563016
201505,2015,3호선,양재,1102847,1174824,2277671
201505,2015,3호선,남부터미널,996645,1027661,2024306
201505,2015,3호선,교대,351179,267092,618271
201505,2015,3호선,고속터미널,1694766,1780820,3475586
201505,2015,3호선,잠원,144077,139595,283672
201505,2015,3호선,신사,887184,978087,1865271
201505,2015,3호선,압구정,921444,1025566,1947010
201505,2015,3호선,옥수,264142,270389,534531
201505,2015,3호선,금호,192301,172028,364329
201505,2015,3호선,약수,356471,337322,693793
201505,2015,3호선,동대입구,346737,404483,751220
201505,2015,3호선,충무로,38,0,38
201505,2015,3호선,을지로3가,195789,231198,426987
201505,2015,3호선,종로3가,183818,262875,446693
201505,2015,3호선,안국,784382,865760,1650142
201505,2015,3호선,경복궁,741991,816431,1558422
201505,2015,3호선,독립문,181355,191408,372763
201505,2015,3호선,무악재,96759,92765,189524
201505,2015,3호선,홍제,501871,464266,966137
201505,2015,3호선,녹번,372260,312923,685183
201505,2015,3호선,불광,449838,497257,947095
201505,2015,3호선,연신내,1044657,973596,2018253
201505,2015,7호선,신대방삼거리,392906,363963,756869
201505,2015,7호선,보라매,257294,259161,516455
201505,2015,7호선,신풍,303582,284886,588468
201505,2015,7호선,대림,309053,308432,617485
201505,2015,7호선,남구로,422155,435997,858152
201505,2015,7호선,가산디지털단지,1066670,1061731,2128401
201505,2015,7호선,철산,677634,679335,1356969
201505,2015,7호선,광명사거리,717944,677333,1395277
201505,2015,6호선,마포구청,340106,286876,626982
201505,2015,6호선,월드컵경기장,255674,285808,541482
201505,2015,6호선,디지털미디어시티,385454,416902,802356
201505,2015,6호선,증산,257844,243084,500928
201505,2015,6호선,새절,356014,334507,690521
201505,2015,6호선,구산,196179,128029,324208
201505,2015,3호선,구파발,461369,372750,834119
201505,2015,3호선,지축,31914,31527,63441
201505,2015,2호선,용두,44318,46783,91101
201505,2015,2호선,신정네거리,270727,266007,536734
201505,2015,2호선,양천구청,181282,190923,372205
201505,2015,2호선,도림천,22157,24904,47061
201505,2015,2호선,신설동,89928,82120,172048
201505,2015,2호선,신답,30269,34804,65073
201505,2015,2호선,용답,60914,62498,123412
201505,2015,2호선,교대,971565,1083514,2055079
201505,2015,2호선,강남,2745195,2811347,5556542
201505,2015,2호선,역삼,1108186,1247403,2355589
201505,2015,2호선,선릉,1354393,1171924,2526317
201505,2015,2호선,삼성,1584242,1641873,3226115
201505,2015,2호선,종합운동장,592929,678752,1271681
201505,2015,2호선,신천,708012,690442,1398454
201505,2015,2호선,잠실,2343325,2118005,4461330
201505,2015,2호선,잠실나루,463900,443759,907659
201505,2015,6호선,연신내,16,0,16
201505,2015,7호선,천왕,202673,183755,386428
201505,2015,7호선,온수,307556,293216,600772
201505,2015,7호선,까치울,172538,150881,323419
201505,2015,7호선,부천종합운동장,158732,145125,303857
201505,2015,7호선,춘의,214052,209222,423274
201505,2015,7호선,신중동,384765,382081,766846
201505,2015,7호선,부천시청,334517,341484,676001
201505,2015,7호선,상동,382603,394395,776998
201505,2015,7호선,삼산체육관,152667,137405,290072
201505,2015,7호선,굴포천,226795,231613,458408
201505,2015,7호선,부평구청,331431,247842,579273
201505,2015,8호선,암사,441236,381001,822237
201505,2015,8호선,천호,508080,569808,1077888
201504,2015,5호선,김포공항,198472,173715,372187
201504,2015,2호선,건대입구,1311804,1423964,2735768
201504,2015,2호선,구의,624602,609048,1233650
201504,2015,2호선,강변,1425513,1407363,2832876
201504,2015,2호선,잠실나루,482560,461222,943782
201504,2015,2호선,잠실,2372992,2151715,4524707
201504,2015,2호선,신천,715371,691670,1407041
201504,2015,2호선,종합운동장,511477,584870,1096347
201504,2015,2호선,삼성,1708784,1780402,3489186
201504,2015,2호선,선릉,1476444,1278180,2754624
201504,2015,2호선,역삼,1259824,1417431,2677255
201504,2015,2호선,강남,2827674,2822580,5650254
201504,2015,2호선,교대,1029945,1152495,2182440
201504,2015,2호선,서초,628940,636547,1265487
201504,2015,2호선,방배,619659,629908,1249567
201504,2015,9호선,종합운동장,95421,73907,169328
201504,2015,9호선,봉은사,189630,185097,374727
201504,2015,9호선,삼성중앙,82433,79700,162133
201504,2015,9호선,선정릉,109391,118485,227876
201504,2015,9호선,언주,134675,124224,258899
201504,2015,9호선,신논현,842378,816013,1658391
201504,2015,9호선,사평,76861,70833,147694
201504,2015,9호선,고속터미널,422398,473920,896318
201504,2015,9호선,신반포,80964,80011,160975
201504,2015,9호선,구반포,82162,86730,168892
201504,2015,9호선,동작,73381,55388,128769
201504,2015,9호선,흑석(중앙대입구),338816,339669,678485
201504,2015,9호선,노들,126327,102034,228361
201504,2015,9호선,노량진,927746,984085,1911831
201504,2015,9호선,샛강,150299,156867,307166
201504,2015,9호선,여의도,566129,548199,1114328
201504,2015,9호선,국회의사당,609493,592184,1201677
201504,2015,9호선,당산,460420,436444,896864
201504,2015,9호선,선유도,190460,189577,380037
201504,2015,9호선,신목동,114389,97981,212370
201504,2015,9호선,염창,405387,403640,809027
201504,2015,9호선,등촌,268319,259822,528141
201504,2015,9호선,증미,188239,192007,380246
201504,2015,9호선,가양,512205,494457,1006662
201504,2015,9호선,양천향교,183307,180293,363600
201504,2015,9호선,마곡나루,51005,47017,98022
201504,2015,9호선,신방화,189509,181117,370626
201504,2015,9호선,공항시장,71549,79211,150760
201504,2015,9호선,김포공항,240951,283396,524347
201504,2015,9호선,개화,174106,103970,278076
201504,2015,8호선,모란,101208,77960,179168
201504,2015,8호선,수진,123107,111287,234394
201504,2015,8호선,신흥,121640,125746,247386
201504,2015,8호선,단대오거리,357940,323204,681144
201504,2015,8호선,남한산성입구,422249,391001,813250
201504,2015,8호선,산성,198742,189798,388540
201504,2015,8호선,복정,236190,173861,410051
201504,2015,8호선,장지,338643,322967,661610
201504,2015,8호선,문정,152324,143747,296071
201504,2015,8호선,가락시장,153518,185930,339448
201504,2015,8호선,송파,140304,142576,282880
201504,2015,8호선,석촌,233131,252238,485369
201504,2015,8호선,잠실,285052,353872,638924
201504,2015,8호선,몽촌토성,182647,197826,380473
201504,2015,8호선,강동구청,270259,279632,549891
201504,2015,8호선,천호,519744,573947,1093691
201504,2015,8호선,암사,455860,394174,850034
201504,2015,7호선,부평구청,343036,256122,599158
201504,2015,7호선,굴포천,232269,238533,470802
201504,2015,7호선,삼산체육관,150610,134330,284940
201504,2015,7호선,상동,386509,399224,785733
201504,2015,7호선,부천시청,335181,344153,679334
201504,2015,7호선,신중동,394370,393364,787734
201504,2015,7호선,춘의,221652,217101,438753
201504,2015,7호선,부천종합운동장,188069,175162,363231
201504,2015,7호선,까치울,173638,150599,324237
201504,2015,7호선,온수,330068,312025,642093
201504,2015,7호선,천왕,207225,185119,392344
201504,2015,7호선,광명사거리,726654,686019,1412673
201504,2015,7호선,철산,690975,691151,1382126
201504,2015,7호선,가산디지털단지,1174431,1196656,2371087
201504,2015,7호선,남구로,446324,467732,914056
201504,2015,7호선,대림,296552,297454,594006
201504,2015,7호선,신풍,306382,286304,592686
201504,2015,7호선,보라매,266533,268017,534550
201504,2015,7호선,신대방삼거리,406966,378674,785640
201504,2015,7호선,장승배기,262797,249359,512156
201504,2015,7호선,상도,316733,309119,625852
201504,2015,7호선,숭실대입구,514100,503581,1017681
201504,2015,7호선,남성,300246,271143,571389
201504,2015,7호선,이수,448543,443890,892433
201504,2015,7호선,내방,377862,394085,771947
201504,2015,7호선,고속터미널,562534,498765,1061299
201504,2015,7호선,반포,169241,162451,331692
201504,2015,7호선,논현,552951,614272,1167223
201504,2015,7호선,학동,641825,727309,1369134
201504,2015,7호선,강남구청,462788,512187,974975
201504,2015,7호선,청담,603974,710819,1314793
201504,2015,7호선,뚝섬유원지,271137,260138,531275
201504,2015,7호선,건대입구,508782,547746,1056528
201504,2015,7호선,어린이대공원,587831,614562,1202393
201504,2015,7호선,군자,380694,278721,659415
201504,2015,7호선,중곡,258855,231480,490335
201504,2015,7호선,용마산,160217,147841,308058
201504,2015,7호선,사가정,430442,413567,844009
201504,2015,7호선,면목,450229,428878,879107
201504,2015,7호선,상봉,487593,453942,941535
201504,2015,7호선,중화,319296,300425,619721
201504,2015,7호선,먹골,264237,251135,515372
201504,2015,7호선,태릉입구,260248,245109,505357
201504,2015,7호선,공릉,360934,352478,713412
201504,2015,7호선,하계,548642,515340,1063982
201504,2015,7호선,중계,410881,367341,778222
201504,2015,7호선,노원,537368,597041,1134409
201504,2015,7호선,마들,295756,265185,560941
201504,2015,7호선,수락산,361749,345265,707014
201504,2015,7호선,도봉산,320245,296027,616272
201504,2015,7호선,장암,72840,23914,96754
201504,2015,6호선,봉화산(서울의료원),243344,224519,467863
201504,2015,6호선,화랑대,385051,282674,667725
201504,2015,6호선,태릉입구,136722,169993,306715
201504,2015,6호선,석계,355463,360387,715850
201504,2015,6호선,돌곶이,248152,221371,469523
201504,2015,6호선,상월곡,168776,157038,325814
201504,2015,6호선,월곡,353862,326771,680633
201504,2015,6호선,고려대,296573,287985,584558
201504,2015,6호선,안암,427514,441451,868965
201504,2015,6호선,보문,228478,199458,427936
201504,2015,6호선,창신,88831,77045,165876
201504,2015,6호선,동묘앞,218518,223016,441534
201504,2015,6호선,신당,212630,221974,434604
201504,2015,6호선,청구,95244,97847,193091
201504,2015,6호선,약수,87461,90604,178065
201504,2015,6호선,버티고개,67805,62497,130302
201504,2015,6호선,한강진,156870,194709,351579
201504,2015,6호선,이태원,437809,494406,932215
201504,2015,6호선,녹사평(용산구청),196584,217753,414337
201504,2015,6호선,삼각지,209684,167465,377149
201504,2015,6호선,효창공원앞,213969,208886,422855
201504,2015,6호선,공덕,477804,468931,946735
201504,2015,6호선,대흥,230664,246677,477341
201504,2015,6호선,광흥창,238703,228140,466843
201504,2015,6호선,상수,290255,341028,631283
201504,2015,6호선,합정,344178,340431,684609
201504,2015,6호선,망원,290677,307040,597717
201504,2015,6호선,마포구청,355852,303453,659305
201504,2015,6호선,월드컵경기장,174380,189446,363826
201504,2015,6호선,디지털미디어시티,413880,451247,865127
201504,2015,6호선,증산,265583,251424,517007
201504,2015,6호선,새절,371956,350341,722297
201504,2015,6호선,구산,198417,130729,329146
201504,2015,6호선,연신내,24,0,24
201504,2015,6호선,독바위,70024,74722,144746
201504,2015,6호선,불광,134241,138017,272258
201504,2015,6호선,역촌,80804,101663,182467
201504,2015,6호선,응암,445251,429211,874462
201504,2015,5호선,마천,137749,135158,272907
201504,2015,5호선,거여,181570,169033,350603
201504,2015,5호선,개롱,177308,175326,352634
201504,2015,5호선,오금,107263,108096,215359
201504,2015,5호선,방이,175884,179672,355556
201504,2015,5호선,올림픽공원,202023,201715,403738
201504,2015,5호선,둔촌동,342672,337798,680470
201504,2015,5호선,상일동,312750,250458,563208
201504,2015,5호선,고덕,209528,209365,418893
201504,2015,5호선,명일,220049,216702,436751
201504,2015,5호선,굽은다리,237147,223079,460226
201504,2015,5호선,길동,176730,186243,362973
201504,2015,5호선,강동,524807,430415,955222
201504,2015,5호선,천호,519507,567011,1086518
201504,2015,5호선,광나루,433327,389195,822522
201504,2015,5호선,아차산,414171,388620,802791
201504,2015,5호선,군자,296680,324398,621078
201504,2015,5호선,장한평,487756,487624,975380
201504,2015,5호선,답십리,434735,395248,829983
201504,2015,5호선,마장,160951,157698,318649
201504,2015,5호선,왕십리(성동구청),132448,167426,299874
201504,2015,5호선,행당,216369,186043,402412
201504,2015,5호선,신금호,138382,135804,274186
201504,2015,5호선,청구,105207,103646,208853
201504,2015,5호선,동대문역사문화공원,80751,97766,178517
201504,2015,5호선,을지로4가,112294,125721,238015
201504,2015,5호선,종로3가,293497,289905,583402
201504,2015,5호선,광화문,1026966,1077416,2104382
201504,2015,5호선,서대문,486436,495822,982258
201504,2015,5호선,충정로,137968,144124,282092
201504,2015,5호선,애오개,159371,164121,323492
201504,2015,5호선,공덕,369607,396520,766127
201504,2015,5호선,마포,389287,407178,796465
201504,2015,5호선,여의나루,427772,501786,929558
201504,2015,5호선,여의도,693122,817209,1510331
201504,2015,5호선,신길,83583,99444,183027
201504,2015,5호선,영등포시장,170654,190924,361578
201504,2015,5호선,영등포구청,86298,88052,174350
201504,2015,5호선,양평,163041,165584,328625
201504,2015,5호선,오목교,711939,772383,1484322
201504,2015,5호선,목동,519206,542030,1061236
201504,2015,5호선,신정,403118,310193,713311
201504,2015,5호선,까치산,782710,726250,1508960
201504,2015,5호선,화곡,764375,692553,1456928
201504,2015,2호선,사당,1202443,1367282,2569725
201504,2015,2호선,낙성대,846594,812722,1659316
201504,2015,2호선,서울대입구,1462296,1431575,2893871
201504,2015,2호선,봉천,594057,535138,1129195
201504,2015,2호선,신림,2019614,1952714,3972328
201504,2015,2호선,신대방,712355,676757,1389112
201504,2015,2호선,구로디지털단지,1813560,1816854,3630414
201504,2015,2호선,대림,840926,875706,1716632
201504,2015,2호선,신도림,1852924,1847980,3700904
201504,2015,2호선,문래,510970,518271,1029241
201504,2015,2호선,영등포구청,562472,567191,1129663
201504,2015,2호선,당산,675943,738293,1414236
201504,2015,2호선,합정,976159,980681,1956840
201504,2015,2호선,홍대입구,2068501,2201325,4269826
201504,2015,2호선,신촌,1435917,1472741,2908658
201504,2015,2호선,이대,685734,727840,1413574
201504,2015,2호선,아현,249942,217488,467430
201504,2015,2호선,충정로,297989,328597,626586
201504,2015,2호선,용답,62427,64964,127391
201504,2015,2호선,신답,31194,36498,67692
201504,2015,2호선,신설동,92166,87747,179913
201504,2015,2호선,도림천,25019,29351,54370
201504,2015,2호선,양천구청,184073,196271,380344
201504,2015,2호선,신정네거리,275492,269665,545157
201504,2015,2호선,용두,46391,49134,95525
201504,2015,3호선,지축,29351,29472,58823
201504,2015,3호선,구파발,461417,364208,825625
201504,2015,3호선,연신내,1046468,974026,2020494
201504,2015,3호선,불광,452440,491889,944329
201504,2015,3호선,녹번,387437,325053,712490
201504,2015,3호선,홍제,512396,478543,990939
201504,2015,3호선,무악재,100282,96363,196645
201504,2015,3호선,독립문,173964,182081,356045
201504,2015,3호선,경복궁,726709,775317,1502026
201504,2015,3호선,안국,765908,823018,1588926
201504,2015,3호선,종로3가,192103,265040,457143
201504,2015,3호선,을지로3가,218629,257134,475763
201504,2015,3호선,충무로,40,0,40
201504,2015,3호선,동대입구,353775,409108,762883
201504,2015,3호선,약수,367610,350029,717639
201504,2015,3호선,금호,195861,176541,372402
201504,2015,3호선,옥수,269919,276862,546781
201504,2015,3호선,압구정,949332,1063433,2012765
201504,2015,3호선,신사,887132,977889,1865021
201504,2015,3호선,잠원,149673,144065,293738
201504,2015,3호선,고속터미널,1523125,1582316,3105441
201504,2015,3호선,교대,382738,294960,677698
201504,2015,3호선,남부터미널,983527,1028803,2012330
201504,2015,3호선,양재,1191871,1264377,2456248
201504,2015,3호선,매봉,312172,296935,609107
201504,2015,3호선,도곡,202223,187979,390202
201504,2015,3호선,대치,298594,278195,576789
201504,2015,3호선,학여울,84346,88963,173309
201504,2015,3호선,대청,295632,256176,551808
201504,2015,3호선,일원,238913,250107,489020
201504,2015,3호선,수서,302147,310193,612340
201504,2015,3호선,가락시장,213069,193279,406348
201504,2015,3호선,경찰병원,192872,189303,382175
201504,2015,3호선,오금,188046,164739,352785
201504,2015,4호선,당고개,322775,298498,621273
201504,2015,4호선,상계,569419,496976,1066395
201504,2015,4호선,노원,634521,720334,1354855
201504,2015,4호선,창동,756376,832561,1588937
201504,2015,4호선,쌍문,891352,747706,1639058
201504,2015,4호선,수유(강북구청),1214062,1174066,2388128
201504,2015,4호선,미아,487716,434121,921837
201504,2015,4호선,미아사거리,879513,844696,1724209
201504,2015,4호선,길음,797435,767292,1564727
201504,2015,4호선,성신여대입구,762652,688819,1451471
201504,2015,4호선,한성대입구,489045,469025,958070
201504,2015,4호선,혜화,1189475,1244212,2433687
201504,2015,4호선,동대문,616635,653550,1270185
201504,2015,4호선,동대문역사문화공원,628770,584157,1212927
201504,2015,4호선,충무로,975218,991432,1966650
201504,2015,4호선,명동,1198833,1301585,2500418
201504,2015,4호선,회현,717685,782885,1500570
201504,2015,4호선,서울역,309385,569366,878751
201504,2015,4호선,숙대입구,534971,527471,1062442
201504,2015,4호선,삼각지,137520,171957,309477
201504,2015,4호선,신용산,356036,384598,740634
201504,2015,4호선,이촌,238398,272912,511310
201504,2015,4호선,동작,73702,83759,157461
201504,2015,4호선,총신대입구,574135,645955,1220090
201504,2015,4호선,사당,979614,776782,1756396
201504,2015,4호선,남태령,29431,23255,52686
201504,2015,5호선,방화,183870,174865,358735
201504,2015,5호선,개화산,147125,134803,281928
201504,2015,5호선,송정,275215,263684,538899
201504,2015,5호선,마곡,79086,61856,140942
201504,2015,5호선,발산,299485,297492,596977
201504,2015,5호선,우장산,427457,410999,838456
201504,2015,1호선,서울역,1676648,1520709,3197357
201504,2015,1호선,시청,661468,667648,1329116
201504,2015,1호선,종각,1254011,1172311,2426322
201504,2015,1호선,종로3가,760938,690626,1451564
201504,2015,1호선,종로5가,574108,584534,1158642
201504,2015,1호선,동대문,361972,422268,784240
201504,2015,1호선,신설동,405736,397490,803226
201504,2015,1호선,제기동,297007,295731,592738
201504,2015,1호선,청량리(지하),596596,623362,1219958
201504,2015,1호선,동묘앞,167983,186859,354842
201504,2015,2호선,시청,717817,703710,1421527
201504,2015,2호선,을지로입구,1461440,1453444,2914884
201504,2015,2호선,을지로3가,512673,496511,1009184
201504,2015,2호선,을지로4가,298598,298729,597327
201504,2015,2호선,동대문역사문화공원,496214,575847,1072061
201504,2015,2호선,신당,354822,374640,729462
201504,2015,2호선,상왕십리,263109,247126,510235
201504,2015,2호선,왕십리(성동구청),589784,485553,1075337
201504,2015,2호선,한양대,415550,492943,908493
201504,2015,2호선,뚝섬,429744,454196,883940
201504,2015,2호선,성수,649128,719975,1369103
201503,2015,5호선,충정로,139461,146234,285695
201503,2015,7호선,상동,394851,407884,802735
201503,2015,7호선,삼산체육관,149347,134741,284088
201503,2015,7호선,굴포천,236443,243090,479533
201503,2015,7호선,부평구청,346022,258664,604686
201503,2015,8호선,암사,461171,401226,862397
201503,2015,8호선,천호,536545,591466,1128011
201503,2015,8호선,강동구청,274250,285345,559595
201503,2015,8호선,몽촌토성,171536,184113,355649
201503,2015,8호선,잠실,278363,344223,622586
201503,2015,8호선,석촌,234929,247720,482649
201503,2015,8호선,송파,141234,143599,284833
201503,2015,8호선,가락시장,157164,190422,347586
201503,2015,8호선,문정,152259,144191,296450
201503,2015,8호선,장지,343796,329077,672873
201503,2015,8호선,복정,238847,176932,415779
201503,2015,8호선,산성,200237,191353,391590
201503,2015,8호선,남한산성입구,424877,394090,818967
201503,2015,8호선,단대오거리,363306,332951,696257
201503,2015,8호선,신흥,124229,128215,252444
201503,2015,8호선,수진,125158,114490,239648
201503,2015,8호선,모란,101896,78046,179942
201503,2015,9호선,개화,171572,102987,274559
201503,2015,9호선,김포공항,241428,281384,522812
201503,2015,9호선,공항시장,74054,82478,156532
201503,2015,9호선,신방화,192302,183718,376020
201503,2015,9호선,마곡나루,52044,48340,100384
201503,2015,9호선,양천향교,189058,186137,375195
201503,2015,9호선,가양,517494,494994,1012488
201503,2015,9호선,증미,196076,200451,396527
201503,2015,9호선,등촌,274105,266061,540166
201503,2015,9호선,염창,403125,394847,797972
201503,2015,9호선,신목동,113252,95260,208512
201503,2015,9호선,선유도,184842,184000,368842
201503,2015,9호선,당산,446743,419017,865760
201503,2015,9호선,국회의사당,408512,415487,823999
201503,2015,9호선,여의도,505047,498621,1003668
201503,2015,9호선,샛강,147072,153437,300509
201503,2015,9호선,노량진,857877,912264,1770141
201503,2015,9호선,노들,122382,100259,222641
201503,2015,9호선,흑석(중앙대입구),348407,352180,700587
201503,2015,9호선,동작,44713,32044,76757
201503,2015,9호선,구반포,81634,87377,169011
201503,2015,9호선,신반포,77536,77884,155420
201503,2015,9호선,고속터미널,404224,454741,858965
201503,2015,9호선,사평,74636,70085,144721
201503,2015,9호선,신논현,897431,875131,1772562
201503,2015,9호선,언주,13888,11505,25393
201503,2015,9호선,선정릉,10423,10976,21399
201503,2015,9호선,삼성중앙,8674,7322,15996
201503,2015,9호선,봉은사,19541,18515,38056
201503,2015,9호선,종합운동장,10537,7589,18126
201503,2015,1호선,서울역,1880246,1682965,3563211
201503,2015,1호선,시청,629174,629592,1258766
201503,2015,1호선,종각,1292556,1226790,2519346
201503,2015,1호선,종로3가,776822,720776,1497598
201503,2015,1호선,종로5가,580052,595559,1175611
201503,2015,1호선,동대문,371146,435262,806408
201503,2015,1호선,신설동,413062,405091,818153
201503,2015,1호선,제기동,302851,300914,603765
201503,2015,1호선,청량리(지하),619323,642545,1261868
201503,2015,1호선,동묘앞,179955,199541,379496
201503,2015,2호선,시청,708029,689459,1397488
201503,2015,2호선,을지로입구,1480310,1478168,2958478
201503,2015,2호선,을지로3가,517840,507178,1025018
201503,2015,2호선,을지로4가,298814,300623,599437
201503,2015,2호선,동대문역사문화공원,520205,602194,1122399
201503,2015,2호선,신당,361773,385073,746846
201503,2015,2호선,상왕십리,272255,256906,529161
201503,2015,2호선,왕십리(성동구청),621154,508371,1129525
201503,2015,2호선,한양대,429603,517970,947573
201503,2015,2호선,뚝섬,423552,449409,872961
201503,2015,2호선,성수,663503,733048,1396551
201503,2015,5호선,영등포구청,85496,87568,173064
201503,2015,5호선,양평,164336,166858,331194
201503,2015,5호선,오목교,741363,798081,1539444
201503,2015,5호선,목동,533297,555883,1089180
201503,2015,5호선,신정,402457,314388,716845
201503,2015,5호선,까치산,795465,743256,1538721
201503,2015,5호선,화곡,780062,707373,1487435
201503,2015,5호선,우장산,436670,423185,859855
201503,2015,5호선,발산,311970,309408,621378
201503,2015,5호선,마곡,78127,62032,140159
201503,2015,5호선,송정,278946,268140,547086
201503,2015,5호선,김포공항,204498,177124,381622
201503,2015,5호선,개화산,149562,137663,287225
201503,2015,5호선,방화,185832,178020,363852
201503,2015,4호선,남태령,35734,28251,63985
201503,2015,4호선,사당,1010717,801680,1812397
201503,2015,4호선,총신대입구,590008,662984,1252992
201503,2015,4호선,동작,56545,60098,116643
201503,2015,4호선,이촌,235371,269121,504492
201503,2015,4호선,신용산,349069,381634,730703
201503,2015,4호선,삼각지,140690,175682,316372
201503,2015,4호선,숙대입구,559253,548658,1107911
201503,2015,4호선,서울역,298003,545520,843523
201503,2015,4호선,회현,711319,773546,1484865
201503,2015,4호선,명동,1260815,1367431,2628246
201503,2015,4호선,충무로,975463,988244,1963707
201503,2015,4호선,동대문역사문화공원,657081,604194,1261275
201503,2015,4호선,동대문,624727,663220,1287947
201503,2015,4호선,혜화,1234601,1286793,2521394
201503,2015,4호선,한성대입구,500082,481605,981687
201503,2015,4호선,성신여대입구,803375,723767,1527142
201503,2015,4호선,길음,819991,793505,1613496
201503,2015,4호선,미아사거리,891403,854742,1746145
201503,2015,4호선,미아,498550,447445,945995
201503,2015,4호선,수유(강북구청),1240572,1200248,2440820
201503,2015,4호선,쌍문,912333,765643,1677976
201503,2015,4호선,창동,768783,849691,1618474
201503,2015,4호선,노원,662814,749464,1412278
201503,2015,4호선,상계,583718,512626,1096344
201503,2015,4호선,당고개,329633,306253,635886
201503,2015,3호선,오금,192894,169464,362358
201503,2015,3호선,경찰병원,195514,192972,388486
201503,2015,3호선,가락시장,221843,200953,422796
201503,2015,3호선,수서,318703,327573,646276
201503,2015,3호선,일원,244747,254683,499430
201503,2015,3호선,대청,306550,265435,571985
201503,2015,3호선,학여울,91812,96173,187985
201503,2015,3호선,대치,322748,301623,624371
201503,2015,3호선,도곡,214796,197709,412505
201503,2015,3호선,매봉,318219,301115,619334
201503,2015,3호선,양재,1211213,1286400,2497613
201503,2015,3호선,남부터미널,1012609,1056037,2068646
201503,2015,3호선,교대,391134,302123,693257
201503,2015,3호선,고속터미널,1633157,1684816,3317973
201503,2015,3호선,잠원,155206,150003,305209
201503,2015,3호선,신사,929168,1014829,1943997
201503,2015,3호선,압구정,1002911,1117109,2120020
201503,2015,3호선,옥수,270503,280980,551483
201503,2015,3호선,금호,199311,180006,379317
201503,2015,3호선,약수,375762,357195,732957
201503,2015,3호선,동대입구,341349,396834,738183
201503,2015,3호선,충무로,47,0,47
201503,2015,3호선,을지로3가,224025,262953,486978
201503,2015,3호선,종로3가,193601,267793,461394
201503,2015,3호선,안국,725397,798092,1523489
201503,2015,3호선,경복궁,700727,749321,1450048
201503,2015,3호선,독립문,169709,177984,347693
201503,2015,3호선,무악재,101249,96938,198187
201503,2015,3호선,홍제,516635,480303,996938
201503,2015,3호선,녹번,396850,331623,728473
201503,2015,3호선,불광,464271,505539,969810
201503,2015,3호선,연신내,1068481,996848,2065329
201503,2015,3호선,구파발,462395,362005,824400
201503,2015,3호선,지축,27951,28544,56495
201503,2015,2호선,용두,46645,49373,96018
201503,2015,2호선,신정네거리,280438,277339,557777
201503,2015,2호선,양천구청,185691,199368,385059
201503,2015,2호선,도림천,25740,29069,54809
201503,2015,2호선,신설동,97555,91592,189147
201503,2015,2호선,신답,30778,36065,66843
201503,2015,2호선,용답,64319,67442,131761
201503,2015,2호선,충정로,304591,335669,640260
201503,2015,2호선,아현,252183,223257,475440
201503,2015,2호선,이대,720686,768464,1489150
201503,2015,2호선,신촌,1585300,1599463,3184763
201503,2015,2호선,홍대입구,2229042,2360001,4589043
201503,2015,2호선,합정,1051662,1007461,2059123
201503,2015,2호선,당산,682612,742020,1424632
201503,2015,2호선,영등포구청,580739,583903,1164642
201503,2015,2호선,문래,522813,528899,1051712
201503,2015,2호선,신도림,1937171,1931494,3868665
201503,2015,2호선,대림,853429,889686,1743115
201503,2015,2호선,구로디지털단지,1850588,1858869,3709457
201503,2015,2호선,신대방,716531,680366,1396897
201503,2015,2호선,신림,2082867,2025687,4108554
201503,2015,2호선,봉천,608566,552853,1161419
201503,2015,2호선,서울대입구,1519292,1491491,3010783
201503,2015,2호선,낙성대,863254,830359,1693613
201503,2015,2호선,사당,1245872,1420986,2666858
201503,2015,2호선,방배,648151,658960,1307111
201503,2015,2호선,서초,643390,654315,1297705
201503,2015,2호선,교대,1066630,1192787,2259417
201503,2015,2호선,강남,3048498,3112464,6160962
201503,2015,2호선,역삼,1317771,1468887,2786658
201503,2015,2호선,선릉,1543984,1351739,2895723
201503,2015,2호선,삼성,1820867,1879268,3700135
201503,2015,2호선,종합운동장,420974,450407,871381
201503,2015,2호선,신천,746481,721415,1467896
201503,2015,2호선,잠실,2313458,2088504,4401962
201503,2015,2호선,잠실나루,488273,464720,952993
201503,2015,2호선,강변,1467508,1438329,2905837
201503,2015,2호선,구의,636155,622996,1259151
201503,2015,2호선,건대입구,1337248,1449742,2786990
201503,2015,5호선,영등포시장,172623,192225,364848
201503,2015,5호선,신길,82075,98638,180713
201503,2015,5호선,여의도,642336,713214,1355550
201503,2015,5호선,여의나루,262109,281608,543717
201503,2015,5호선,마포,386129,406843,792972
201503,2015,5호선,공덕,375462,399819,775281
201503,2015,5호선,애오개,160754,166259,327013
201503,2015,5호선,서대문,478125,491914,970039
201503,2015,5호선,광화문,1016617,1077613,2094230
201503,2015,5호선,종로3가,299053,295031,594084
201503,2015,5호선,을지로4가,111715,126074,237789
201503,2015,5호선,동대문역사문화공원,82248,99934,182182
201503,2015,5호선,청구,108348,105918,214266
201503,2015,5호선,신금호,138194,136535,274729
201503,2015,5호선,행당,219449,189695,409144
201503,2015,5호선,왕십리(성동구청),136847,171374,308221
201503,2015,5호선,마장,158996,156575,315571
201503,2015,5호선,답십리,443336,403578,846914
201503,2015,5호선,장한평,492799,492310,985109
201503,2015,5호선,군자,301614,331701,633315
201503,2015,5호선,아차산,398029,375133,773162
201503,2015,5호선,광나루,431942,387890,819832
201503,2015,5호선,천호,540702,586428,1127130
201503,2015,5호선,강동,538767,442564,981331
201503,2015,5호선,길동,182353,193417,375770
201503,2015,5호선,굽은다리,242624,229360,471984
201503,2015,5호선,명일,234292,230546,464838
201503,2015,5호선,고덕,212709,214090,426799
201503,2015,5호선,상일동,319412,260110,579522
201503,2015,5호선,둔촌동,352793,350608,703401
201503,2015,5호선,올림픽공원,249284,251523,500807
201503,2015,5호선,방이,183333,185285,368618
201503,2015,5호선,오금,110581,110540,221121
201503,2015,5호선,개롱,177189,175816,353005
201503,2015,5호선,거여,186339,174912,361251
201503,2015,5호선,마천,141013,140591,281604
201503,2015,6호선,응암,448631,434053,882684
201503,2015,6호선,역촌,82021,102524,184545
201503,2015,6호선,불광,137367,139055,276422
201503,2015,6호선,독바위,71239,78936,150175
201503,2015,6호선,연신내,11,0,11
201503,2015,6호선,구산,201651,135739,337390
201503,2015,6호선,새절,374840,354121,728961
201503,2015,6호선,증산,268703,254648,523351
201503,2015,6호선,디지털미디어시티,421280,460377,881657
201503,2015,6호선,월드컵경기장,168867,181704,350571
201503,2015,6호선,마포구청,359526,306692,666218
201503,2015,6호선,망원,299349,318386,617735
201503,2015,6호선,합정,309013,344673,653686
201503,2015,6호선,상수,301719,353599,655318
201503,2015,6호선,광흥창,237762,229119,466881
201503,2015,6호선,대흥,240460,260095,500555
201503,2015,6호선,공덕,482833,477281,960114
201503,2015,6호선,효창공원앞,217135,213000,430135
201503,2015,6호선,삼각지,209528,166120,375648
201503,2015,6호선,녹사평(용산구청),205342,230151,435493
201503,2015,6호선,이태원,468415,520963,989378
201503,2015,6호선,한강진,174196,211791,385987
201503,2015,6호선,버티고개,69137,63239,132376
201503,2015,6호선,약수,91153,93355,184508
201503,2015,6호선,청구,93302,97018,190320
201503,2015,6호선,신당,216147,224412,440559
201503,2015,6호선,동묘앞,231273,234922,466195
201503,2015,6호선,창신,90095,77033,167128
201503,2015,6호선,보문,234169,205334,439503
201503,2015,6호선,안암,475425,485677,961102
201503,2015,6호선,고려대,300050,295837,595887
201503,2015,6호선,월곡,373773,348051,721824
201503,2015,6호선,상월곡,170782,159139,329921
201503,2015,6호선,돌곶이,252112,225039,477151
201503,2015,6호선,석계,364964,368310,733274
201503,2015,6호선,태릉입구,139930,173225,313155
201503,2015,6호선,화랑대,388772,289859,678631
201503,2015,6호선,봉화산(서울의료원),246669,228821,475490
201503,2015,7호선,장암,73258,24374,97632
201503,2015,7호선,도봉산,325537,305333,630870
201503,2015,7호선,수락산,374302,357747,732049
201503,2015,7호선,마들,301167,270648,571815
201503,2015,7호선,노원,561054,617216,1178270
201503,2015,7호선,중계,418053,375827,793880
201503,2015,7호선,하계,558368,524542,1082910
201503,2015,7호선,공릉,382887,374796,757683
201503,2015,7호선,태릉입구,264555,249305,513860
201503,2015,7호선,먹골,272030,259394,531424
201503,2015,7호선,중화,325600,307462,633062
201503,2015,7호선,상봉,502459,467029,969488
201503,2015,7호선,면목,457034,436980,894014
201503,2015,7호선,사가정,441452,424178,865630
201503,2015,7호선,용마산,161539,150509,312048
201503,2015,7호선,중곡,265999,238698,504697
201503,2015,7호선,군자,390120,287329,677449
201503,2015,7호선,어린이대공원,547643,564623,1112266
201503,2015,7호선,건대입구,532977,570916,1103893
201503,2015,7호선,뚝섬유원지,247652,240926,488578
201503,2015,7호선,청담,660259,767630,1427889
201503,2015,7호선,강남구청,494913,544759,1039672
201503,2015,7호선,학동,684289,768481,1452770
201503,2015,7호선,논현,575617,641627,1217244
201503,2015,7호선,반포,178270,169655,347925
201503,2015,7호선,고속터미널,584736,521091,1105827
201503,2015,7호선,내방,388862,406763,795625
201503,2015,7호선,이수,463907,461023,924930
201503,2015,7호선,남성,308640,279418,588058
201503,2015,7호선,숭실대입구,540874,531721,1072595
201503,2015,7호선,상도,332005,327149,659154
201503,2015,7호선,장승배기,271209,256796,528005
201503,2015,7호선,신대방삼거리,420042,390157,810199
201503,2015,7호선,보라매,272148,273948,546096
201503,2015,7호선,신풍,312164,291423,603587
201503,2015,7호선,대림,311334,310161,621495
201503,2015,7호선,남구로,454729,475330,930059
201503,2015,7호선,가산디지털단지,1205420,1220144,2425564
201503,2015,7호선,철산,708253,710691,1418944
201503,2015,7호선,광명사거리,741356,704176,1445532
201503,2015,7호선,천왕,210440,188552,398992
201503,2015,7호선,온수,335641,317349,652990
201503,2015,7호선,까치울,159321,138463,297784
201503,2015,7호선,부천종합운동장,157905,144070,301975
201503,2015,7호선,춘의,214389,209156,423545
201503,2015,7호선,신중동,398443,395924,794367
201503,2015,7호선,부천시청,341310,349187,690497
201502,2015,4호선,남태령,27563,19019,46582
201502,2015,5호선,방화,148161,141728,289889
201502,2015,5호선,개화산,121134,111320,232454
201502,2015,5호선,김포공항,189872,164682,354554
201502,2015,5호선,송정,222501,219209,441710
201502,2015,5호선,마곡,59975,48700,108675
201502,2015,5호선,발산,232639,231525,464164
201502,2015,5호선,우장산,339470,329853,669323
201502,2015,5호선,화곡,627384,571880,1199264
201502,2015,5호선,까치산,644827,606028,1250855
201502,2015,5호선,신정,315999,248385,564384
201502,2015,5호선,목동,419294,439083,858377
201502,2015,5호선,오목교,612918,656403,1269321
201502,2015,5호선,양평,130212,131667,261879
201502,2015,5호선,영등포구청,66739,68193,134932
201502,2015,5호선,영등포시장,141944,159194,301138
201502,2015,5호선,신길,63002,74374,137376
201502,2015,5호선,여의도,500600,546361,1046961
201502,2015,5호선,여의나루,164909,174528,339437
201502,2015,5호선,마포,306914,324415,631329
201502,2015,5호선,공덕,289501,308484,597985
201502,2015,5호선,애오개,123244,126428,249672
201502,2015,5호선,충정로,100036,102332,202368
201502,2015,5호선,서대문,344662,357513,702175
201502,2015,5호선,광화문,831707,860533,1692240
201502,2015,5호선,종로3가,261820,257725,519545
201502,2015,5호선,을지로4가,93308,104194,197502
201502,2015,5호선,동대문역사문화공원,69468,83156,152624
201502,2015,5호선,청구,92495,89630,182125
201502,2015,5호선,신금호,105815,104893,210708
201502,2015,5호선,행당,173904,150987,324891
201502,2015,5호선,왕십리(성동구청),111323,140132,251455
201502,2015,5호선,마장,121960,117150,239110
201502,2015,5호선,답십리,353196,322140,675336
201502,2015,5호선,장한평,389531,389092,778623
201502,2015,5호선,군자,238426,265327,503753
201502,2015,5호선,아차산,298989,284663,583652
201502,2015,5호선,광나루,328315,291452,619767
201502,2015,5호선,천호,461750,492220,953970
201502,2015,5호선,강동,421522,349819,771341
201502,2015,5호선,길동,149242,158810,308052
201502,2015,5호선,굽은다리,195328,184504,379832
201502,2015,5호선,명일,186648,183378,370026
201502,2015,5호선,고덕,166919,167746,334665
201502,2015,5호선,상일동,253390,207396,460786
201502,2015,5호선,둔촌동,273589,273119,546708
201502,2015,5호선,올림픽공원,134687,135846,270533
201502,2015,5호선,방이,145308,147731,293039
201502,2015,5호선,오금,82880,82927,165807
201502,2015,5호선,개롱,141472,139497,280969
201502,2015,5호선,거여,143115,133455,276570
201502,2015,5호선,마천,112271,112377,224648
201502,2015,6호선,응암,355210,346580,701790
201502,2015,6호선,역촌,66887,82022,148909
201502,2015,3호선,신사,770662,836957,1607619
201502,2015,3호선,압구정,862162,961129,1823291
201502,2015,3호선,옥수,216097,223786,439883
201502,2015,3호선,금호,160313,145343,305656
201502,2015,3호선,약수,301116,284746,585862
201502,2015,3호선,동대입구,230500,258365,488865
201502,2015,3호선,충무로,33,0,33
201502,2015,3호선,을지로3가,176529,207429,383958
201502,2015,3호선,종로3가,158539,224875,383414
201502,2015,3호선,안국,577719,633488,1211207
201502,2015,3호선,경복궁,519413,566757,1086170
201502,2015,3호선,독립문,129909,133573,263482
201502,2015,3호선,무악재,82633,78355,160988
201502,2015,3호선,홍제,390952,360491,751443
201502,2015,3호선,녹번,317849,265271,583120
201502,2015,3호선,불광,362008,399546,761554
201502,2015,4호선,한성대입구,333124,319482,652606
201502,2015,9호선,노량진,701291,743234,1444525
201502,2015,9호선,샛강,122900,124934,247834
201502,2015,9호선,여의도,391700,389917,781617
201502,2015,9호선,국회의사당,326130,330521,656651
201502,2015,9호선,당산,356649,326101,682750
201502,2015,9호선,선유도,142404,139423,281827
201502,2015,9호선,신목동,90305,76299,166604
201502,2015,9호선,염창,319535,311190,630725
201502,2015,9호선,등촌,225282,218034,443316
201502,2015,9호선,증미,160793,165318,326111
201502,2015,9호선,가양,409417,390229,799646
201502,2015,9호선,양천향교,143186,139234,282420
201502,2015,9호선,마곡나루,41948,38901,80849
201502,2015,9호선,신방화,149035,141836,290871
201502,2015,9호선,공항시장,61629,69179,130808
201502,2015,9호선,김포공항,221046,259203,480249
201502,2015,9호선,개화,126117,77128,203245
201502,2015,8호선,모란,81119,62698,143817
201502,2015,8호선,수진,104428,95491,199919
201502,2015,8호선,신흥,105274,110140,215414
201502,2015,8호선,단대오거리,267862,253039,520901
201502,2015,8호선,남한산성입구,299269,263807,563076
201502,2015,8호선,산성,152957,144568,297525
201502,2015,8호선,복정,155389,109057,264446
201502,2015,8호선,장지,278823,269382,548205
201502,2015,8호선,문정,119153,113739,232892
201502,2015,8호선,가락시장,129435,156679,286114
201502,2015,8호선,송파,106320,108366,214686
201502,2015,8호선,석촌,188883,199654,388537
201502,2015,8호선,잠실,237115,287025,524140
201502,2015,8호선,몽촌토성,132475,143016,275491
201502,2015,3호선,연신내,856020,805846,1661866
201502,2015,3호선,구파발,354462,278320,632782
201502,2015,3호선,지축,22104,22679,44783
201502,2015,2호선,용두,39099,41266,80365
201502,2015,7호선,어린이대공원,306099,301718,607817
201502,2015,7호선,건대입구,406442,440056,846498
201502,2015,7호선,뚝섬유원지,168597,161025,329622
201502,2015,7호선,청담,527360,608482,1135842
201502,2015,7호선,강남구청,400192,437128,837320
201502,2015,7호선,학동,537717,595787,1133504
201502,2015,7호선,논현,462488,515131,977619
201502,2015,7호선,반포,141315,133177,274492
201502,2015,1호선,서울역,1688548,1490571,3179119
201502,2015,1호선,시청,520415,516568,1036983
201502,2015,1호선,종각,1105535,1041530,2147065
201502,2015,1호선,종로3가,691413,654549,1345962
201502,2015,1호선,종로5가,502934,512176,1015110
201502,2015,1호선,동대문,312964,368884,681848
201502,2015,1호선,신설동,317717,308150,625867
201502,2015,1호선,제기동,251837,252779,504616
201502,2015,1호선,청량리(지하),510467,532712,1043179
201502,2015,1호선,동묘앞,147391,164950,312341
201502,2015,2호선,시청,574644,548162,1122806
201502,2015,2호선,을지로입구,1260227,1244278,2504505
201502,2015,2호선,을지로3가,412152,404537,816689
201502,2015,2호선,을지로4가,247633,251474,499107
201502,2015,2호선,동대문역사문화공원,411686,468276,879962
201502,2015,2호선,신당,288968,309436,598404
201502,2015,2호선,상왕십리,206327,195807,402134
201502,2015,2호선,왕십리(성동구청),451549,393426,844975
201502,2015,2호선,한양대,196034,225815,421849
201502,2015,2호선,뚝섬,320480,337990,658470
201502,2015,2호선,성수,521146,573668,1094814
201502,2015,2호선,건대입구,1080730,1192136,2272866
201502,2015,2호선,구의,509138,499876,1009014
201502,2015,2호선,강변,1270065,1275631,2545696
201502,2015,2호선,잠실나루,386092,366156,752248
201502,2015,2호선,잠실,1994937,1797395,3792332
201502,2015,2호선,신천,602401,594669,1197070
201502,2015,2호선,종합운동장,275925,288201,564126
201502,2015,2호선,삼성,1499698,1527666,3027364
201502,2015,2호선,선릉,1239249,1079062,2318311
201502,2015,2호선,역삼,1065617,1169741,2235358
201502,2015,2호선,강남,2681119,2742084,5423203
201502,2015,2호선,교대,829298,915160,1744458
201502,2015,2호선,서초,499727,504590,1004317
201502,2015,2호선,방배,436275,441492,877767
201502,2015,2호선,사당,964842,1097418,2062260
201502,2015,2호선,낙성대,678706,646872,1325578
201502,2015,2호선,서울대입구,1169942,1150867,2320809
201502,2015,2호선,봉천,493970,449762,943732
201502,2015,2호선,신림,1697027,1658653,3355680
201502,2015,2호선,신대방,583140,554977,1138117
201502,2015,2호선,구로디지털단지,1504185,1508499,3012684
201502,2015,2호선,대림,703957,736406,1440363
201502,2015,2호선,신도림,1562137,1554828,3116965
201502,2015,2호선,문래,415443,419229,834672
201502,2015,6호선,불광,119139,113451,232590
201502,2015,6호선,독바위,56425,60384,116809
201502,2015,6호선,연신내,15,0,15
201502,2015,6호선,구산,155436,107179,262615
201502,2015,6호선,새절,264829,248993,513822
201502,2015,6호선,증산,212053,196369,408422
201502,2015,6호선,디지털미디어시티,329019,360953,689972
201502,2015,6호선,월드컵경기장,121884,130751,252635
201502,2015,6호선,마포구청,281397,240296,521693
201502,2015,6호선,망원,236654,253535,490189
201502,2015,6호선,합정,244815,276409,521224
201502,2015,6호선,상수,236329,274390,510719
201502,2015,6호선,광흥창,184732,178176,362908
201502,2015,6호선,대흥,166970,178427,345397
201502,2015,6호선,공덕,379116,374023,753139
201502,2015,6호선,효창공원앞,156562,149145,305707
201502,2015,6호선,삼각지,173456,132737,306193
201502,2015,6호선,녹사평(용산구청),167812,186991,354803
201502,2015,6호선,이태원,401101,449092,850193
201502,2015,6호선,한강진,137986,166831,304817
201502,2015,6호선,버티고개,49884,47907,97791
201502,2015,6호선,약수,72738,74902,147640
201502,2015,6호선,청구,66465,69687,136152
201502,2015,6호선,신당,170074,171735,341809
201502,2015,6호선,동묘앞,185137,184354,369491
201502,2015,6호선,창신,65379,51029,116408
201502,2015,6호선,보문,179575,156799,336374
201502,2015,6호선,안암,279563,285451,565014
201502,2015,6호선,고려대,200296,195761,396057
201502,2015,6호선,월곡,247018,234306,481324
201502,2015,6호선,상월곡,123903,108451,232354
201502,2015,6호선,돌곶이,193460,173238,366698
201502,2015,6호선,석계,273551,273052,546603
201502,2015,6호선,태릉입구,104361,116436,220797
201502,2015,6호선,화랑대,267735,197868,465603
201502,2015,6호선,봉화산(서울의료원),196780,183514,380294
201502,2015,7호선,장암,54756,17886,72642
201502,2015,7호선,도봉산,245402,226788,472190
201502,2015,7호선,수락산,297175,282117,579292
201502,2015,7호선,마들,246340,221381,467721
201502,2015,7호선,노원,477980,521804,999784
201502,2015,7호선,중계,317309,284114,601423
201502,2015,7호선,하계,440724,412475,853199
201502,2015,7호선,공릉,259874,257147,517021
201502,2015,7호선,태릉입구,174147,161266,335413
201502,2015,7호선,먹골,221135,210185,431320
201502,2015,7호선,중화,259524,244657,504181
201502,2015,7호선,상봉,407558,379583,787141
201502,2015,7호선,면목,319591,305085,624676
201502,2015,7호선,사가정,356111,342581,698692
201502,2015,7호선,용마산,127170,118112,245282
201502,2015,7호선,중곡,210581,190360,400941
201502,2015,7호선,고속터미널,544479,460608,1005087
201502,2015,7호선,내방,303183,316622,619805
201502,2015,7호선,이수,379749,376980,756729
201502,2015,7호선,남성,237034,214540,451574
201502,2015,7호선,숭실대입구,313551,304731,618282
201502,2015,7호선,상도,234336,219426,453762
201502,2015,7호선,장승배기,219710,209180,428890
201502,2015,7호선,신대방삼거리,333331,311870,645201
201502,2015,7호선,보라매,207869,207756,415625
201502,2015,7호선,신풍,252562,235856,488418
201502,2015,7호선,대림,274048,277272,551320
201502,2015,7호선,남구로,378651,391171,769822
201502,2015,7호선,가산디지털단지,991971,993047,1985018
201502,2015,7호선,철산,570901,573066,1143967
201502,2015,7호선,광명사거리,607860,580110,1187970
201502,2015,7호선,천왕,167180,149809,316989
201502,2015,7호선,온수,241727,226795,468522
201502,2015,7호선,까치울,119333,104714,224047
201502,2015,7호선,부천종합운동장,120235,109241,229476
201502,2015,7호선,춘의,172373,167757,340130
201502,2015,7호선,신중동,319549,316494,636043
201502,2015,7호선,부천시청,282919,287980,570899
201502,2015,7호선,상동,321630,328614,650244
201502,2015,7호선,삼산체육관,121034,109446,230480
201502,2015,7호선,굴포천,192025,196498,388523
201502,2015,7호선,부평구청,274737,205055,479792
201502,2015,8호선,암사,369023,322095,691118
201502,2015,8호선,천호,440275,492650,932925
201502,2015,8호선,강동구청,215507,224116,439623
201502,2015,7호선,군자,315929,234585,550514
201502,2015,4호선,성신여대입구,581866,535094,1116960
201502,2015,4호선,길음,578760,540495,1119255
201502,2015,2호선,신정네거리,226443,225133,451576
201502,2015,2호선,양천구청,144996,155749,300745
201502,2015,2호선,도림천,18694,20749,39443
201502,2015,2호선,신설동,76305,72275,148580
201502,2015,2호선,신답,24449,28756,53205
201502,2015,2호선,용답,48283,47750,96033
201502,2015,2호선,충정로,238402,257573,495975
201502,2015,2호선,아현,177060,166714,343774
201502,2015,2호선,이대,508522,528009,1036531
201502,2015,2호선,신촌,1255069,1278896,2533965
201502,2015,2호선,홍대입구,1937607,2087984,4025591
201502,2015,2호선,합정,860549,816699,1677248
201502,2015,2호선,당산,516320,561359,1077679
201502,2015,2호선,영등포구청,459436,459294,918730
201502,2015,4호선,혜화,1018861,1072686,2091547
201502,2015,4호선,동대문,501754,526599,1028353
201502,2015,4호선,동대문역사문화공원,536812,484536,1021348
201502,2015,4호선,충무로,705797,733688,1439485
201502,2015,4호선,명동,1070953,1176132,2247085
201502,2015,4호선,회현,568369,609722,1178091
201502,2015,4호선,서울역,234094,457023,691117
201502,2015,4호선,신용산,296036,321672,617708
201502,2015,4호선,숙대입구,363929,356933,720862
201502,2015,4호선,삼각지,114606,147219,261825
201502,2015,4호선,미아사거리,734314,704833,1439147
201502,2015,4호선,미아,374126,330801,704927
201502,2015,4호선,수유(강북구청),966727,937409,1904136
201502,2015,4호선,쌍문,731522,614475,1345997
201502,2015,4호선,창동,624547,682739,1307286
201502,2015,4호선,노원,549909,622497,1172406
201502,2015,4호선,상계,463887,409109,872996
201502,2015,4호선,당고개,264621,245399,510020
201502,2015,3호선,오금,152075,133364,285439
201502,2015,3호선,경찰병원,156984,154094,311078
201502,2015,3호선,가락시장,180526,163561,344087
201502,2015,3호선,수서,249813,257937,507750
201502,2015,3호선,일원,191141,203492,394633
201502,2015,3호선,대청,239623,207882,447505
201502,2015,3호선,학여울,92955,95763,188718
201502,2015,3호선,대치,265344,246469,511813
201502,2015,3호선,도곡,171007,159695,330702
201502,2015,3호선,매봉,252471,239508,491979
201502,2015,3호선,양재,920993,987194,1908187
201502,2015,9호선,신논현,749998,734533,1484531
201502,2015,9호선,사평,59669,55927,115596
201502,2015,9호선,고속터미널,362651,408727,771378
201502,2015,9호선,신반포,60093,60434,120527
201502,2015,9호선,구반포,67812,72918,140730
201502,2015,9호선,동작,36124,24923,61047
201502,2015,9호선,흑석(중앙대입구),214241,220927,435168
201502,2015,9호선,노들,101163,82305,183468
201502,2015,3호선,남부터미널,873505,905785,1779290
201502,2015,3호선,교대,294210,220079,514289
201502,2015,3호선,고속터미널,1515282,1587968,3103250
201502,2015,3호선,잠원,120740,116884,237624
201502,2015,4호선,이촌,204543,227459,432002
201502,2015,4호선,동작,42275,45410,87685
201502,2015,4호선,총신대입구,470831,531464,1002295
201502,2015,4호선,사당,764734,593064,1357798
201501,2015,4호선,미아사거리,837781,806517,1644298
201501,2015,4호선,성신여대입구,661018,605985,1267003
201501,2015,4호선,한성대입구,381209,364110,745319
201501,2015,4호선,혜화,1211915,1270131,2482046
201501,2015,4호선,동대문,588698,624002,1212700
201501,2015,4호선,동대문역사문화공원,610788,557234,1168022
201501,2015,4호선,충무로,829737,867245,1696982
201501,2015,4호선,명동,1113556,1221559,2335115
201501,2015,4호선,회현,663292,717745,1381037
201501,2015,4호선,서울역,277180,520174,797354
201501,2015,5호선,신길,74933,86829,161762
201501,2015,5호선,영등포시장,164977,184503,349480
201501,2015,5호선,영등포구청,78720,80510,159230
201501,2015,5호선,양평,153883,156795,310678
201501,2015,5호선,오목교,708533,758129,1466662
201501,2015,5호선,목동,496167,520857,1017024
201501,2015,5호선,신정,368673,288509,657182
201501,2015,5호선,까치산,741502,697076,1438578
201501,2015,5호선,화곡,731835,666404,1398239
201501,2015,5호선,우장산,387595,374825,762420
201501,2015,5호선,발산,263319,266566,529885
201501,2015,5호선,마곡,75941,61823,137764
201501,2015,5호선,송정,252777,244999,497776
201501,2015,5호선,김포공항,217576,190713,408289
201501,2015,5호선,개화산,139625,127500,267125
201501,2015,5호선,방화,170436,162264,332700
201501,2015,4호선,남태령,24889,19409,44298
201501,2015,4호선,사당,904059,707117,1611176
201501,2015,4호선,총신대입구,550301,619606,1169907
201501,2015,4호선,동작,47701,50075,97776
201501,2015,4호선,이촌,257256,283880,541136
201501,2015,4호선,신용산,343494,370255,713749
201501,2015,4호선,삼각지,138257,178987,317244
201501,2015,4호선,숙대입구,426269,421753,848022
201501,2015,1호선,서울역,1890411,1667163,3557574
201501,2015,1호선,시청,639441,636014,1275455
201501,2015,1호선,종각,1353882,1288680,2642562
201501,2015,1호선,종로3가,850077,819933,1670010
201501,2015,1호선,종로5가,590927,599790,1190717
201501,2015,1호선,동대문,336981,390926,727907
201501,2015,1호선,신설동,374981,363032,738013
201501,2015,1호선,제기동,286925,285937,572862
201501,2015,1호선,청량리(지하),582547,602667,1185214
201501,2015,1호선,동묘앞,155556,171171,326727
201501,2015,2호선,시청,684748,668078,1352826
201501,2015,2호선,을지로입구,1427247,1428862,2856109
201501,2015,2호선,을지로3가,487427,482581,970008
201501,2015,2호선,을지로4가,278668,283483,562151
201501,2015,2호선,동대문역사문화공원,464467,529194,993661
201501,2015,2호선,신당,333981,360531,694512
201501,2015,2호선,상왕십리,240454,228425,468879
201501,2015,2호선,왕십리,528644,459377,988021
201501,2015,2호선,한양대,233685,258301,491986
201501,2015,2호선,뚝섬,370286,392134,762420
201501,2015,2호선,성수,621629,685163,1306792
201501,2015,2호선,건대입구,1242112,1372098,2614210
201501,2015,5호선,충정로,117793,121686,239479
201501,2015,5호선,애오개,142028,147647,289675
201501,2015,7호선,중곡,239457,214682,454139
201501,2015,7호선,군자,370450,276574,647024
201501,2015,7호선,어린이대공원,366349,360576,726925
201501,2015,7호선,건대입구,479408,514069,993477
201501,2015,7호선,뚝섬유원지,197455,188056,385511
201501,2015,7호선,청담,623883,721147,1345030
201501,2015,7호선,강남구청,481456,526382,1007838
201501,2015,7호선,학동,647623,720706,1368329
201501,2015,7호선,논현,555553,621500,1177053
201501,2015,7호선,반포,160639,151493,312132
201501,2015,7호선,고속터미널,588155,503242,1091397
201501,2015,7호선,내방,357592,372517,730109
201501,2015,7호선,이수,446338,442134,888472
201501,2015,7호선,남성,275945,250335,526280
201501,2015,7호선,숭실대입구,367026,353793,720819
201501,2015,7호선,상도,273438,256283,529721
201501,2015,7호선,장승배기,252807,241487,494294
201501,2015,7호선,신대방삼거리,385387,362576,747963
201501,2015,2호선,구의,597712,586217,1183929
201501,2015,2호선,강변,1419664,1409882,2829546
201501,2015,2호선,잠실나루,458205,434608,892813
201501,2015,2호선,잠실,2264435,2035737,4300172
201501,2015,2호선,신천,707193,694181,1401374
201501,2015,2호선,종합운동장,336914,351289,688203
201501,2015,2호선,삼성,1770447,1810283,3580730
201501,2015,2호선,선릉,1521424,1326153,2847577
201501,2015,2호선,역삼,1285178,1417505,2702683
201501,2015,2호선,강남,3266271,3353256,6619527
201501,2015,2호선,교대,1019830,1132386,2152216
201501,2015,2호선,서초,593867,606446,1200313
201501,2015,2호선,방배,519107,526179,1045286
201501,2015,2호선,사당,1167250,1321752,2489002
201501,2015,2호선,낙성대,800857,765740,1566597
201501,2015,2호선,서울대입구,1389174,1370024,2759198
201501,2015,2호선,봉천,575480,525008,1100488
201501,2015,2호선,신림,1974870,1930373,3905243
201501,2015,2호선,신대방,670303,636477,1306780
201501,2015,2호선,구로디지털단지,1765773,1774970,3540743
201501,2015,2호선,대림,799262,832942,1632204
201501,2015,2호선,신도림,1795527,1778750,3574277
201501,2015,2호선,문래,490388,494872,985260
201501,2015,2호선,영등포구청,542338,541379,1083717
201501,2015,2호선,당산,613297,663754,1277051
201501,2015,2호선,합정,999733,951763,1951496
201501,2015,2호선,홍대입구,2156348,2316644,4472992
201501,2015,2호선,신촌,1442997,1476389,2919386
201501,2015,2호선,이대,559027,576940,1135967
201501,2015,2호선,아현,201426,189620,391046
201501,2015,2호선,충정로,280645,303487,584132
201501,2015,2호선,용답,55321,56113,111434
201501,2015,2호선,신답,28913,34082,62995
201501,2015,2호선,신설동,89457,86155,175612
201501,2015,2호선,도림천,21972,24048,46020
201501,2015,2호선,양천구청,168690,181699,350389
201501,2015,2호선,신정네거리,260252,259971,520223
201501,2015,2호선,용두,43967,47048,91015
201501,2015,3호선,지축,25624,26567,52191
201501,2015,3호선,구파발,410177,318255,728432
201501,2015,3호선,연신내,979846,918642,1898488
201501,2015,3호선,불광,421650,463422,885072
201501,2015,3호선,녹번,369269,306792,676061
201501,2015,3호선,홍제,450397,414511,864908
201501,2015,7호선,용마산,146433,134395,280828
201501,2015,7호선,사가정,409635,393489,803124
201501,2015,7호선,면목,366354,346993,713347
201501,2015,7호선,상봉,471891,437811,909702
201501,2015,7호선,중화,299994,282627,582621
201501,2015,7호선,먹골,255619,243775,499394
201501,2015,7호선,태릉입구,206621,190896,397517
201501,2015,7호선,공릉,296356,293571,589927
201501,2015,7호선,하계,505749,473307,979056
201501,2015,7호선,중계,365564,324633,690197
201501,2015,7호선,노원,552067,599232,1151299
201501,2015,7호선,마들,280914,254947,535861
201501,2015,7호선,수락산,341474,326733,668207
201501,2015,7호선,도봉산,283789,260203,543992
201501,2015,7호선,장암,64946,20964,85910
201501,2015,6호선,봉화산(서울의료원),233041,216740,449781
201501,2015,6호선,화랑대,317687,234766,552453
201501,2015,6호선,태릉입구,123844,139429,263273
201501,2015,6호선,석계,317989,318451,636440
201501,2015,6호선,돌곶이,223433,199882,423315
201501,2015,6호선,상월곡,144203,126452,270655
201501,2015,6호선,월곡,285821,269488,555309
201501,2015,6호선,고려대,232348,223012,455360
201501,2015,6호선,안암,316312,323225,639537
201501,2015,6호선,보문,206531,180504,387035
201501,2015,6호선,창신,74004,57216,131220
201501,2015,6호선,동묘앞,204664,207291,411955
201501,2015,6호선,신당,207825,209011,416836
201501,2015,6호선,청구,63070,72605,135675
201501,2015,6호선,약수,85275,87842,173117
201501,2015,6호선,버티고개,58853,55563,114416
201501,2015,7호선,보라매,239704,239821,479525
201501,2015,7호선,신풍,286373,268304,554677
201501,2015,7호선,대림,292626,291850,584476
201501,2015,7호선,남구로,426418,446367,872785
201501,2015,7호선,가산디지털단지,1160629,1170977,2331606
201501,2015,7호선,철산,665206,667439,1332645
201501,2015,7호선,광명사거리,690249,658279,1348528
201501,2015,7호선,천왕,190297,168756,359053
201501,2015,7호선,온수,278930,257383,536313
201501,2015,7호선,까치울,138751,122405,261156
201501,2015,7호선,부천종합운동장,139483,126558,266041
201501,2015,7호선,춘의,197730,192468,390198
201501,2015,7호선,신중동,374259,372513,746772
201501,2015,7호선,부천시청,324627,330774,655401
201501,2015,7호선,상동,378381,385219,763600
201501,2015,7호선,삼산체육관,139748,126401,266149
201501,2015,7호선,굴포천,221661,228834,450495
201501,2015,7호선,부평구청,315921,234338,550259
201501,2015,8호선,암사,434855,378227,813082
201501,2015,8호선,천호,512794,569800,1082594
201501,2015,8호선,강동구청,259593,269234,528827
201501,2015,8호선,몽촌토성,157863,170534,328397
201501,2015,8호선,잠실,269125,323557,592682
201501,2015,8호선,석촌,225766,239659,465425
201501,2015,8호선,송파,123234,124379,247613
201501,2015,8호선,가락시장,152234,183405,335639
201501,2015,8호선,문정,135696,129859,265555
201501,2015,8호선,장지,323192,311127,634319
201501,2015,8호선,복정,182864,129434,312298
201501,2015,8호선,산성,175781,166092,341873
201501,2015,8호선,남한산성입구,347538,303534,651072
201501,2015,8호선,단대오거리,307412,290929,598341
201501,2015,8호선,신흥,117541,121888,239429
201501,2015,8호선,수진,115949,105371,221320
201501,2015,8호선,모란,90667,69400,160067
201501,2015,9호선,개화,148155,88699,236854
201501,2015,9호선,김포공항,246752,287114,533866
201501,2015,9호선,공항시장,72585,82551,155136
201501,2015,9호선,신방화,169119,160054,329173
201501,2015,9호선,마곡나루,49608,45753,95361
201501,2015,9호선,양천향교,169461,165605,335066
201501,2015,9호선,가양,469127,439698,908825
201501,2015,9호선,증미,191313,201261,392574
201501,2015,9호선,등촌,265941,271132,537073
201501,2015,9호선,염창,369970,345474,715444
201501,2015,9호선,신목동,106192,90820,197012
201501,2015,9호선,선유도,172599,169582,342181
201501,2015,9호선,당산,422698,384841,807539
201501,2015,9호선,국회의사당,392949,405860,798809
201501,2015,9호선,여의도,470992,470497,941489
201501,2015,9호선,샛강,150408,160460,310868
201501,2015,9호선,노량진,817907,864989,1682896
201501,2015,9호선,노들,121496,100670,222166
201501,2015,9호선,흑석(중앙대입구),252588,260917,513505
201501,2015,9호선,동작,40212,26443,66655
201501,2015,9호선,구반포,80815,87864,168679
201501,2015,9호선,신반포,69980,71893,141873
201501,2015,9호선,고속터미널,388081,429180,817261
201501,2015,9호선,사평,70919,67069,137988
201501,2015,9호선,신논현,911378,891964,1803342
201501,2015,5호선,공덕,342973,367506,710479
201501,2015,5호선,마포,358222,381433,739655
201501,2015,5호선,여의나루,184361,200101,384462
201501,2015,5호선,여의도,600408,659127,1259535
201501,2015,6호선,한강진,162521,195328,357849
201501,2015,6호선,이태원,440702,491386,932088
201501,2015,6호선,녹사평(용산구청),185728,207358,393086
201501,2015,6호선,삼각지,212421,163731,376152
201501,2015,6호선,효창공원앞,185346,177165,362511
201501,2015,6호선,공덕,442052,437596,879648
201501,2015,6호선,대흥,197493,209604,407097
201501,2015,6호선,광흥창,219854,212708,432562
201501,2015,6호선,상수,274861,317653,592514
201501,2015,6호선,합정,282876,318906,601782
201501,2015,6호선,망원,275664,295316,570980
201501,2015,6호선,마포구청,323986,278397,602383
201501,2015,6호선,월드컵경기장,138988,148372,287360
201501,2015,6호선,디지털미디어시티,389623,430057,819680
201501,2015,6호선,증산,244352,226314,470666
201501,2015,6호선,새절,305071,284002,589073
201501,2015,6호선,구산,176369,122240,298609
201501,2015,6호선,연신내,15,0,15
201501,2015,6호선,독바위,64212,68735,132947
201501,2015,6호선,불광,134228,129665,263893
201501,2015,6호선,역촌,77928,95553,173481
201501,2015,6호선,응암,409940,396462,806402
201501,2015,5호선,마천,126745,127278,254023
201501,2015,5호선,거여,165380,153365,318745
201501,2015,5호선,개롱,165615,163872,329487
201501,2015,5호선,오금,96204,97412,193616
201501,2015,5호선,방이,172049,174538,346587
201501,2015,5호선,올림픽공원,151918,149429,301347
201501,2015,5호선,둔촌동,319524,320434,639958
201501,2015,5호선,상일동,298972,241620,540592
201501,2015,5호선,고덕,191201,192150,383351
201501,2015,5호선,명일,220767,217639,438406
201501,2015,5호선,굽은다리,229279,218496,447775
201501,2015,5호선,길동,172893,185513,358406
201501,2015,5호선,강동,493274,408354,901628
201501,2015,5호선,천호,533087,569031,1102118
201501,2015,5호선,광나루,385706,339154,724860
201501,2015,5호선,아차산,343266,328964,672230
201501,2015,5호선,군자,280180,312276,592456
201501,2015,5호선,장한평,456953,458138,915091
201501,2015,5호선,답십리,416720,379733,796453
201501,2015,5호선,마장,137233,132012,269245
201501,2015,5호선,왕십리,129382,162406,291788
201501,2015,5호선,행당,204096,177160,381256
201501,2015,3호선,무악재,96852,91663,188515
201501,2015,3호선,독립문,151167,155842,307009
201501,2015,3호선,경복궁,599252,644005,1243257
201501,2015,3호선,안국,661781,720816,1382597
201501,2015,3호선,종로3가,192798,267603,460401
201501,2015,3호선,을지로3가,211335,250352,461687
201501,2015,3호선,충무로,38,0,38
201501,2015,3호선,동대입구,267904,296406,564310
201501,2015,3호선,약수,349755,329772,679527
201501,2015,3호선,금호,185700,166605,352305
201501,2015,3호선,옥수,252387,262774,515161
201501,2015,3호선,압구정,1041322,1159966,2201288
201501,2015,3호선,신사,907423,990332,1897755
201501,2015,3호선,잠원,142654,138225,280879
201501,2015,3호선,고속터미널,1624401,1680989,3305390
201501,2015,3호선,교대,355356,265021,620377
201501,2015,3호선,남부터미널,995046,1024694,2019740
201501,2015,3호선,양재,1094512,1179984,2274496
201501,2015,3호선,매봉,299315,286302,585617
201501,2015,3호선,도곡,196997,181377,378374
201501,2015,3호선,대치,311663,288566,600229
201501,2015,3호선,학여울,85583,88449,174032
201501,2015,3호선,대청,274518,237865,512383
201501,2015,3호선,일원,226673,240245,466918
201501,2015,3호선,수서,291181,302218,593399
201501,2015,3호선,가락시장,211871,192147,404018
201501,2015,3호선,경찰병원,185160,182259,367419
201501,2015,3호선,오금,180851,157370,338221
201501,2015,4호선,당고개,302175,279763,581938
201501,2015,4호선,상계,536173,470361,1006534
201501,2015,4호선,노원,626466,710718,1337184
201501,2015,4호선,창동,715599,784879,1500478
201501,2015,4호선,쌍문,852351,716160,1568511
201501,2015,5호선,신금호,121268,119102,240370
201501,2015,5호선,청구,117400,109441,226841
201501,2015,5호선,동대문역사문화공원,81161,98024,179185
201501,2015,5호선,을지로4가,108326,120126,228452
201501,2015,5호선,종로3가,310056,306973,617029
201501,2015,5호선,광화문,978250,1023190,2001440
201501,2015,5호선,서대문,404720,421410,826130
201501,2015,4호선,수유(강북구청),1110438,1073695,2184133
201501,2015,4호선,미아,429323,381799,811122
201501,2015,4호선,길음,666658,619459,1286117
